090200,112610,37850,2,1100,2.99,154.55,11,17,6,2,12,10,1080,37650,37850,37650,14,1,4,2460,5557,10,4
090300,112610,37550,2,800,2.18,111.45,131,146,15,10,16,6,1329,37500,37550,37500,116,4,1,2404,4789,87,29
090400,112610,37450,2,700,1.9,43.2,338,146,-192,16,16,0,1539,37450,37450,37450,8,1,0,2092,4737,8,0
090500,112610,37350,2,600,1.63,71.43,413,295,-118,20,21,1,1763,37400,37400,37350,16,1,2,2425,4842,13,3
090600,112610,37300,2,550,1.5,57.17,530,303,-227,23,23,0,1888,37300,37300,37300,58,2,1,1658,5226,55,3
090700,112610,37250,2,500,1.36,49.55,662,328,-334,28,25,-3,2045,37250,37250,37250,115,2,0,2219,5202,115,0
090800,112610,37250,2,500,1.36,63.6,662,421,-241,28,30,2,2138,37250,37250,37250,89,0,3,1286,5799,0,89
090900,112610,37250,2,500,1.36,51.14,831,425,-406,33,32,-1,2311,37250,37250,37200,161,4,2,944,6000,157,4
091000,112610,37250,2,500,1.36,118.19,874,1033,159,36,34,-2,2962,37200,37250,37200,648,2,1,697,5948,41,607
091100,112610,37250,2,500,1.36,114.33,907,1037,130,38,35,-3,2999,37250,37250,37250,4,0,1,997,6354,0,4
091200,112610,37250,2,500,1.36,151.39,934,1414,480,39,40,1,3403,37250,37250,37250,364,1,4,1007,6538,27,337
091300,112610,37250,2,500,1.36,154.66,1008,1559,551,40,44,4,3622,37250,37250,37250,208,1,2,731,6211,74,134
091400,112610,37300,2,550,1.5,139.39,1122,1564,442,42,49,7,3741,37300,37300,37300,4,0,4,779,6060,0,4
091500,112610,37250,2,500,1.36,137.73,1137,1566,429,44,51,7,3758,37300,37300,37250,16,2,1,736,5958,15,1
091600,112610,37350,2,600,1.63,144.14,1187,1711,524,45,58,13,3953,37300,37350,37250,194,1,6,946,5955,50,144
091700,112610,37400,2,650,1.77,150.45,1211,1822,611,47,61,14,4088,37350,37400,37350,135,2,3,909,5654,24,111
091800,112610,37350,2,600,1.63,148.98,1223,1822,599,49,61,12,4100,37350,37350,37350,6,1,0,954,5741,6,0
091900,112610,37450,2,700,1.9,157.92,1224,1933,709,50,65,15,4212,37400,37450,37400,110,0,3,1037,6490,0,110
092000,112610,37450,2,700,1.9,158.5,1224,1940,716,50,66,16,4219,37450,37450,37450,7,0,1,1034,7154,0,7
092100,112610,37450,2,700,1.9,164.74,1228,2023,795,51,72,21,4306,37450,37450,37450,87,1,6,1261,6596,4,83
092200,112610,37500,2,750,2.04,165.55,1228,2033,805,51,74,23,4316,37500,37500,37500,0,0,0,1260,6592,0,0
092300,112610,37650,2,900,2.45,195.79,1236,2420,1184,52,82,30,4711,37550,37650,37550,351,1,7,2025,5921,8,343
092400,112610,37700,2,950,2.59,208.01,1249,2598,1349,54,96,42,4902,37650,37700,37650,191,2,14,2295,5920,13,178
092500,112610,37700,2,950,2.59,211.09,1262,2664,1402,59,100,41,4981,37700,37750,37700,79,5,4,2555,1820,13,66
092600,112610,37700,2,950,2.59,222.57,1267,2820,1553,64,108,44,5142,37750,37800,37700,161,5,8,2622,1981,5,156
092700,112610,37900,2,1150,3.13,232.42,1465,3405,1940,79,131,52,5925,37700,37950,37650,783,15,23,2559,681,198,585
092900,112610,37900,2,1150,3.13,226.46,1572,3560,1988,85,135,50,6187,37900,37900,37900,0,0,0,2633,784,0,0
093000,112610,37950,2,1200,3.27,215.31,2077,4472,2395,92,149,57,7604,37950,37950,37950,0,0,0,4074,4056,0,0
093100,112610,37950,2,1200,3.27,219.34,2203,4832,2629,99,163,64,8090,37950,37950,37950,0,0,0,4212,4118,0,0
093200,112610,37950,2,1200,3.27,229.72,2234,5132,2898,102,169,67,8421,37950,37950,37950,0,0,0,4055,4166,0,0
093300,112610,38100,2,1350,3.67,276.2,2248,6209,3961,105,177,72,9512,38050,38100,38050,844,0,3,4506,789,0,844
093400,112610,38200,2,1450,3.95,299.17,2284,6833,4549,108,187,79,10172,38200,38200,38200,4,1,0,2844,2950,4,0
093500,112610,38250,2,1500,4.08,309.7,2288,7086,4798,109,197,88,10429,38250,38250,38250,60,0,2,3323,3071,0,60
093600,112610,38300,2,1550,4.22,322.34,2310,7446,5136,111,203,92,10811,38300,38300,38300,4,0,1,3469,3031,0,4
093700,112610,38350,2,1600,4.35,321.25,2461,7906,5445,117,222,105,11422,38400,38400,38350,106,2,1,4104,3145,102,4
093800,112610,38500,2,1750,4.76,347.68,2865,9961,7096,127,229,102,13881,38550,38550,38500,72,2,2,3267,811,52,20
093900,112610,38500,2,1750,4.76,293.0,3445,10094,6649,134,234,100,14595,38450,38500,38450,25,1,1,2491,280,20,5
094000,112610,38400,2,1650,4.49,294.52,3467,10211,6744,141,242,101,14734,38400,38400,38400,59,2,3,2283,446,6,53
094100,112610,38500,2,1750,4.76,304.34,3523,10722,7199,144,259,115,15301,38500,38500,38500,224,0,9,2677,531,0,224
094200,112610,38650,2,1900,5.17,335.66,3567,11973,8406,146,283,137,16596,38550,38650,38550,981,2,17,2609,909,44,937
094300,112610,38750,2,2000,5.44,329.17,3744,12324,8580,158,292,134,17124,38700,38750,38700,175,9,3,3865,763,137,38
094400,112610,38850,2,2100,5.71,340.77,3907,13314,9407,166,309,143,18277,38700,38850,38700,1075,4,13,3622,1089,128,947
094500,112610,38800,2,2050,5.58,336.76,4059,13669,9610,171,322,151,18784,38850,38850,38800,210,1,9,3590,825,15,195
094600,112610,38850,2,2100,5.71,303.55,4728,14352,9624,189,339,150,20136,38900,38900,38500,989,18,6,3759,740,669,320
094700,112610,38700,2,1950,5.31,298.61,4833,14432,9599,196,345,149,20321,38600,38700,38600,93,2,3,2940,980,51,42
094800,112610,38750,2,2000,5.44,286.78,5104,14637,9533,204,350,146,20797,38700,38750,38700,176,5,4,3462,1261,18,158
094900,112610,38800,2,2050,5.58,290.36,5136,14913,9777,209,363,154,21105,38750,38800,38700,211,2,9,3841,1264,8,203
095000,112610,38800,2,2050,5.58,290.17,5230,15176,9946,216,372,156,21462,38750,38800,38700,279,6,5,3763,1157,92,187
095100,112610,38800,2,2050,5.58,290.7,5282,15355,10073,223,384,161,21693,38750,38850,38750,118,7,7,3920,1165,52,66
095200,112610,38850,2,2100,5.71,293.36,5287,15510,10223,224,390,166,21853,38850,38850,38850,155,0,6,3886,1137,0,155
095300,112610,38850,2,2100,5.71,296.42,5362,15894,10532,230,405,175,22312,38850,38900,38850,347,6,7,3813,1072,75,272
095400,112610,38850,2,2100,5.71,297.43,5414,16103,10689,238,415,177,22573,38850,38900,38800,197,4,8,3871,1213,35,162
095500,112610,38850,2,2100,5.71,311.39,5424,16890,11466,240,425,185,23370,38800,38850,38800,9,1,4,3377,1240,2,7
095600,112610,38950,2,2200,5.99,312.54,5480,17127,11647,246,435,189,23663,38850,38950,38850,184,3,7,3193,706,5,179
095700,112610,38950,2,2200,5.99,322.22,5513,17764,12251,247,448,201,24333,38950,38950,38900,590,1,10,2731,912,33,557
095800,112610,39050,2,2300,6.26,330.69,5621,18588,12967,250,467,217,25265,39000,39050,38950,768,2,15,3195,474,76,692
095900,112610,39050,2,2300,6.26,331.62,5746,19055,13309,255,477,222,25857,39050,39050,38950,569,5,8,3351,744,125,444
100000,112610,39050,2,2300,6.26,333.16,5808,19350,13542,263,483,220,26214,39050,39050,39000,267,3,4,3911,496,25,242
100100,112610,39050,2,2300,6.26,330.36,5899,19488,13589,268,489,221,26443,39050,39050,39000,229,5,6,3692,652,91,138
100200,112610,38950,2,2200,5.99,328.82,5937,19522,13585,271,493,222,26515,39050,39050,38950,67,3,2,3434,823,38,29
100300,112610,39000,2,2250,6.12,334.85,5971,19994,14023,273,502,229,27021,39000,39000,38950,470,2,7,3926,1802,34,436
100400,112610,39000,2,2250,6.12,337.43,6030,20347,14317,276,512,236,27433,38950,39050,38950,407,3,9,3605,1721,59,348
100600,112610,39150,2,2400,6.53,350.65,6292,22063,15771,282,535,253,29411,39150,39150,39150,0,0,0,6076,1513,0,0
100700,112610,39200,2,2450,6.67,339.87,6511,22129,15618,287,540,253,29696,39200,39200,39200,20,0,1,5761,1321,0,20
100800,112610,39200,2,2450,6.67,348.16,6524,22714,16190,288,550,262,30294,39200,39200,39200,13,1,0,7848,1342,13,0
100900,112610,39250,2,2500,6.8,350.24,6700,23466,16766,291,559,268,31222,39250,39250,39250,633,1,1,8140,1807,5,628
101000,112610,39300,2,2550,6.94,341.8,6926,23673,16747,294,568,274,31655,39300,39300,39300,138,0,5,9230,2578,0,138
101100,112610,39350,2,2600,7.07,358.25,7002,25085,18083,300,594,294,33143,39300,39350,39300,378,3,14,10309,2530,38,340
101200,112610,39100,2,2350,6.39,288.04,8969,25834,16865,311,609,298,35859,39250,39300,39050,838,9,2,8196,1181,767,71
101300,112610,39150,2,2400,6.53,283.77,9114,25863,16749,317,614,297,36033,39100,39150,39100,128,2,2,6612,2156,114,14
101400,112610,39200,2,2450,6.67,284.55,9131,25982,16851,323,620,297,36169,39200,39200,39150,95,2,4,8670,2339,9,86
101500,112610,39250,2,2500,6.8,299.89,9196,27578,18382,330,632,302,37830,39250,39250,39200,1629,2,11,8812,2043,39,1590
101600,112610,39300,2,2550,6.94,301.2,9250,27861,18611,332,652,320,38167,39300,39300,39300,124,0,9,9086,2044,0,124
101700,112610,39300,2,2550,6.94,302.84,9269,28070,18801,333,665,332,38395,39300,39300,39300,162,0,11,9167,2039,0,162
101800,112610,39250,2,2500,6.8,303.51,9270,28135,18865,334,671,337,38461,39300,39300,39250,46,1,5,9141,2040,1,45
101900,112610,39200,2,2450,6.67,278.24,10137,28205,18068,340,675,335,39398,39250,39250,39200,929,6,3,9627,1643,867,62
102000,112610,39200,2,2450,6.67,279.79,10137,28362,18225,340,684,344,39555,39200,39200,39200,157,0,9,7705,1459,0,157
102100,112610,39200,2,2450,6.67,281.2,10193,28663,18470,347,704,357,39912,39250,39250,39100,349,7,19,9063,2541,56,293
102200,112610,39250,2,2500,6.8,291.63,10193,29726,19533,347,714,367,40975,39200,39250,39200,1055,0,9,11060,2628,0,1055
102300,112610,39150,2,2400,6.53,286.24,10422,29832,19410,353,721,368,41310,39250,39250,39100,315,6,6,9200,2539,229,86
102400,112610,39200,2,2450,6.67,287.09,10428,29938,19510,354,726,372,41422,39200,39200,39200,112,1,5,11191,2647,6,106
102500,112610,39200,2,2450,6.67,283.75,10612,30112,19500,358,735,377,41780,39150,39200,39150,355,3,9,9129,2529,181,174
102600,112610,39150,2,2400,6.53,283.31,10730,30399,19669,359,747,388,42185,39200,39200,39150,405,1,12,10210,2622,118,287
102700,112610,39150,2,2400,6.53,284.28,10758,30583,19825,363,760,397,42397,39200,39200,39100,180,4,10,9302,2480,28,152
102900,112610,39200,2,2450,6.67,283.09,10842,30693,19851,367,766,399,42591,39200,39200,39200,0,0,0,10016,2496,0,0
103000,112610,39200,2,2450,6.67,283.67,10861,30809,19948,368,773,405,42726,39150,39200,39150,32,1,1,10808,2477,19,13
103100,112610,39150,2,2400,6.53,258.38,11952,30881,18929,374,780,406,43889,39150,39150,39150,19,0,1,10145,1560,0,19
103200,112610,39200,2,2450,6.67,259.17,11952,30976,19024,374,788,414,43984,39200,39200,39200,0,0,0,10711,1561,0,0
103300,112610,39150,2,2400,6.53,260.17,12005,31234,19229,378,807,429,44295,39150,39150,39150,20,0,2,9924,1531,0,20
103400,112610,39100,2,2350,6.39,258.37,12119,31312,19193,382,815,433,44488,39100,39100,39100,0,0,0,9983,1552,0,0
103500,112610,39100,2,2350,6.39,258.28,12141,31358,19217,385,823,438,44568,39100,39100,39100,1,0,1,8430,1625,0,1
103600,112610,39200,2,2450,6.67,260.53,12165,31693,19528,388,839,451,44927,39200,39200,39150,126,2,4,10638,1558,19,107
103700,112610,39250,2,2500,6.8,268.87,12202,32808,20606,390,856,466,46079,39250,39250,39250,71,0,5,11587,1506,0,71
103800,112610,39350,2,2600,7.07,287.11,12209,35053,22844,391,878,487,48331,39300,39350,39300,810,0,11,10390,1393,0,810
103900,112610,39450,2,2700,7.35,297.17,12255,36418,24163,396,895,499,49742,39300,39450,39300,1347,4,10,12328,1380,37,1310
104100,112610,39550,2,2800,7.62,326.17,12327,40207,27880,405,928,523,53603,39500,39550,39500,2552,3,12,14141,526,12,2540
104300,112610,39650,2,2900,7.89,345.9,12445,43047,30602,412,967,555,56561,39700,39700,39650,104,2,5,13201,1599,39,65
104400,112610,39850,2,3100,8.44,373.37,12602,47052,34450,418,996,578,60723,39800,39850,39800,1325,0,12,11803,2215,0,1325
104500,112610,39850,2,3100,8.44,378.89,12712,48165,35453,426,1015,589,61946,39850,39900,39750,556,2,7,11142,2006,19,537
104600,112610,39850,2,3100,8.44,381.95,12974,49554,36580,434,1042,608,63597,39900,39950,39850,1153,6,19,14798,1479,256,897
104700,112610,39800,2,3050,8.3,381.19,13067,49810,36743,442,1057,615,63946,39800,39850,39700,273,7,12,12782,1464,53,220
104900,112610,39700,2,2950,8.03,374.54,13327,49915,36588,446,1068,622,64311,39800,39800,39700,41,1,3,11276,1641,9,32
105000,112610,39750,2,3000,8.16,372.09,13513,50281,36768,457,1089,632,64866,39750,39800,39650,234,4,11,12354,1450,10,221
105100,112610,39650,2,2900,7.89,371.44,13589,50475,36886,462,1099,637,65136,39750,39750,39600,188,5,7,12804,2193,76,112
105200,112610,39700,2,2950,8.03,366.99,13789,50604,36815,468,1107,639,65465,39650,39700,39650,288,5,7,13754,1487,188,100
105300,112610,39550,2,2800,7.62,363.71,13982,50854,36872,476,1119,643,65908,39700,39700,39500,424,8,11,12419,1432,193,231
105500,112610,39500,2,2750,7.48,362.63,14113,51178,37065,483,1134,651,66363,39500,39500,39500,64,0,2,12043,1181,0,64
105600,112610,39350,2,2600,7.07,361.75,14162,51231,37069,489,1139,650,66465,39350,39350,39300,49,5,1,3984,1370,47,2
105700,112610,39450,2,2700,7.35,358.86,14335,51442,37107,494,1156,662,66849,39500,39500,39450,68,1,4,12388,1419,10,58
105800,112610,39500,2,2750,7.48,359.21,14400,51726,37326,500,1172,672,67198,39500,39500,39450,155,2,9,13492,1388,20,135
105900,112610,39550,2,2800,7.62,358.86,14443,51830,37387,508,1182,674,67345,39500,39550,39500,62,4,5,14311,1482,31,31
110000,112610,39500,2,2750,7.48,359.29,14451,51921,37470,509,1189,680,67444,39550,39550,39500,63,1,3,13683,1481,8,55
110100,112610,39500,2,2750,7.48,358.27,14527,52046,37519,513,1197,684,67645,39500,39500,39500,94,0,4,13692,1413,0,94
110200,112610,39250,2,2500,6.8,351.46,14832,52128,37296,522,1205,683,68032,39250,39300,39200,209,5,4,1691,1533,156,53
110300,112610,38950,2,2200,5.99,327.46,15929,52161,36232,533,1210,677,69162,39100,39100,38950,1099,8,2,2006,1023,1079,20
110400,112610,39050,2,2300,6.26,321.16,16282,52291,36009,545,1223,678,69645,39050,39100,39050,63,0,8,2384,1086,0,63
110500,112610,39000,2,2250,6.12,319.43,16394,52367,35973,550,1232,682,69841,39100,39100,38950,133,2,6,1758,1136,70,63
110600,112610,38850,2,2100,5.71,317.92,16520,52520,36000,556,1239,683,70120,38950,38950,38800,125,4,3,1332,1207,98,27
110700,112610,38900,2,2150,5.85,315.18,16678,52565,35887,563,1245,682,70323,38750,38900,38750,123,3,3,2331,913,102,21
110800,112610,39050,2,2300,6.26,314.22,16770,52695,35925,568,1257,689,70545,38950,39050,38950,146,3,8,2472,661,41,105
110900,112610,39250,2,2500,6.8,314.26,16797,52786,35989,574,1270,696,70663,39150,39250,39100,85,4,9,3009,248,22,63
111000,112610,39100,2,2350,6.39,314.07,16840,52889,36049,580,1278,698,70809,39200,39200,39000,84,6,5,2870,597,43,41
111100,112610,39200,2,2450,6.67,311.95,16975,52954,35979,590,1286,696,71009,39200,39200,39100,107,6,4,3193,604,72,35
111200,112610,39200,2,2450,6.67,311.5,17030,53048,36018,597,1292,695,71158,39100,39200,39100,108,4,5,3251,468,48,60
111300,112610,39200,2,2450,6.67,311.49,17053,53118,36065,601,1299,698,71251,39200,39250,39150,84,4,6,3294,1821,23,61
111400,112610,39150,2,2400,6.53,311.53,17084,53221,36137,604,1304,700,71385,39200,39250,39150,134,3,5,4492,1844,31,103
111500,112610,39150,2,2400,6.53,310.33,17167,53275,36108,609,1307,698,71522,39150,39200,39150,96,3,3,5559,2274,42,54
111600,112610,39150,2,2400,6.53,309.58,17254,53415,36161,613,1317,704,71749,39200,39200,39150,198,4,8,5224,2392,87,111
111700,112610,39100,2,2350,6.39,309.36,17314,53563,36249,617,1325,708,71957,39150,39150,39100,208,4,8,5488,2339,60,148
111800,112610,39000,2,2250,6.12,307.77,17418,53608,36190,620,1330,710,72106,39100,39100,39000,149,3,5,4898,2359,104,45
111900,112610,39050,2,2300,6.26,307.76,17475,53781,36306,624,1337,713,72336,39050,39050,39000,190,4,6,5246,2332,57,133
112000,112610,39050,2,2300,6.26,306.36,17603,53929,36326,628,1345,717,72612,39000,39050,39000,257,3,8,6001,2192,109,148
112200,112610,39050,2,2300,6.26,306.4,17636,54037,36401,629,1355,726,72753,39050,39050,39050,0,0,0,6006,2164,0,0
112300,112610,39000,2,2250,6.12,287.46,18833,54137,35304,639,1361,722,74050,39000,39000,39000,0,0,0,5032,1272,0,0
112400,112610,39050,2,2300,6.26,287.6,18846,54202,35356,641,1369,728,74128,39050,39050,39050,0,0,0,5987,1402,0,0
112500,112610,39000,2,2250,6.12,286.75,18920,54253,35333,645,1375,730,74253,39000,39000,39000,9,0,1,4965,1688,0,9
112600,112610,38950,2,2200,5.99,286.62,18950,54315,35365,648,1382,734,74345,38950,38950,38950,12,1,0,5183,1585,12,0
112700,112610,38800,2,2050,5.58,283.93,19215,54557,35342,659,1395,736,74854,38850,38850,38750,146,2,2,3582,1768,122,22
112800,112610,38750,2,2000,5.44,277.81,19643,54571,34928,669,1400,731,75296,38750,38750,38750,48,2,1,3513,1517,40,8
112900,112610,38850,2,2100,5.71,278.58,19651,54744,35093,673,1407,734,75477,38850,38850,38850,0,0,0,3566,1394,0,0
113000,112610,38850,2,2100,5.71,278.34,19695,54820,35125,679,1416,737,75597,38850,38850,38850,11,2,1,3584,1308,3,8
113100,112610,38850,2,2100,5.71,278.29,19727,54898,35171,682,1424,742,75707,38850,38850,38850,15,0,3,4021,1500,0,15
113200,112610,38850,2,2100,5.71,278.12,19774,54995,35221,687,1434,747,75851,38800,38850,38750,67,4,4,4175,1334,39,28
113300,112610,38900,2,2150,5.85,277.98,19822,55101,35279,696,1441,745,76005,38800,38900,38800,113,3,4,4151,1325,22,91
113400,112610,38850,2,2100,5.71,277.68,19871,55177,35306,702,1447,745,76130,38900,38900,38850,51,2,2,4181,1463,23,28
113500,112610,38750,2,2000,5.44,276.97,19944,55238,35294,710,1454,744,76264,38850,38850,38750,83,5,3,4084,2046,35,48
113600,112610,38850,2,2100,5.71,277.35,19952,55336,35384,714,1461,747,76370,38850,38850,38850,23,2,1,4094,1749,4,19
113700,112610,38800,2,2050,5.58,276.81,20042,55478,35436,724,1472,748,76602,38850,38900,38800,128,4,7,4104,1884,35,93
113800,112610,38950,2,2200,5.99,278.28,20066,55840,35774,726,1487,761,76988,38800,38950,38800,39,1,5,3992,1967,4,35
113900,112610,38900,2,2150,5.85,278.16,20106,55927,35821,731,1494,763,77115,38950,38950,38850,106,4,5,4511,1957,37,69
114000,112610,38950,2,2200,5.99,275.57,20329,56021,35692,740,1499,759,77432,39000,39000,38950,266,9,3,7666,1700,223,43
114100,112610,38950,2,2200,5.99,275.49,20370,56117,35747,747,1511,764,77569,39000,39050,38900,115,6,9,4502,2042,40,75
114200,112610,39000,2,2250,6.12,274.91,20428,56158,35730,754,1517,763,77668,39000,39050,38950,65,5,4,7810,1572,33,32
114300,112610,39100,2,2350,6.39,274.29,20511,56259,35748,764,1526,762,77852,39050,39100,38950,120,7,4,8190,1462,64,56
114400,112610,39100,2,2350,6.39,274.15,20563,56374,35811,770,1532,762,78019,39000,39100,39000,125,2,6,8286,1527,10,115
114500,112610,39050,2,2300,6.26,272.94,20686,56461,35775,779,1538,759,78229,39050,39100,39050,151,5,4,8672,1315,87,64
114600,112610,39100,2,2350,6.39,272.1,20798,56592,35794,789,1544,755,78472,39050,39150,39050,190,10,4,9237,926,112,78
114700,112610,39150,2,2400,6.53,271.99,20838,56678,35840,794,1550,756,78598,39150,39150,39050,125,4,6,9316,1001,39,86
114800,112610,39100,2,2350,6.39,271.42,20924,56792,35868,802,1560,758,78798,39150,39150,39050,200,8,10,8753,1437,86,114
114900,112610,39050,2,2300,6.26,270.64,21008,56856,35848,808,1563,755,78946,39100,39150,39050,148,6,3,8866,1431,84,64
115100,112610,39050,2,2300,6.26,269.75,21093,56899,35806,815,1569,754,79074,39050,39050,39050,0,0,0,9057,1404,0,0
115200,112610,39100,2,2350,6.39,269.68,21128,56977,35849,820,1574,754,79187,39100,39100,39100,0,0,0,9537,1053,0,0
115300,112610,39150,2,2400,6.53,269.85,21186,57170,35984,823,1586,763,79438,39150,39150,39150,9,0,1,9802,1013,0,9
115400,112610,39100,2,2350,6.39,268.97,21294,57274,35980,832,1594,762,79650,39100,39100,39100,10,2,0,9911,888,10,0
115500,112610,39150,2,2400,6.53,269.34,21340,57477,36137,834,1605,771,79899,39150,39150,39150,30,0,5,9723,812,0,30
115600,112610,39100,2,2350,6.39,269.03,21435,57667,36232,840,1617,777,80184,39100,39100,39100,32,1,0,9644,749,32,0
115700,112610,39150,2,2400,6.53,268.6,21516,57793,36277,847,1628,781,80391,39100,39150,39100,75,1,3,9514,762,26,49
115800,112610,39100,2,2350,6.39,268.0,21594,57871,36277,853,1636,783,80547,39150,39150,39100,99,3,3,9633,768,61,38
115900,112610,39150,2,2400,6.53,277.7,21638,60088,38450,857,1702,845,82808,39150,39250,39100,1400,1,35,7932,712,7,1393
120000,112610,39150,2,2400,6.53,277.19,21682,60101,38419,861,1705,844,82865,39150,39150,39150,10,0,2,7575,780,0,10
120100,112610,39150,2,2400,6.53,277.01,21744,60233,38489,869,1713,844,83059,39200,39250,39150,47,2,3,8079,646,11,36
120200,112610,39250,2,2500,6.8,281.62,21835,61492,39657,876,1728,852,84409,39250,39250,39250,1182,0,2,8123,559,0,1182
120300,112610,39200,2,2450,6.67,280.91,21916,61564,39648,882,1736,854,84562,39200,39250,39150,68,4,4,6858,679,40,28
120400,112610,39200,2,2450,6.67,279.78,22039,61661,39622,893,1745,852,84782,39200,39200,39150,150,6,4,6934,628,105,45
120500,112610,39200,2,2450,6.67,279.79,22063,61731,39668,898,1750,852,84876,39250,39250,39150,39,3,3,6883,598,21,18
120600,112610,39200,2,2450,6.67,279.96,22109,61897,39788,903,1758,855,85088,39250,39250,39200,32,2,1,7021,651,23,9
120700,112610,39250,2,2500,6.8,279.25,22185,61952,39767,908,1761,853,85241,39200,39250,39150,43,1,1,7105,705,3,18
120800,112610,39150,2,2400,6.53,279.13,22242,62085,39843,913,1769,856,85431,39250,39250,39150,88,1,4,6979,662,1,87
120900,112610,39150,2,2400,6.53,278.98,22291,62187,39896,919,1778,859,85582,39200,39250,39150,116,3,7,6421,776,28,88
121000,112610,39150,2,2400,6.53,279.18,22308,62280,39972,924,1785,861,85692,39100,39150,39100,13,1,1,6654,773,4,9
121100,112610,39250,2,2500,6.8,279.01,22353,62368,40015,932,1792,860,85825,39100,39250,39100,99,5,5,6836,649,40,59
121200,112610,39100,2,2350,6.39,277.86,22458,62401,39943,940,1795,855,85963,39150,39150,39100,116,7,2,6507,747,102,14
121300,112610,39150,2,2400,6.53,278.26,22462,62503,40041,944,1801,857,86069,39100,39200,39100,43,3,3,6757,1124,3,40
121400,112610,39150,2,2400,6.53,277.76,22534,62591,40057,950,1807,857,86229,39150,39250,39150,140,4,5,6847,1072,53,87
121500,112610,39200,2,2450,6.67,277.6,22575,62668,40093,956,1817,861,86347,39200,39250,39200,20,2,3,6766,1007,2,18
121600,112610,39150,2,2400,6.53,277.22,22651,62792,40141,965,1825,860,86547,39200,39200,39100,157,8,4,6435,1189,74,83
121700,112610,39150,2,2400,6.53,276.41,22749,62881,40132,970,1832,862,86734,39200,39250,39100,151,4,4,6642,1112,95,56
121800,112610,39100,2,2350,6.39,276.6,22777,63001,40224,973,1838,865,86882,39200,39200,39100,97,3,5,6784,1085,28,69
121900,112610,39050,2,2300,6.26,270.81,23288,63066,39778,982,1845,863,87458,39100,39150,39000,534,7,4,6641,1201,494,40
122000,112610,39050,2,2300,6.26,270.65,23341,63173,39832,989,1852,863,87618,39000,39050,39000,112,2,7,8126,1149,5,107
122100,112610,39000,2,2250,6.12,270.24,23412,63268,39856,997,1862,865,87784,38950,39000,38900,136,5,9,4823,1451,50,86
122200,112610,38750,2,2000,5.44,268.57,23838,64022,40184,1005,1870,865,88964,39000,39000,38750,1180,8,8,4405,1703,426,754
122300,112610,38800,2,2050,5.58,268.54,23888,64148,40260,1010,1881,871,89141,38750,38800,38700,177,5,11,4354,1758,50,126
122400,112610,38900,2,2150,5.85,268.8,23902,64249,40347,1014,1888,874,89257,38900,38950,38900,65,4,5,4342,1475,14,51
122500,112610,38800,2,2050,5.58,268.53,23944,64296,40352,1021,1894,873,89346,38900,38950,38750,89,7,6,4391,1500,42,47
122600,112610,38850,2,2100,5.71,267.66,24047,64363,40316,1032,1904,872,89516,38900,38900,38700,167,10,10,3964,1588,100,67
122700,112610,39000,2,2250,6.12,267.28,24108,64437,40329,1037,1911,874,89651,38800,39000,38800,109,5,4,4461,1093,61,48
122900,112610,38950,2,2200,5.99,266.47,24193,64466,40273,1047,1915,868,89765,38950,38950,38950,0,0,0,4425,1490,0,0
123000,112610,38850,2,2100,5.71,266.44,24218,64527,40309,1052,1924,872,89851,38850,38850,38850,1,0,1,4202,1684,0,1
123100,112610,38800,2,2050,5.58,266.7,24250,64675,40425,1056,1935,879,90031,38800,38800,38800,0,0,0,1615,1724,0,0
123200,112610,38750,2,2000,5.44,266.09,24319,64710,40391,1062,1941,879,90135,38750,38750,38750,1,0,1,1643,1691,0,1
123300,112610,38850,2,2100,5.71,266.37,24320,64780,40460,1063,1948,885,90206,38850,38850,38850,9,0,1,4132,1568,0,9
123400,112610,38750,2,2000,5.44,265.6,24426,64876,40450,1073,1958,885,90408,38800,38800,38750,18,2,0,1512,1751,18,0
123500,112610,38850,2,2100,5.71,265.76,24454,64989,40535,1078,1966,888,90549,38850,38850,38850,1,1,0,4153,1374,1,0
123600,112610,38650,2,1900,5.17,264.5,24605,65080,40475,1091,1976,885,90791,38700,38700,38650,70,4,4,763,1713,52,18
123700,112610,38850,2,2100,5.71,264.61,24630,65173,40543,1096,1987,891,90909,38850,38850,38850,10,0,2,4145,1560,0,10
123800,112610,38750,2,2000,5.44,264.27,24697,65266,40569,1106,1992,886,91069,38900,38900,38750,66,3,2,4148,1576,26,40
123900,112610,38800,2,2050,5.58,264.21,24733,65348,40615,1112,2003,891,91187,38800,38800,38800,32,1,4,4129,1545,1,31
124000,112610,38950,2,2200,5.99,264.7,24742,65492,40750,1117,2013,896,91340,38950,38950,38950,9,0,1,4463,1159,0,9
124100,112610,38700,2,1950,5.31,264.29,24818,65591,40773,1129,2023,894,91515,38800,38900,38700,120,7,6,819,1759,40,80
124200,112610,38900,2,2150,5.85,264.54,24824,65669,40845,1131,2028,897,91599,38900,38900,38900,50,0,3,4209,1586,0,50
124300,112610,38900,2,2150,5.85,263.76,24919,65726,40807,1138,2033,895,91751,38850,38900,38850,80,4,4,4271,1574,38,42
124400,112610,38750,2,2000,5.44,263.62,24958,65795,40837,1146,2040,894,91859,38750,38750,38700,73,5,5,1596,1951,27,46
124500,112610,38850,2,2100,5.71,262.71,25084,65899,40815,1154,2054,900,92089,38850,38900,38850,115,5,5,4282,1530,61,54
124600,112610,38750,2,2000,5.44,261.0,25275,65967,40692,1164,2060,896,92348,38700,38800,38700,203,7,5,1605,2080,137,66
124700,112610,38750,2,2000,5.44,259.77,25411,66010,40599,1171,2070,899,92527,38700,38750,38700,28,2,4,1077,1976,15,13
124800,112610,38800,2,2050,5.58,260.03,25491,66284,40793,1176,2078,902,92881,38800,38900,38750,111,4,4,4151,1969,53,58
124900,112610,38850,2,2100,5.71,260.09,25519,66373,40854,1182,2087,905,92998,38850,38850,38750,67,3,5,4161,1957,21,46
125000,112610,38800,2,2050,5.58,259.96,25567,66465,40898,1187,2094,907,93138,38850,38850,38800,103,4,5,1620,2124,36,67
125100,112610,38800,2,2050,5.58,257.77,25827,66573,40746,1194,2104,910,93506,38750,38800,38750,289,4,6,1597,1888,209,80
125200,112610,38700,2,1950,5.31,258.03,25850,66701,40851,1198,2110,912,93657,38750,38800,38700,151,4,6,1576,1884,23,128
125300,112610,38750,2,2000,5.44,257.98,25889,66789,40900,1204,2115,911,93784,38750,38800,38700,127,6,5,1564,1869,39,88
125400,112610,38750,2,2000,5.44,256.99,26033,66902,40869,1214,2124,910,94041,38750,38750,38700,246,8,9,1612,1814,133,113
125500,112610,38800,2,2050,5.58,256.3,26137,66988,40851,1223,2129,906,94231,38700,38850,38700,190,9,5,4188,1646,104,86
125600,112610,38800,2,2050,5.58,256.54,26141,67063,40922,1225,2138,913,94310,38800,38800,38750,79,2,9,1759,2000,4,75
125800,112610,38650,2,1900,5.17,254.77,26370,67183,40813,1234,2148,914,94659,38650,38650,38650,0,0,0,907,1858,0,0
125900,112610,38700,2,1950,5.31,254.81,26416,67311,40895,1238,2157,919,94833,38700,38700,38700,0,0,0,911,1704,0,0
130000,112610,38700,2,1950,5.31,253.87,26529,67350,40821,1244,2162,918,94985,38650,38700,38650,66,2,2,1001,1754,59,7
130100,112610,38700,2,1950,5.31,253.69,26579,67428,40849,1248,2171,923,95113,38700,38700,38700,32,0,3,609,1738,0,32
130200,112610,38700,2,1950,5.31,253.72,26599,67487,40888,1251,2174,923,95192,38700,38700,38700,44,0,1,697,1740,0,44
130300,112610,38650,2,1900,5.17,253.07,26716,67611,40895,1261,2181,920,95433,38650,38650,38650,37,2,2,332,1909,13,24
130400,112610,38700,2,1950,5.31,253.13,26718,67632,40914,1262,2186,924,95456,38700,38700,38600,20,1,3,761,1922,2,18
130500,112610,38650,2,1900,5.17,252.93,26781,67738,40957,1268,2194,926,95625,38700,38750,38600,89,4,4,689,1823,40,49
130600,112610,38700,2,1950,5.31,252.9,26809,67800,40991,1271,2204,933,95716,38700,38700,38700,35,1,2,1127,1814,1,33
130700,112610,38700,2,1950,5.31,252.6,26873,67880,41007,1275,2210,935,95860,38800,38800,38700,64,3,1,1125,1731,63,1
130800,112610,38700,2,1950,5.31,251.93,27010,68045,41035,1285,2218,933,96162,38650,38800,38650,233,6,5,1778,1759,100,133
130900,112610,38750,2,2000,5.44,251.81,27036,68079,41043,1291,2221,930,96222,38750,38750,38650,32,5,2,1130,1800,25,7
131000,112610,38750,2,2000,5.44,251.49,27089,68125,41036,1296,2230,934,96321,38700,38750,38700,76,3,6,1165,1755,33,43
131100,112610,38750,2,2000,5.44,251.6,27134,68269,41135,1299,2242,943,96510,38800,38800,38750,130,2,5,1715,1731,13,117
131200,112610,38750,2,2000,5.44,251.8,27158,68383,41225,1303,2250,947,96648,38800,38800,38750,57,2,3,1895,1751,20,37
131300,112610,38800,2,2050,5.58,251.49,27223,68462,41239,1309,2258,949,96792,38700,38800,38700,108,3,7,4503,1552,41,67
131400,112610,38750,2,2000,5.44,250.97,27285,68477,41192,1316,2263,947,96869,38800,38800,38700,73,6,5,1165,1884,58,15
131500,112610,38800,2,2050,5.58,251.37,27298,68620,41322,1319,2272,953,97025,38800,38850,38800,33,2,3,4565,1641,7,26
131600,112610,38800,2,2050,5.58,251.07,27356,68682,41326,1324,2279,955,97145,38800,38800,38750,77,4,5,4792,1623,46,31
131700,112610,38800,2,2050,5.58,250.93,27419,68803,41384,1330,2284,954,97329,38750,38850,38750,165,5,5,4667,1845,44,121
131800,112610,38800,2,2050,5.58,250.67,27497,68926,41429,1335,2290,955,97530,38800,38850,38700,157,5,5,4607,1823,78,79
132000,112610,38750,2,2000,5.44,249.99,27584,68957,41373,1341,2297,956,97648,38750,38750,38750,9,0,1,2017,1626,0,9
132100,112610,38850,2,2100,5.71,249.92,27637,69071,41434,1345,2304,959,97815,38850,38850,38850,9,0,1,4558,1345,0,9
132200,112610,38750,2,2000,5.44,249.12,27767,69174,41407,1354,2311,957,98048,38750,38750,38750,12,2,0,1901,1498,12,0
132300,112610,38700,2,1950,5.31,248.63,27832,69199,41367,1361,2315,954,98138,38750,38750,38700,6,2,1,1257,1520,5,1
132400,112610,38800,2,2050,5.58,247.97,27947,69301,41354,1370,2323,953,98355,38800,38850,38800,109,5,3,4698,1360,68,41
132500,112610,38800,2,2050,5.58,248.39,27963,69456,41493,1372,2331,959,98526,38800,38800,38800,9,1,2,2021,1544,4,5
132600,112610,38850,2,2100,5.71,248.63,27978,69561,41583,1374,2335,961,98646,38850,38850,38850,40,0,2,4595,1353,0,40
132700,112610,38750,2,2000,5.44,247.6,28127,69643,41516,1384,2343,959,98877,38750,38750,38750,112,4,3,2023,1647,94,18
132800,112610,38900,2,2150,5.85,247.42,28187,69740,41553,1390,2348,958,99034,38900,38900,38900,29,0,2,4768,1317,0,29
132900,112610,38750,2,2000,5.44,247.35,28226,69818,41592,1396,2353,957,99151,38850,38850,38750,78,4,3,1479,1658,34,44
133000,112610,38700,2,1950,5.31,246.11,28397,69887,41490,1404,2359,955,99391,38700,38700,38700,27,3,1,1455,1590,21,6
133100,112610,38600,2,1850,5.03,244.82,28625,70079,41454,1409,2370,961,99811,38650,38650,38600,143,2,4,1121,1604,46,97
133200,112610,38650,2,1900,5.17,244.53,28723,70235,41512,1416,2383,967,100065,38600,38650,38600,167,4,9,1051,1435,55,112
133300,112610,38650,2,1900,5.17,243.81,28847,70332,41485,1421,2393,972,100286,38650,38700,38650,41,2,1,1478,1170,21,20
133400,112610,38550,2,1800,4.9,243.37,28934,70416,41482,1431,2400,969,100457,38600,38600,38550,37,6,1,439,1243,21,16
133500,112610,38700,2,1950,5.31,241.45,29225,70564,41339,1443,2408,965,100896,38600,38700,38500,209,5,4,1084,1126,135,74
133600,112610,38600,2,1850,5.03,240.75,29329,70610,41281,1448,2412,964,101046,38600,38600,38550,128,5,3,369,1140,104,24
133700,112610,38600,2,1850,5.03,240.83,29354,70693,41339,1454,2417,963,101154,38700,38700,38600,85,3,3,323,1294,19,66
133800,112610,38650,2,1900,5.17,241.31,29357,70841,41484,1455,2426,971,101305,38650,38700,38600,134,1,7,369,1497,3,131
133900,112610,38550,2,1800,4.9,240.74,29442,70880,41438,1463,2429,966,101429,38500,38600,38500,62,4,3,289,1496,23,39
134000,112610,38650,2,1900,5.17,240.7,29470,70934,41464,1466,2434,968,101511,38550,38650,38550,81,3,4,343,1505,28,53
134100,112610,38700,2,1950,5.31,240.15,29567,71006,41439,1477,2440,963,101680,38650,38700,38600,169,11,6,1105,1846,97,72
134200,112610,38750,2,2000,5.44,240.11,29628,71139,41511,1483,2446,963,101875,38700,38750,38650,194,6,6,2339,1771,61,133
134300,112610,38750,2,2000,5.44,239.78,29701,71218,41517,1492,2455,963,102027,38700,38750,38700,152,9,9,1732,1779,73,79
134400,112610,38700,2,1950,5.31,239.68,29749,71301,41552,1497,2460,963,102158,38700,38750,38700,131,5,5,1150,1854,48,83
134500,112610,38650,2,1900,5.17,239.72,29815,71472,41657,1502,2474,972,102395,38700,38700,38650,237,5,14,1322,1796,66,171
134600,112610,38700,2,1950,5.31,240.1,29855,71681,41826,1505,2480,975,102644,38650,38700,38650,237,2,6,1688,1668,28,209
134800,112610,38650,2,1900,5.17,239.8,29925,71759,41834,1511,2488,977,102792,38650,38650,38650,31,1,1,460,1844,28,3
134900,112610,38650,2,1900,5.17,239.3,30010,71813,41803,1517,2495,978,102931,38650,38650,38650,0,0,0,497,1759,0,0
135000,112610,38700,2,1950,5.31,239.51,30036,71940,41904,1522,2502,980,103084,38700,38700,38700,0,0,0,2403,1618,0,0
135100,112610,38700,2,1950,5.31,238.81,30161,72027,41866,1531,2507,976,103296,38700,38700,38700,24,0,2,1355,1675,0,24
135200,112610,38650,2,1900,5.17,238.59,30198,72050,41852,1538,2511,973,103356,38650,38650,38650,8,2,0,1369,1672,8,0
135300,112610,38700,2,1950,5.31,238.92,30219,72200,41981,1541,2518,977,103527,38700,38700,38700,47,1,2,1792,1592,12,35
135400,112610,38700,2,1950,5.31,238.9,30258,72286,42028,1545,2522,977,103652,38700,38700,38700,0,0,0,1352,1668,0,0
135500,112610,38650,2,1900,5.17,238.93,30286,72361,42075,1549,2528,979,103755,38650,38650,38650,4,1,0,1809,1740,4,0
135600,112610,38750,2,2000,5.44,238.68,30371,72488,42117,1557,2536,979,103967,38650,38750,38600,114,3,4,1787,1662,20,94
135700,112610,38750,2,2000,5.44,238.83,30381,72559,42178,1560,2541,981,104048,38800,38800,38750,32,2,2,2589,1694,4,28
135800,112610,38700,2,1950,5.31,238.73,30438,72665,42227,1567,2546,979,104211,38800,38800,38700,86,2,4,1380,1759,10,76
135900,112610,38700,2,1950,5.31,238.94,30475,72818,42343,1572,2554,982,104401,38650,38750,38650,157,2,6,1777,1676,6,151
140000,112610,38800,2,2050,5.58,238.6,30551,72895,42344,1579,2558,979,104554,38800,38800,38750,104,4,2,5108,1634,64,40
140100,112610,38750,2,2000,5.44,238.26,30619,72953,42334,1585,2561,976,104680,38700,38750,38700,38,4,0,2506,1620,38,0
140200,112610,38800,2,2050,5.58,238.18,30689,73095,42406,1592,2568,976,104892,38750,38800,38750,181,4,6,2590,1623,48,133
140300,112610,38750,2,2000,5.44,238.14,30729,73179,42450,1601,2575,974,105016,38600,38750,38600,77,2,4,2227,1639,4,73
140400,112610,38800,2,2050,5.58,237.59,30820,73224,42404,1613,2577,964,105152,38750,38800,38700,122,9,2,2990,1662,77,45
140500,112610,38750,2,2000,5.44,237.18,30911,73315,42404,1626,2584,958,105334,38750,38850,38750,120,4,5,2934,1690,33,87
140600,112610,38750,2,2000,5.44,237.26,30935,73397,42462,1633,2590,957,105440,38850,38850,38750,42,6,4,2905,1688,23,19
140700,112610,38750,2,2000,5.44,236.37,31094,73497,42403,1650,2594,944,105699,38850,38850,38750,70,6,2,5442,1886,38,32
140800,112610,38750,2,2000,5.44,235.85,31184,73548,42364,1661,2598,937,105840,38800,38800,38750,54,7,1,5576,1860,32,22
140900,112610,38750,2,2000,5.44,236.33,31248,73849,42601,1673,2604,931,106205,38750,38800,38700,101,7,3,2852,1522,30,71
141000,112610,38700,2,1950,5.31,236.14,31305,73924,42619,1683,2613,930,106337,38650,38750,38600,123,8,8,2880,1532,50,73
141100,112610,38850,2,2100,5.71,236.06,31357,74022,42665,1695,2619,924,106487,38700,38850,38700,125,9,5,5488,1504,29,96
141200,112610,38700,2,1950,5.31,235.88,31431,74138,42707,1705,2626,921,106677,38800,38800,38700,144,8,6,2983,1539,40,104
141300,112610,38650,2,1900,5.17,235.56,31488,74173,42685,1715,2628,913,106769,38650,38700,38650,77,9,2,1394,1608,42,35
141400,112610,38750,2,2000,5.44,235.06,31607,74296,42689,1731,2634,903,107011,38650,38750,38600,208,14,5,2878,1673,112,96
141500,112610,38800,2,2050,5.58,234.94,31672,74409,42737,1739,2639,900,107189,38700,38800,38700,159,7,4,2895,1639,64,95
141600,112610,38750,2,2000,5.44,234.68,31715,74430,42715,1748,2642,894,107253,38750,38750,38650,64,9,3,2380,1685,43,21
141700,112610,38700,2,1950,5.31,234.22,31808,74500,42692,1762,2651,889,107416,38750,38750,38650,163,14,9,2408,1666,93,70
141900,112610,38800,2,2050,5.58,234.65,31816,74656,42840,1766,2660,894,107580,38800,38800,38800,0,0,0,3120,1671,0,0
142000,112610,38750,2,2000,5.44,234.11,31929,74748,42819,1778,2665,887,107785,38750,38750,38750,32,1,1,2365,1681,26,6
142100,112610,38800,2,2050,5.58,232.68,32169,74852,42683,1789,2670,881,108129,38800,38800,38800,20,0,1,2985,1722,0,20
142200,112610,38800,2,2050,5.58,232.45,32280,75034,42754,1802,2678,876,108422,38700,38800,38700,21,3,1,2846,1676,9,12
142300,112610,38850,2,2100,5.71,231.9,32403,75141,42738,1812,2685,873,108652,38850,38850,38850,0,0,0,6082,1219,0,0
142400,112610,38750,2,2000,5.44,231.7,32463,75217,42754,1822,2689,867,108788,38750,38750,38750,18,1,1,2492,1641,11,7
142500,112610,38650,2,1900,5.17,230.92,32591,75259,42668,1834,2694,860,108958,38650,38650,38650,4,1,0,3738,1617,4,0
142600,112610,38750,2,2000,5.44,230.77,32652,75351,42699,1842,2701,859,109111,38750,38750,38750,13,2,1,3694,1771,6,7
142700,112610,38700,2,1950,5.31,230.29,32761,75445,42684,1852,2707,855,109314,38750,38750,38700,41,3,0,3657,1757,41,0
142800,112610,38750,2,2000,5.44,230.27,32815,75563,42748,1864,2713,849,109486,38750,38750,38700,40,3,2,6276,1778,10,30
142900,112610,38850,2,2100,5.71,229.77,32939,75683,42744,1876,2719,843,109730,38900,38900,38800,104,7,3,6550,1321,61,43
143000,112610,38850,2,2100,5.71,229.23,33046,75750,42704,1885,2722,837,109904,38800,38850,38800,78,3,2,6607,1172,44,34
143100,112610,38850,2,2100,5.71,228.63,33150,75791,42641,1895,2727,832,110049,38850,38900,38850,96,6,2,6617,1255,84,12
143200,112610,38800,2,2050,5.58,227.97,33283,75876,42593,1909,2732,823,110267,38850,38900,38800,126,7,2,6571,1251,71,55
143300,112610,38750,2,2000,5.44,227.61,33364,75941,42577,1921,2735,814,110413,38800,38800,38750,106,7,2,6236,1658,66,40
143400,112610,38850,2,2100,5.71,227.13,33456,75987,42531,1932,2739,807,110551,38750,38850,38750,87,5,2,6236,1593,64,23
143500,112610,38850,2,2100,5.71,226.79,33540,76064,42524,1942,2747,805,110712,38800,38900,38800,62,8,5,6604,1227,25,37
143600,112610,38800,2,2050,5.58,225.99,33682,76118,42436,1955,2754,799,110908,38850,38950,38800,177,12,7,3648,1613,123,54
143700,112610,38800,2,2050,5.58,225.41,33795,76177,42382,1967,2759,792,111080,38750,38800,38750,136,9,4,6304,1393,81,55
143800,112610,38700,2,1950,5.31,225.24,33859,76264,42405,1977,2766,789,111231,38850,38850,38700,107,7,6,3743,1618,22,85
143900,112610,38750,2,2000,5.44,224.91,33940,76334,42394,1985,2771,786,111382,38750,38800,38750,64,7,1,6373,1611,52,12
144000,112610,38850,2,2100,5.71,224.86,34011,76476,42465,1995,2778,783,111595,38800,38900,38800,180,10,5,6621,1216,71,109
144100,112610,38800,2,2050,5.58,224.63,34071,76533,42462,2007,2782,775,111712,38800,38950,38800,115,11,4,6268,1400,58,57
144200,112610,38850,2,2100,5.71,224.74,34094,76624,42530,2013,2787,774,111826,38750,38900,38750,114,6,5,6594,1189,23,91
144300,112610,38800,2,2050,5.58,224.55,34190,76774,42584,2026,2794,768,112072,38850,38950,38800,168,8,6,6245,1383,47,121
144400,112610,38800,2,2050,5.58,224.43,34235,76834,42599,2033,2799,766,112177,38750,38850,38700,105,7,5,6329,1403,45,60
144500,112610,38850,2,2100,5.71,224.29,34300,76932,42632,2044,2803,759,112340,38800,38900,38800,151,10,4,6640,1219,53,98
144600,112610,38900,2,2150,5.85,224.04,34392,77053,42661,2053,2810,757,112553,38850,38900,38800,213,9,7,6600,1240,92,121
144800,112610,38850,2,2100,5.71,223.79,34487,77178,42691,2065,2815,750,112773,38850,38850,38850,1,1,0,6474,1212,1,0
144900,112610,38900,2,2150,5.85,223.33,34570,77206,42636,2074,2819,745,112884,38900,38900,38900,4,1,0,6905,1165,4,0
145000,112610,38850,2,2100,5.71,222.85,34674,77272,42598,2085,2827,742,113054,38850,38850,38850,2,1,0,7015,1241,2,0
145100,112610,38900,2,2150,5.85,223.15,34717,77472,42755,2094,2833,739,113297,38900,38900,38900,31,1,1,7023,1206,2,29
145200,112610,38800,2,2050,5.58,222.58,34854,77577,42723,2104,2840,736,113539,38800,38800,38700,79,5,3,6282,1604,38,41
145300,112610,38950,2,2200,5.99,222.45,34904,77644,42740,2109,2844,735,113656,38900,38950,38900,22,1,1,7046,1179,2,20
145400,112610,38850,2,2100,5.71,222.18,34994,77750,42756,2122,2850,728,113852,38850,38850,38850,16,3,0,7030,1216,16,0
145500,112610,38950,2,2200,5.99,222.13,35049,77855,42806,2132,2855,723,114012,38950,39000,38950,29,5,1,7063,1101,28,1
145600,112610,38800,2,2050,5.58,221.96,35130,77975,42845,2142,2861,719,114213,38900,38950,38800,31,6,2,6472,1345,29,2
145700,112610,38950,2,2200,5.99,221.82,35182,78039,42857,2150,2867,717,114329,38950,39000,38950,22,2,2,6988,1156,19,3
145800,112610,38850,2,2100,5.71,221.81,35247,78183,42936,2161,2873,712,114538,38900,38900,38850,54,4,2,6849,1191,19,35
145900,112610,38950,2,2200,5.99,221.48,35386,78373,42987,2171,2881,710,114867,39000,39050,38950,67,3,2,6875,1448,42,25
150000,112610,39000,2,2250,6.12,221.94,35477,78736,43259,2181,2887,706,115321,38950,39050,38950,333,5,3,9125,1788,53,280
150100,112610,39000,2,2250,6.12,222.33,35536,79008,43472,2189,2898,709,115652,38950,39050,38950,275,4,10,9071,1724,36,239
150200,112610,39000,2,2250,6.12,221.98,35673,79188,43515,2196,2904,708,115969,39050,39050,39000,262,5,4,9137,2474,129,133
150300,112610,39000,2,2250,6.12,221.89,35725,79270,43545,2202,2907,705,116103,39000,39000,39000,51,5,0,9104,2378,51,0
150400,112610,39000,2,2250,6.12,221.39,35853,79376,43523,2211,2911,700,116337,39000,39050,39000,134,3,2,9128,2289,68,66
150500,112610,39050,2,2300,6.26,220.88,35996,79508,43512,2219,2916,697,116612,39000,39050,39000,144,5,3,9128,2154,71,73
150600,112610,39000,2,2250,6.12,219.99,36170,79570,43400,2229,2919,690,116848,39050,39050,39000,169,5,3,9396,2011,107,62
150700,112610,38900,2,2150,5.85,218.36,36488,79677,43189,2236,2923,687,117273,39000,39050,38900,392,5,4,6825,1736,285,107
150800,112610,38950,2,2200,5.99,218.3,36574,79841,43267,2244,2928,684,117523,38900,39000,38900,207,6,4,6991,1604,73,134
150900,112610,38700,2,1950,5.31,213.57,37423,79923,42500,2255,2932,677,118454,38900,38950,38700,410,9,3,3855,1679,336,74
151000,112610,38700,2,1950,5.31,212.89,37567,79975,42408,2265,2938,673,118650,38750,38800,38700,147,8,5,6484,1441,114,33
151100,112610,38800,2,2050,5.58,212.7,37635,80051,42416,2271,2943,672,118794,38800,38800,38800,98,6,2,6483,1433,68,30
151200,112610,38850,2,2100,5.71,212.48,37720,80148,42428,2279,2951,672,118976,38800,38900,38750,150,8,6,6290,1619,85,65
151300,112610,38800,2,2050,5.58,212.62,37766,80299,42533,2284,2956,672,119173,38800,38900,38750,192,4,5,6390,1398,41,151
151400,112610,38700,2,1950,5.31,212.39,37840,80368,42528,2293,2962,669,119316,38800,38850,38700,143,9,6,6516,1661,74,69
151500,112610,38750,2,2000,5.44,211.12,38134,80509,42375,2303,2971,668,119751,38700,38800,38700,433,9,8,6530,1360,293,140
151700,112610,38750,2,2000,5.44,210.73,38240,80585,42345,2309,2977,668,119933,38750,38750,38750,17,0,3,6381,1471,0,17
151800,112610,38650,2,1900,5.17,209.28,38554,80687,42133,2329,2986,657,120349,38650,38800,38600,92,6,5,6421,1785,62,30
151900,112610,38700,2,1950,5.31,208.63,38699,80738,42039,2338,2990,652,120545,38650,38700,38650,68,4,0,6580,1667,68,0
152000,112610,38600,2,1850,5.03,207.9,38857,80783,41926,2344,2993,649,120748,38600,38600,38600,125,1,0,6807,2201,125,0
152000,112610,38550,2,1800,4.9,207.25,39075,80984,41909,2349,3001,652,121167,38600,38950,38550,544,6,8,7233,1948,343,201
152000,112610,38550,2,1800,4.9,207.25,39075,80984,41909,2349,3001,652,121167,38600,38950,38550,544,6,8,7233,1948,343,201
152000,112610,38550,2,1800,4.9,207.25,39075,80984,41909,2349,3001,652,121167,38600,38950,38550,544,6,8,7233,1948,343,201
152000,112610,38550,2,1800,4.9,207.25,39075,80984,41909,2349,3001,652,121167,38600,38950,38550,544,6,8,7233,1948,343,201
152000,112610,38550,2,1800,4.9,207.25,39075,80984,41909,2349,3001,652,121167,38600,38950,38550,544,6,8,7233,1948,343,201
152000,112610,38550,2,1800,4.9,207.25,39075,80984,41909,2349,3001,652,121167,38600,38950,38550,544,6,8,7233,1948,343,201
152000,112610,38550,2,1800,4.9,207.25,39075,80984,41909,2349,3001,652,121167,38600,38950,38550,544,6,8,7233,1948,343,201
152000,112610,38550,2,1800,4.9,207.25,39075,80984,41909,2349,3001,652,121167,38600,38950,38550,544,6,8,7233,1948,343,201
152000,112610,38550,2,1800,4.9,207.25,39075,80984,41909,2349,3001,652,121167,38600,38950,38550,544,6,8,7233,1948,343,201
153000,112610,38550,2,1800,4.9,207.25,39075,80984,41909,2349,3001,652,121167,38550,38550,38550,0,0,0,7234,1919,0,0
