090200,002780,2315,5,10,-0.43,9.05,4904,444,-4460,11,3,-8,12373,2320,2325,2315,1008,3,1,3307,17557,1006,2
090300,002780,2300,5,25,-1.08,8.55,15165,1297,-13868,21,6,-15,23487,2300,2300,2300,1,1,0,3322,22593,1,0
090300,002780,2285,5,40,-1.72,6.44,20165,1299,-18866,25,8,-17,28489,2300,2310,2285,5003,5,2,3223,25591,5001,2
090400,002780,2305,5,20,-0.86,26.29,21203,5575,-15628,28,13,-15,33803,2295,2305,2290,430,2,2,3827,40562,416,14
090500,002780,2310,5,15,-0.65,30.14,22250,6706,-15544,31,21,-10,35981,2305,2310,2305,986,0,3,3445,27855,0,986
090500,002780,2305,5,20,-0.86,32.14,22282,7161,-15121,34,23,-11,36468,2305,2315,2305,1473,3,5,3462,27544,32,1441
090600,002780,2305,5,20,-0.86,31.65,22626,7161,-15465,36,23,-13,36812,2305,2305,2305,20,1,0,3462,26473,20,0
090700,002780,2305,5,20,-0.86,31.65,22626,7161,-15465,36,23,-13,36812,2305,2305,2305,0,0,0,3462,26473,0,0
090800,002780,2305,5,20,-0.86,31.39,23355,7332,-16023,38,25,-13,37712,2305,2305,2305,0,0,0,3512,26476,0,0
090800,002780,2305,5,20,-0.86,31.39,23355,7332,-16023,38,25,-13,37712,2305,2305,2305,0,0,0,3512,26476,0,0
090900,002780,2315,5,10,-0.43,32.59,23847,7772,-16075,40,28,-12,38644,2295,2315,2295,81,1,1,3511,43328,80,1
090900,002780,2300,5,25,-1.08,32.59,23848,7772,-16076,41,28,-13,38645,2295,2315,2295,82,2,1,3448,30429,81,1
091000,002780,2310,5,15,-0.65,33.34,23848,7952,-15896,41,29,-12,38825,2310,2310,2310,180,0,1,3447,31256,0,180
091100,002780,2315,5,10,-0.43,34.54,23848,8236,-15612,41,31,-10,39109,2315,2315,2315,0,0,0,3585,28551,0,0
091100,002780,2325,3,0,0.0,35.9,23848,8561,-15287,41,34,-7,39434,2320,2325,2320,325,0,3,3417,15466,0,325
091200,002780,2330,2,5,0.22,39.37,23848,9390,-14458,41,41,0,40263,2330,2335,2330,655,0,5,4030,12546,0,655
091200,002780,2330,2,5,0.22,39.37,23848,9390,-14458,41,41,0,40263,2330,2335,2330,655,0,5,4030,12546,0,655
091300,002780,2325,3,0,0.0,38.89,24148,9391,-14757,42,42,0,40564,2330,2330,2325,301,1,1,6085,14113,300,1
091400,002780,2325,3,0,0.0,38.36,24481,9391,-15090,44,42,-2,40897,2325,2325,2325,333,2,0,6885,16760,333,0
091500,002780,2335,2,10,0.43,42.93,24671,10592,-14079,45,49,4,42288,2330,2335,2330,901,0,5,7166,16254,0,901
091600,002780,2335,2,10,0.43,43.2,24671,10658,-14013,45,50,5,42354,2335,2335,2335,66,0,1,7063,17587,0,66
091600,002780,2335,2,10,0.43,43.37,24672,10700,-13972,46,51,5,42397,2335,2335,2335,109,1,2,7085,13886,1,108
091700,002780,2355,2,30,1.29,54.03,25865,13975,-11890,52,62,10,46865,2350,2355,2340,1763,6,5,12028,20901,1193,570
091800,002780,2345,2,20,0.86,43.27,33539,14513,-19026,56,68,12,55077,2345,2345,2345,226,0,4,9569,15122,0,226
091900,002780,2365,2,40,1.72,47.79,35485,16957,-18528,60,77,17,59467,2360,2365,2360,300,0,2,12069,15222,0,300
091900,002780,2365,2,40,1.72,53.06,36307,19265,-17042,62,81,19,62597,2360,2365,2360,3430,2,6,15217,15324,822,2608
092000,002780,2365,2,40,1.72,56.47,36307,20502,-15805,62,84,22,63834,2365,2365,2365,719,0,2,12292,17155,0,719
092100,002780,2370,2,45,1.94,55.85,37673,21040,-16633,66,87,21,65738,2370,2370,2370,90,1,0,12428,16655,90,0
092100,002780,2370,2,45,1.94,66.42,37673,25023,-12650,66,89,23,69721,2370,2370,2370,4073,1,2,12467,17866,90,3983
092200,002780,2370,2,45,1.94,66.42,37673,25023,-12650,66,89,23,69721,2370,2370,2370,0,0,0,12467,17866,0,0
092200,002780,2370,2,45,1.94,66.68,37694,25133,-12561,67,90,23,69852,2365,2370,2365,131,1,1,13782,17774,21,110
092300,002780,2365,2,40,1.72,66.75,38400,25633,-12767,71,92,21,71058,2365,2365,2355,1206,4,2,13589,19582,706,500
092400,002780,2355,2,30,1.29,64.6,39972,25823,-14149,73,93,20,72820,2355,2355,2355,190,0,1,13379,21487,0,190
092400,002780,2350,2,25,1.08,61.87,41740,25823,-15917,75,93,18,74588,2355,2355,2350,1958,2,1,13812,20139,1768,190
092500,002780,2350,2,25,1.08,61.87,41740,25823,-15917,75,93,18,74588,2350,2350,2350,0,0,0,13812,20139,0,0
092600,002780,2345,2,20,0.86,62.03,47871,29692,-18179,77,95,18,84588,2350,2350,2345,10000,2,2,15496,16282,6131,3869
092600,002780,2340,2,15,0.65,55.22,53771,29692,-24079,81,95,14,90488,2350,2350,2340,15900,6,2,11751,13341,12031,3869
092700,002780,2340,2,15,0.65,54.38,55518,30192,-25326,83,99,16,92735,2340,2370,2340,2247,2,4,14004,14229,1747,500
092800,002780,2370,2,45,1.94,54.58,55518,30299,-25219,83,103,20,92842,2365,2370,2365,103,0,3,13170,13602,0,103
092900,002780,2350,2,25,1.08,54.7,55519,30369,-25150,84,104,20,92913,2350,2350,2350,0,0,0,14160,13609,0,0
092900,002780,2350,2,25,1.08,54.7,55519,30369,-25150,84,104,20,92913,2350,2350,2350,0,0,0,14160,13609,0,0
093000,002780,2350,2,25,1.08,54.7,55519,30369,-25150,84,104,20,92913,2350,2350,2350,0,0,0,14313,13899,0,0
093000,002780,2340,2,15,0.65,58.41,60575,35384,-25191,87,110,23,102984,2365,2365,2340,10071,3,6,14305,15341,5056,5015
093100,002780,2360,2,35,1.51,59.4,60576,35984,-24592,88,114,26,103585,2355,2365,2340,601,1,4,14785,13731,1,600
093200,002780,2355,2,30,1.29,59.36,61221,36341,-24880,90,116,26,104587,2355,2355,2355,0,0,0,14935,15550,0,0
093300,002780,2350,2,25,1.08,59.38,61221,36353,-24868,90,117,27,104599,2350,2350,2350,0,0,0,29732,18676,0,0
093300,002780,2350,2,25,1.08,59.38,61221,36353,-24868,90,117,27,104599,2350,2350,2350,0,0,0,29732,18676,0,0
093400,002780,2345,2,20,0.86,58.65,61988,36353,-25635,92,117,25,105366,2345,2345,2345,767,2,0,30091,22689,767,0
093500,002780,2345,2,20,0.86,58.6,62038,36353,-25685,93,117,24,105416,2345,2345,2345,50,1,0,33491,22409,50,0
093500,002780,2345,2,20,0.86,58.34,62316,36353,-25963,96,117,21,105694,2345,2345,2345,328,4,0,33313,22517,328,0
093600,002780,2340,2,15,0.65,54.08,67215,36353,-30862,99,117,18,110593,2345,2345,2340,4899,3,0,33368,19822,4899,0
093700,002780,2350,2,25,1.08,54.09,67215,36356,-30859,99,118,19,110596,2350,2350,2350,0,0,0,17687,20222,0,0
093700,002780,2350,2,25,1.08,54.09,67215,36356,-30859,99,118,19,110596,2350,2350,2350,0,0,0,18089,20722,0,0
093800,002780,2350,2,25,1.08,54.16,67215,36406,-30809,99,119,20,110646,2350,2350,2350,0,0,0,18489,20922,0,0
093900,002780,2350,2,25,1.08,54.16,67215,36406,-30809,99,119,20,110646,2350,2350,2350,0,0,0,18599,19284,0,0
093900,002780,2350,2,25,1.08,54.87,67215,36881,-30334,99,120,21,111121,2350,2350,2350,475,0,1,18799,18689,0,475
094000,002780,2350,2,25,1.08,54.87,67215,36881,-30334,99,120,21,111121,2350,2350,2350,0,0,0,18799,18689,0,0
094000,002780,2350,2,25,1.08,54.66,67472,36881,-30591,101,120,19,111378,2350,2350,2350,257,2,0,19554,19873,257,0
094100,002780,2350,2,25,1.08,54.66,67472,36881,-30591,101,120,19,111378,2350,2350,2350,0,0,0,19554,19873,0,0
094200,002780,2345,2,20,0.86,66.29,72303,47931,-24372,103,124,21,127259,2345,2345,2345,0,0,0,15678,18001,0,0
094200,002780,2345,2,20,0.86,66.43,72303,48031,-24272,103,125,22,127359,2345,2345,2345,100,0,1,16914,18699,0,100
094300,002780,2340,2,15,0.65,65.49,73338,48031,-25307,105,125,20,128394,2340,2340,2340,1035,2,0,16824,16989,1035,0
094300,002780,2345,2,20,0.86,65.77,73338,48231,-25107,105,126,21,128594,2340,2345,2340,1235,2,1,16829,17004,1035,200
094400,002780,2345,2,20,0.86,65.79,73338,48252,-25086,105,128,23,128615,2345,2345,2345,21,0,2,16910,15932,0,21
094500,002780,2345,2,20,0.86,65.79,73338,48252,-25086,105,128,23,128615,2345,2345,2345,0,0,0,16910,15932,0,0
094500,002780,2345,2,20,0.86,66.24,73348,48585,-24763,106,129,23,128958,2345,2345,2345,343,1,1,19164,15653,10,333
094600,002780,2350,2,25,1.08,67.26,73348,49336,-24012,106,131,25,129709,2350,2350,2350,2,0,1,18415,15743,0,2
094600,002780,2350,2,25,1.08,67.26,73348,49336,-24012,106,131,25,129709,2350,2350,2350,2,0,1,18415,15743,0,2
094700,002780,2345,2,20,0.86,67.23,73380,49336,-24044,107,131,24,129741,2345,2345,2345,32,1,0,18513,16253,32,0
094700,002780,2345,2,20,0.86,67.23,73380,49337,-24043,107,132,25,129742,2345,2345,2345,33,1,1,16154,17403,32,1
094800,002780,2345,2,20,0.86,67.23,73380,49337,-24043,107,132,25,129742,2345,2345,2345,0,0,0,16154,17403,0,0
094900,002780,2330,2,5,0.22,66.24,74486,49337,-25149,111,132,21,130848,2330,2330,2330,0,0,0,16213,17353,0,0
094900,002780,2330,2,5,0.22,66.24,74486,49337,-25149,111,132,21,130848,2330,2330,2330,0,0,0,16213,17353,0,0
095000,002780,2330,2,5,0.22,66.24,74486,49337,-25149,111,132,21,130848,2330,2330,2330,0,0,0,11743,22833,0,0
095000,002780,2330,2,5,0.22,66.15,74586,49337,-25249,112,132,20,130948,2330,2330,2330,100,1,0,11843,23608,100,0
095100,002780,2325,3,0,0.0,62.87,78475,49337,-29138,115,132,17,134837,2325,2325,2325,1065,2,0,13961,23181,1065,0
095200,002780,2330,2,5,0.22,65.22,80813,52705,-28108,117,134,17,140543,2330,2330,2330,0,0,0,8415,19596,0,0
095200,002780,2330,2,5,0.22,65.19,80853,52705,-28148,118,134,16,140583,2330,2330,2330,40,1,0,10088,18368,40,0
095300,002780,2330,2,5,0.22,65.25,80853,52757,-28096,118,136,18,140635,2330,2330,2330,0,0,0,10900,19805,0,0
095300,002780,2325,3,0,0.0,65.2,80920,52757,-28163,119,136,17,140702,2325,2325,2325,67,1,0,10898,19755,67,0
095400,002780,2330,2,5,0.22,65.25,80920,52800,-28120,119,138,19,140745,2330,2330,2330,43,0,2,10897,20562,0,43
095500,002780,2330,2,5,0.22,67.59,80920,54697,-26223,119,142,23,142642,2330,2330,2330,0,0,0,10703,20563,0,0
095500,002780,2330,2,5,0.22,67.59,80920,54697,-26223,119,142,23,142642,2330,2330,2330,0,0,0,10703,20563,0,0
095600,002780,2335,2,10,0.43,67.6,80920,54701,-26219,119,143,24,142646,2335,2335,2335,0,0,0,12838,20569,0,0
095600,002780,2335,2,10,0.43,67.6,80920,54702,-26218,119,144,25,142647,2335,2335,2335,1,0,1,12834,20569,0,1
095700,002780,2335,2,10,0.43,67.6,80920,54702,-26218,119,144,25,142647,2335,2335,2335,0,0,0,12834,20569,0,0
095800,002780,2340,2,15,0.65,68.33,80989,55337,-25652,120,147,27,143351,2340,2340,2340,69,1,0,19393,19209,69,0
095800,002780,2340,2,15,0.65,68.33,80989,55337,-25652,120,147,27,143351,2340,2340,2340,69,1,0,19393,19209,69,0
095900,002780,2340,2,15,0.65,68.33,80989,55337,-25652,120,147,27,143351,2340,2340,2340,0,0,0,19393,19209,0,0
095900,002780,2345,2,20,0.86,68.39,80989,55387,-25602,120,148,28,143401,2345,2345,2345,50,0,1,16393,20054,0,50
100000,002780,2345,2,20,0.86,68.39,80989,55387,-25602,120,148,28,143401,2345,2345,2345,0,0,0,16393,20054,0,0
100100,002780,2345,2,20,0.86,68.39,80989,55387,-25602,120,148,28,143401,2345,2345,2345,0,0,0,16635,20140,0,0
100100,002780,2340,2,15,0.65,66.78,82946,55389,-27557,121,149,28,145360,2345,2345,2340,1959,1,1,16633,16877,1957,2
100200,002780,2340,2,15,0.65,66.89,82946,55485,-27461,121,150,29,145456,2340,2340,2340,96,0,1,11426,17296,0,96
100300,002780,2340,2,15,0.65,66.89,82946,55485,-27461,121,150,29,145456,2340,2340,2340,0,0,0,11426,17296,0,0
100300,002780,2335,2,10,0.43,66.49,83446,55485,-27961,123,150,27,145956,2340,2340,2335,500,2,0,17363,16095,500,0
100400,002780,2335,2,10,0.43,66.49,83446,55485,-27961,123,150,27,145956,2335,2335,2335,0,0,0,17363,16095,0,0
100500,002780,2335,2,10,0.43,66.29,83696,55485,-28211,124,150,26,146206,2335,2335,2335,0,0,0,12721,16767,0,0
100500,002780,2335,2,10,0.43,67.08,84131,56438,-27693,126,152,26,147594,2335,2335,2335,1388,2,2,10358,20196,435,953
100600,002780,2335,2,10,0.43,67.08,84131,56438,-27693,126,152,26,147594,2335,2335,2335,0,0,0,10358,20196,0,0
100600,002780,2340,2,15,0.65,67.32,84131,56639,-27492,126,154,28,147795,2335,2340,2335,201,0,2,12471,17091,0,201
100700,002780,2340,2,15,0.65,67.32,84131,56639,-27492,126,154,28,147795,2340,2340,2340,0,0,0,12471,17091,0,0
100800,002780,2340,2,15,0.65,67.32,84131,56641,-27490,126,155,29,147797,2340,2340,2340,0,0,0,12571,16963,0,0
100800,002780,2345,2,20,0.86,67.33,84131,56642,-27489,126,156,30,147798,2345,2345,2345,1,0,1,17249,16961,0,1
100900,002780,2345,2,20,0.86,67.33,84131,56642,-27489,126,156,30,147798,2345,2345,2345,0,0,0,17249,16961,0,0
100900,002780,2345,2,20,0.86,67.33,84131,56644,-27487,126,157,31,147800,2345,2345,2345,2,0,1,17298,17540,0,2
101000,002780,2345,2,20,0.86,67.3,84162,56645,-27517,127,158,31,147832,2345,2345,2345,1,0,1,18019,17613,0,1
101000,002780,2330,2,5,0.22,67.22,84911,57075,-27836,130,160,30,149011,2345,2345,2330,1180,3,3,17588,16241,749,431
101100,002780,2345,2,20,0.86,67.22,84911,57076,-27835,130,161,31,149012,2345,2345,2345,1,0,1,17588,21983,0,1
101200,002780,2345,2,20,0.86,67.28,84911,57126,-27785,130,162,32,149062,2345,2345,2345,0,0,0,17587,21983,0,0
101200,002780,2345,2,20,0.86,67.28,84911,57126,-27785,130,162,32,149062,2345,2345,2345,0,0,0,17587,21983,0,0
101300,002780,2345,2,20,0.86,67.28,84911,57128,-27783,130,163,33,149064,2345,2345,2345,2,0,1,17537,24401,0,2
101300,002780,2345,2,20,0.86,67.28,84911,57128,-27783,130,163,33,149064,2345,2345,2345,2,0,1,17537,24401,0,2
101400,002780,2330,2,5,0.22,67.25,84951,57128,-27823,131,163,32,149104,2330,2330,2330,0,0,0,17535,24405,0,0
101400,002780,2330,2,5,0.22,67.25,84951,57128,-27823,131,163,32,149104,2330,2330,2330,0,0,0,17535,24405,0,0
101500,002780,2330,2,5,0.22,66.31,86147,57128,-29019,132,163,31,150300,2330,2330,2330,1196,1,0,12885,24377,1196,0
101600,002780,2330,2,5,0.22,66.31,86147,57128,-29019,132,163,31,150300,2330,2330,2330,0,0,0,12885,24377,0,0
101600,002780,2330,2,5,0.22,66.31,86147,57128,-29019,132,163,31,150300,2330,2330,2330,0,0,0,13035,22002,0,0
101700,002780,2330,2,5,0.22,66.31,86147,57128,-29019,132,163,31,150300,2330,2330,2330,0,0,0,13535,23064,0,0
101700,002780,2330,2,5,0.22,66.31,86157,57128,-29029,133,163,30,150310,2330,2330,2330,10,1,0,13535,24768,10,0
101800,002780,2330,2,5,0.22,66.31,86157,57128,-29029,133,163,30,150310,2330,2330,2330,0,0,0,13535,24768,0,0
101800,002780,2330,2,5,0.22,66.31,86157,57128,-29029,133,163,30,150310,2330,2330,2330,0,0,0,13535,24769,0,0
101900,002780,2330,2,5,0.22,65.97,86592,57128,-29464,134,163,29,150745,2330,2330,2330,435,1,0,13535,34938,435,0
102000,002780,2330,2,5,0.22,65.97,86592,57128,-29464,134,163,29,150745,2330,2330,2330,0,0,0,13535,34938,0,0
102000,002780,2330,2,5,0.22,65.97,86592,57128,-29464,134,163,29,150745,2330,2330,2330,0,0,0,14471,34508,0,0
102100,002780,2340,2,15,0.65,65.97,86592,57129,-29463,134,164,30,150746,2340,2340,2340,0,0,0,14470,33982,0,0
102100,002780,2340,2,15,0.65,65.98,86592,57136,-29456,134,167,33,150753,2340,2340,2340,7,0,3,14565,31984,0,7
102200,002780,2340,2,15,0.65,65.98,86592,57136,-29456,134,167,33,150753,2340,2340,2340,0,0,0,14565,31984,0,0
102200,002780,2340,2,15,0.65,65.98,86592,57136,-29456,134,167,33,150753,2340,2340,2340,0,0,0,14565,31984,0,0
102300,002780,2340,2,15,0.65,66.01,86592,57156,-29436,134,170,36,150773,2340,2340,2340,20,0,3,14746,31992,0,20
102400,002780,2340,2,15,0.65,66.01,86592,57156,-29436,134,170,36,150773,2340,2340,2340,0,0,0,14746,31992,0,0
102400,002780,2340,2,15,0.65,66.01,86592,57157,-29435,134,171,37,150774,2340,2340,2340,1,0,1,14742,31994,0,1
102500,002780,2340,2,15,0.65,66.01,86592,57160,-29432,134,173,39,150777,2340,2340,2340,0,0,0,14741,32487,0,0
102500,002780,2315,5,10,-0.43,60.84,93959,57160,-36799,138,173,35,158144,2330,2330,2315,7367,4,0,14738,32490,7367,0
102600,002780,2315,5,10,-0.43,60.84,93959,57160,-36799,138,173,35,158144,2315,2315,2315,0,0,0,14738,32490,0,0
102700,002780,2315,5,10,-0.43,60.84,93959,57160,-36799,138,173,35,158144,2315,2315,2315,0,0,0,13187,30031,0,0
102700,002780,2315,5,10,-0.43,60.84,93959,57160,-36799,138,173,35,158144,2315,2315,2315,0,0,0,13348,33338,0,0
102800,002780,2330,2,5,0.22,60.84,93959,57164,-36795,138,175,37,158148,2330,2330,2330,4,0,2,12689,40437,0,4
102800,002780,2330,2,5,0.22,60.84,93959,57164,-36795,138,175,37,158148,2330,2330,2330,4,0,2,12689,40437,0,4
102900,002780,2330,2,5,0.22,60.84,93959,57164,-36795,138,175,37,158148,2330,2330,2330,0,0,0,12689,40437,0,0
102900,002780,2330,2,5,0.22,61.92,93959,58182,-35777,138,176,38,159166,2330,2330,2330,1018,0,1,13546,43012,0,1018
103000,002780,2330,2,5,0.22,61.92,93959,58182,-35777,138,176,38,159166,2330,2330,2330,0,0,0,14945,41080,0,0
103100,002780,2330,2,5,0.22,61.92,93959,58182,-35777,138,176,38,159166,2330,2330,2330,0,0,0,14945,41684,0,0
103100,002780,2330,2,5,0.22,61.92,93959,58182,-35777,138,176,38,159166,2330,2330,2330,0,0,0,14945,34475,0,0
103200,002780,2340,2,15,0.65,62.48,93959,58709,-35250,138,177,39,159693,2340,2340,2340,527,0,1,14645,34874,0,527
103200,002780,2340,2,15,0.65,62.48,93959,58709,-35250,138,177,39,159693,2340,2340,2340,527,0,1,14645,34874,0,527
103300,002780,2340,2,15,0.65,62.49,93959,58712,-35247,138,179,41,159696,2340,2340,2340,3,0,2,15018,35482,0,3
103400,002780,2340,2,15,0.65,62.49,93959,58712,-35247,138,179,41,159696,2340,2340,2340,0,0,0,15018,35482,0,0
103400,002780,2340,2,15,0.65,62.49,93959,58712,-35247,138,179,41,159696,2340,2340,2340,0,0,0,15115,35475,0,0
103500,002780,2340,2,15,0.65,62.49,93959,58716,-35243,138,182,44,159700,2340,2340,2340,1,0,1,14932,35477,0,1
103500,002780,2340,2,15,0.65,62.49,93959,58716,-35243,138,182,44,159700,2340,2340,2340,1,0,1,14932,35477,0,1
103600,002780,2340,2,15,0.65,63.15,93959,59338,-34621,138,183,45,160322,2340,2340,2340,0,0,0,14931,35981,0,0
103600,002780,2340,2,15,0.65,63.34,93959,59517,-34442,138,184,46,160501,2340,2340,2340,179,0,1,14309,35985,0,179
103700,002780,2330,2,5,0.22,63.14,94258,59517,-34741,140,184,44,160800,2340,2340,2330,299,2,0,18560,21418,299,0
103800,002780,2345,2,20,0.86,63.15,94258,59528,-34730,140,186,46,160811,2345,2345,2345,0,0,0,18559,27032,0,0
103800,002780,2345,2,20,0.86,63.16,94258,59530,-34728,140,187,47,160813,2345,2345,2345,2,0,1,18549,27032,0,2
103900,002780,2345,2,20,0.86,63.16,94258,59530,-34728,140,187,47,160813,2345,2345,2345,0,0,0,18549,27032,0,0
103900,002780,2345,2,20,0.86,63.16,94258,59530,-34728,140,187,47,160813,2345,2345,2345,0,0,0,18820,22070,0,0
104000,002780,2345,2,20,0.86,63.16,94258,59532,-34726,140,188,48,160815,2345,2345,2345,0,0,0,21576,22074,0,0
104000,002780,2345,2,20,0.86,63.16,94258,59532,-34726,140,188,48,160815,2345,2345,2345,0,0,0,21576,22074,0,0
104100,002780,2345,2,20,0.86,63.16,94258,59532,-34726,140,188,48,160815,2345,2345,2345,0,0,0,21574,22078,0,0
104200,002780,2345,2,20,0.86,63.16,94258,59534,-34724,140,189,49,160817,2345,2345,2345,0,0,0,21574,21864,0,0
104200,002780,2345,2,20,0.86,63.16,94258,59534,-34724,140,189,49,160817,2345,2345,2345,0,0,0,21574,21864,0,0
104300,002780,2340,2,15,0.65,63.16,94258,59535,-34723,140,190,50,160818,2340,2340,2340,1,0,1,17192,21874,0,1
104300,002780,2340,2,15,0.65,63.16,94258,59535,-34723,140,190,50,160818,2340,2340,2340,1,0,1,17192,21874,0,1
104400,002780,2340,2,15,0.65,63.16,94258,59535,-34723,140,190,50,160818,2340,2340,2340,0,0,0,17191,21879,0,0
104500,002780,2340,2,15,0.65,63.16,94258,59537,-34721,140,191,51,160820,2340,2340,2340,0,0,0,17191,21883,0,0
104500,002780,2340,2,15,0.65,63.16,94258,59537,-34721,140,191,51,160820,2340,2340,2340,0,0,0,17191,21883,0,0
104600,002780,2340,2,15,0.65,63.16,94258,59537,-34721,140,191,51,160820,2340,2340,2340,0,0,0,21572,21885,0,0
104700,002780,2340,2,15,0.65,63.16,94260,59537,-34723,141,191,50,160822,2340,2340,2340,0,0,0,21572,15279,0,0
104700,002780,2335,2,10,0.43,63.16,94261,59537,-34724,142,191,49,160823,2335,2335,2335,1,1,0,21572,21893,1,0
104800,002780,2335,2,10,0.43,63.11,94331,59537,-34794,145,191,46,160893,2335,2335,2335,0,0,0,21572,21837,0,0
104800,002780,2335,2,10,0.43,63.11,94331,59537,-34794,145,191,46,160893,2335,2335,2335,0,0,0,21572,21837,0,0
104900,002780,2335,2,10,0.43,63.11,94331,59537,-34794,145,191,46,160893,2335,2335,2335,0,0,0,21572,21832,0,0
105000,002780,2335,2,10,0.43,63.11,94331,59537,-34794,145,191,46,160893,2335,2335,2335,0,0,0,21572,21836,0,0
105000,002780,2335,2,10,0.43,63.11,94331,59537,-34794,145,191,46,160893,2335,2335,2335,0,0,0,21572,21682,0,0
105100,002780,2335,2,10,0.43,63.09,94374,59537,-34837,146,191,45,160936,2335,2335,2335,0,0,0,21572,21686,0,0
105200,002780,2335,2,10,0.43,63.09,94374,59539,-34835,146,192,46,160938,2335,2335,2335,0,0,0,17199,25809,0,0
105200,002780,2335,2,10,0.43,63.09,94374,59539,-34835,146,192,46,160938,2335,2335,2335,0,0,0,17199,25809,0,0
105300,002780,2335,2,10,0.43,63.09,94374,59539,-34835,146,192,46,160938,2335,2335,2335,0,0,0,17197,25813,0,0
105300,002780,2335,2,10,0.43,63.09,94374,59541,-34833,146,193,47,160940,2335,2335,2335,2,0,1,17197,25817,0,2
105400,002780,2335,2,10,0.43,63.09,94374,59541,-34833,146,193,47,160940,2335,2335,2335,0,0,0,17197,25817,0,0
105400,002780,2330,2,5,0.22,63.06,94427,59541,-34886,147,193,46,160993,2330,2330,2330,53,1,0,17195,25825,53,0
105500,002780,2330,2,5,0.22,63.06,94427,59541,-34886,147,193,46,160993,2330,2330,2330,0,0,0,17195,25825,0,0
105600,002780,2325,3,0,0.0,62.07,95921,59541,-36380,149,193,44,162487,2325,2325,2325,0,0,0,21572,25275,0,0
105600,002780,2325,3,0,0.0,62.07,95921,59541,-36380,149,193,44,162487,2325,2325,2325,0,0,0,21572,25275,0,0
105700,002780,2325,3,0,0.0,62.07,95921,59541,-36380,149,193,44,162487,2325,2325,2325,0,0,0,22572,25009,0,0
105700,002780,2325,3,0,0.0,62.07,95921,59541,-36380,149,193,44,162487,2325,2325,2325,0,0,0,22572,25011,0,0
105800,002780,2325,3,0,0.0,62.07,95921,59541,-36380,149,193,44,162487,2325,2325,2325,0,0,0,18342,25710,0,0
105800,002780,2325,3,0,0.0,62.07,95921,59541,-36380,149,193,44,162487,2325,2325,2325,0,0,0,18343,25972,0,0
105900,002780,2325,3,0,0.0,62.07,95921,59541,-36380,149,193,44,162487,2325,2325,2325,0,0,0,18343,25973,0,0
110000,002780,2325,3,0,0.0,62.07,95921,59541,-36380,149,193,44,162487,2325,2325,2325,0,0,0,17329,26439,0,0
110000,002780,2325,3,0,0.0,62.07,95921,59541,-36380,149,193,44,162487,2325,2325,2325,0,0,0,17529,26939,0,0
110100,002780,2325,3,0,0.0,62.07,95921,59541,-36380,149,193,44,162487,2325,2325,2325,0,0,0,17529,26945,0,0
110100,002780,2340,2,15,0.65,62.07,95921,59542,-36379,149,194,45,162488,2340,2340,2340,1,0,1,17529,28523,0,1
110200,002780,2340,2,15,0.65,62.14,95921,59602,-36319,149,197,48,162548,2340,2340,2340,56,0,1,17524,29889,0,56
110200,002780,2340,2,15,0.65,62.14,95921,59603,-36318,149,198,49,162549,2340,2340,2340,57,0,2,17468,27945,0,57
110300,002780,2340,2,15,0.65,62.14,95921,59604,-36317,149,199,50,162550,2340,2340,2340,1,0,1,17467,25945,0,1
110300,002780,2335,2,10,0.43,62.14,95921,59608,-36313,149,202,53,162554,2340,2340,2335,5,0,4,15664,25945,0,5
110400,002780,2335,2,10,0.43,62.14,95921,59609,-36312,149,203,54,162555,2335,2335,2335,1,0,1,15663,25945,0,1
110500,002780,2325,3,0,0.0,61.76,96526,59618,-36908,152,205,53,163169,2325,2325,2325,200,1,0,17463,25539,200,0
110500,002780,2340,2,15,0.65,61.76,96526,59619,-36907,152,206,54,163170,2325,2340,2325,201,1,1,17463,24169,200,1
110600,002780,2340,2,15,0.65,61.77,96526,59620,-36906,152,207,55,163171,2340,2340,2340,1,0,1,17462,23061,0,1
110600,002780,2340,2,15,0.65,61.77,96526,59625,-36901,152,210,58,163176,2340,2340,2340,6,0,4,17458,24061,0,6
110700,002780,2340,2,15,0.65,61.77,96526,59626,-36900,152,211,59,163177,2340,2340,2340,1,0,1,17456,24059,0,1
110700,002780,2340,2,15,0.65,61.77,96526,59627,-36899,152,212,60,163178,2340,2340,2340,2,0,2,17455,24059,0,2
110800,002780,2340,2,15,0.65,61.78,96526,59630,-36896,152,214,62,163181,2340,2340,2340,3,0,2,17453,24559,0,3
110900,002780,2345,2,20,0.86,61.91,96526,59756,-36770,152,217,65,163307,2345,2345,2345,0,0,0,21758,22326,0,0
110900,002780,2345,2,20,0.86,61.91,96526,59762,-36764,152,219,67,163313,2345,2345,2345,6,0,2,21750,22426,0,6
111000,002780,2345,2,20,0.86,61.92,96526,59766,-36760,152,222,70,163317,2345,2345,2345,4,0,3,23748,22426,0,4
111000,002780,2345,2,20,0.86,61.92,96526,59767,-36759,152,223,71,163318,2345,2345,2345,5,0,4,23745,22425,0,5
111100,002780,2345,2,20,0.86,61.92,96526,59768,-36758,152,224,72,163319,2345,2345,2345,1,0,1,23744,22425,0,1
111200,002780,2345,2,20,0.86,61.92,96526,59771,-36755,152,226,74,163322,2345,2345,2345,0,0,0,23742,22505,0,0
111200,002780,2345,2,20,0.86,61.92,96526,59772,-36754,152,227,75,163323,2345,2345,2345,1,0,1,23740,22505,0,1
111300,002780,2345,2,20,0.86,61.92,96526,59773,-36753,152,228,76,163324,2345,2345,2345,0,0,0,23739,22505,0,0
111300,002780,2345,2,20,0.86,62.61,96526,60432,-36094,152,230,78,163983,2345,2345,2345,659,0,2,23737,22505,0,659
111400,002780,2350,2,25,1.08,62.61,96526,60433,-36093,152,231,79,163984,2350,2350,2350,0,0,0,26410,19620,0,0
111400,002780,2350,2,25,1.08,62.61,96526,60434,-36092,152,232,80,163985,2350,2350,2350,1,0,1,26409,19617,0,1
111500,002780,2350,2,25,1.08,62.62,96526,60447,-36079,152,235,83,163998,2350,2350,2350,3,0,2,27678,19617,0,3
111500,002780,2350,2,25,1.08,62.62,96526,60448,-36078,152,236,84,163999,2350,2350,2350,4,0,3,27677,17270,0,4
111600,002780,2345,2,20,0.86,62.62,96527,60449,-36078,153,237,84,164001,2350,2350,2345,2,1,1,27675,17276,1,1
111700,002780,2350,2,25,1.08,62.62,96527,60450,-36077,153,238,85,164002,2350,2350,2350,0,0,0,27675,17277,0,0
111700,002780,2350,2,25,1.08,62.9,96527,60713,-35814,153,241,88,164265,2350,2350,2350,263,0,3,27412,17277,0,263
111800,002780,2350,2,25,1.08,64.45,96527,62214,-34313,153,244,91,165766,2350,2350,2350,1500,0,2,28390,17277,0,1500
111800,002780,2350,2,25,1.08,64.33,96747,62234,-34513,154,248,94,166006,2350,2350,2350,1740,1,6,26986,17276,220,1520
111900,002780,2350,2,25,1.08,64.33,96747,62235,-34512,154,249,95,166007,2350,2350,2350,1,0,1,27070,17279,0,1
111900,002780,2345,2,20,0.86,65.59,96750,63455,-33295,155,252,97,167230,2350,2350,2345,1224,1,4,27948,16060,3,1221
112000,002780,2350,2,25,1.08,65.59,96750,63458,-33292,155,254,99,167233,2350,2350,2350,3,0,2,28457,18410,0,3
112100,002780,2345,2,20,0.86,65.25,97250,63459,-33791,156,255,99,167734,2345,2345,2345,0,0,0,25225,19635,0,0
112100,002780,2345,2,20,0.86,65.2,97332,63460,-33872,158,256,98,167817,2340,2345,2340,83,2,1,25145,21809,82,1
112200,002780,2345,2,20,0.86,65.2,97332,63462,-33870,158,258,100,167819,2345,2345,2345,1,0,1,25143,21809,0,1
112200,002780,2345,2,20,0.86,65.2,97332,63463,-33869,158,259,101,167820,2345,2345,2345,2,0,2,25471,21809,0,2
112300,002780,2345,2,20,0.86,65.2,97332,63464,-33868,158,260,102,167821,2345,2345,2345,1,0,1,25470,21809,0,1
112300,002780,2345,2,20,0.86,65.21,97332,63472,-33860,158,263,105,167829,2345,2345,2345,9,0,4,25462,21809,0,9
112400,002780,2345,2,20,0.86,65.21,97332,63472,-33860,158,263,105,167829,2345,2345,2345,0,0,0,25462,21809,0,0
112400,002780,2330,2,5,0.22,64.85,97871,63474,-34397,161,265,104,168370,2345,2345,2330,541,3,2,25459,23118,539,2
112500,002780,2345,2,20,0.86,64.86,97871,63475,-34396,161,266,105,168371,2345,2345,2345,1,0,1,25459,26704,0,1
112600,002780,2345,2,20,0.86,64.86,97871,63476,-34395,161,267,106,168372,2345,2345,2345,1,0,1,25477,26804,0,1
112600,002780,2345,2,20,0.86,64.86,97871,63476,-34395,161,267,106,168372,2345,2345,2345,1,0,1,25477,26804,0,1
112700,002780,2345,2,20,0.86,64.86,97871,63480,-34391,161,270,109,168376,2345,2345,2345,1,0,1,25473,26804,0,1
112700,002780,2345,2,20,0.86,64.86,97871,63481,-34390,161,271,110,168377,2345,2345,2345,2,0,2,25471,26804,0,2
112800,002780,2345,2,20,0.86,64.86,97871,63481,-34390,161,271,110,168377,2345,2345,2345,0,0,0,25471,26804,0,0
112800,002780,2345,2,20,0.86,64.86,97871,63483,-34388,161,273,112,168379,2345,2345,2345,2,0,2,25470,26804,0,2
112900,002780,2345,2,20,0.86,64.87,97871,63485,-34386,161,275,114,168381,2345,2345,2345,2,0,2,25468,26804,0,2
113000,002780,2335,2,10,0.43,57.58,110256,63486,-46770,167,276,109,180767,2335,2335,2335,1,0,1,20648,29274,0,1
113000,002780,2335,2,10,0.43,57.58,110256,63488,-46768,167,277,110,180769,2335,2335,2335,3,0,2,20647,27387,0,3
113100,002780,2335,2,10,0.43,57.59,110256,63494,-46762,167,279,112,180775,2335,2335,2335,6,0,2,20687,29040,0,6
113100,002780,2330,2,5,0.22,57.61,110256,63518,-46738,167,280,113,180799,2335,2335,2330,30,0,3,18749,25303,0,30
113200,002780,2335,2,10,0.43,57.61,110256,63519,-46737,167,281,114,180800,2335,2335,2335,1,0,1,22978,20360,0,1
113200,002780,2335,2,10,0.43,57.61,110256,63519,-46737,167,281,114,180800,2335,2335,2335,1,0,1,22978,20360,0,1
113300,002780,2335,2,10,0.43,57.61,110256,63519,-46737,167,281,114,180800,2335,2335,2335,0,0,0,22978,20360,0,0
113400,002780,2335,2,10,0.43,57.61,110256,63521,-46735,167,282,115,180802,2335,2335,2335,0,0,0,23984,21234,0,0
113400,002780,2335,2,10,0.43,58.05,110256,64006,-46250,167,283,116,181287,2335,2335,2335,485,0,1,24182,21444,0,485
113500,002780,2335,2,10,0.43,58.05,110256,64006,-46250,167,283,116,181287,2335,2335,2335,0,0,0,24182,21444,0,0
113500,002780,2335,2,10,0.43,58.05,110258,64006,-46252,168,283,115,181289,2335,2335,2335,2,1,0,25816,17356,2,0
113600,002780,2335,2,10,0.43,58.05,110258,64006,-46252,168,283,115,181289,2335,2335,2335,0,0,0,25816,17356,0,0
113600,002780,2335,2,10,0.43,58.05,110258,64006,-46252,168,283,115,181289,2335,2335,2335,0,0,0,25816,21443,0,0
113700,002780,2335,2,10,0.43,58.05,110258,64009,-46249,168,285,117,181292,2335,2335,2335,3,0,2,23705,21663,0,3
113700,002780,2330,2,5,0.22,58.03,110306,64009,-46297,169,285,116,181340,2335,2335,2330,51,1,2,23702,21988,48,3
113800,002780,2330,2,5,0.22,58.03,110306,64009,-46297,169,285,116,181340,2330,2330,2330,0,0,0,23702,23637,0,0
113900,002780,2330,2,5,0.22,58.03,110306,64009,-46297,169,285,116,181340,2330,2330,2330,0,0,0,23702,23637,0,0
113900,002780,2330,2,5,0.22,58.03,110306,64009,-46297,169,285,116,181340,2330,2330,2330,0,0,0,23708,22139,0,0
114000,002780,2330,2,5,0.22,58.0,110361,64010,-46351,171,286,115,181396,2330,2330,2330,10,1,0,25553,21711,10,0
114000,002780,2330,2,5,0.22,58.0,110361,64010,-46351,171,286,115,181396,2330,2330,2330,10,1,0,25553,21711,10,0
114100,002780,2330,2,5,0.22,58.0,110361,64010,-46351,171,286,115,181396,2330,2330,2330,0,0,0,25553,21711,0,0
114100,002780,2330,2,5,0.22,58.0,110361,64010,-46351,171,286,115,181396,2330,2330,2330,0,0,0,25553,21708,0,0
114200,002780,2330,2,5,0.22,58.0,110361,64010,-46351,171,286,115,181396,2330,2330,2330,0,0,0,25553,21760,0,0
114300,002780,2330,2,5,0.22,58.0,110361,64010,-46351,171,286,115,181396,2330,2330,2330,0,0,0,25553,20681,0,0
114300,002780,2330,2,5,0.22,58.0,110361,64010,-46351,171,286,115,181396,2330,2330,2330,0,0,0,25553,20726,0,0
114400,002780,2330,2,5,0.22,58.0,110361,64010,-46351,171,286,115,181396,2330,2330,2330,0,0,0,25553,21208,0,0
114400,002780,2330,2,5,0.22,58.08,110637,64260,-46377,172,287,115,181922,2330,2330,2330,526,1,1,26240,22160,276,250
114500,002780,2330,2,5,0.22,58.08,110637,64260,-46377,172,287,115,181922,2330,2330,2330,0,0,0,26240,22160,0,0
114500,002780,2330,2,5,0.22,58.08,110637,64262,-46375,172,288,116,181924,2330,2330,2330,2,0,1,24990,22673,0,2
114600,002780,2330,2,5,0.22,58.08,110637,64262,-46375,172,288,116,181924,2330,2330,2330,0,0,0,24990,22673,0,0
114600,002780,2330,2,5,0.22,58.08,110637,64262,-46375,172,288,116,181924,2330,2330,2330,0,0,0,24988,22673,0,0
114700,002780,2330,2,5,0.22,58.54,110637,64764,-45873,172,290,118,182426,2330,2330,2330,502,0,2,24986,22203,0,502
114800,002780,2330,2,5,0.22,58.72,110637,64964,-45673,172,291,119,182626,2330,2330,2330,0,0,0,24123,21337,0,0
114800,002780,2330,2,5,0.22,58.72,110637,64964,-45673,172,291,119,182626,2330,2330,2330,0,0,0,24123,21337,0,0
114900,002780,2330,2,5,0.22,58.72,110637,64966,-45671,172,292,120,182628,2330,2330,2330,0,0,0,23923,21637,0,0
114900,002780,2330,2,5,0.22,58.72,110637,64966,-45671,172,292,120,182628,2330,2330,2330,0,0,0,23923,21637,0,0
115000,002780,2330,2,5,0.22,58.72,110637,64966,-45671,172,292,120,182628,2330,2330,2330,0,0,0,23921,21637,0,0
115000,002780,2330,2,5,0.22,58.81,110637,65069,-45568,172,295,123,182731,2330,2330,2330,103,0,3,24182,22458,0,103
115100,002780,2330,2,5,0.22,58.9,110637,65169,-45468,172,296,124,182831,2330,2330,2330,100,0,1,24181,22458,0,100
115200,002780,2330,2,5,0.22,58.9,110637,65169,-45468,172,296,124,182831,2330,2330,2330,0,0,0,24181,22458,0,0
115200,002780,2330,2,5,0.22,58.9,110637,65170,-45467,172,297,125,182832,2330,2330,2330,1,0,1,24081,22358,0,1
115300,002780,2330,2,5,0.22,58.9,110637,65170,-45467,172,297,125,182832,2330,2330,2330,0,0,0,24081,22358,0,0
115300,002780,2330,2,5,0.22,58.9,110637,65170,-45467,172,297,125,182832,2330,2330,2330,0,0,0,24080,22358,0,0
115400,002780,2330,2,5,0.22,58.91,110637,65172,-45465,172,298,126,182834,2330,2330,2330,0,0,0,24080,17358,0,0
115400,002780,2330,2,5,0.22,58.91,110637,65172,-45465,172,298,126,182834,2330,2330,2330,0,0,0,24080,17358,0,0
115500,002780,2330,2,5,0.22,58.91,110637,65172,-45465,172,298,126,182834,2330,2330,2330,0,0,0,24078,17361,0,0
115500,002780,2330,2,5,0.22,59.7,110637,66051,-44586,172,300,128,183713,2330,2330,2330,879,0,2,24076,16361,0,879
115600,002780,2330,2,5,0.22,59.7,110637,66051,-44586,172,300,128,183713,2330,2330,2330,0,0,0,24076,16361,0,0
115700,002780,2330,2,5,0.22,59.7,110637,66051,-44586,172,300,128,183713,2330,2330,2330,0,0,0,23199,16361,0,0
115700,002780,2330,2,5,0.22,59.7,110637,66053,-44584,172,301,129,183715,2330,2330,2330,2,0,1,23199,16361,0,2
115800,002780,2330,2,5,0.22,59.7,110637,66053,-44584,172,301,129,183715,2330,2330,2330,0,0,0,23199,16361,0,0
115800,002780,2330,2,5,0.22,59.75,110637,66103,-44534,172,302,130,183765,2330,2330,2330,50,0,1,23197,16970,0,50
115900,002780,2330,2,5,0.22,59.75,110637,66105,-44532,172,303,131,183767,2330,2330,2330,0,0,0,23147,16770,0,0
115900,002780,2330,2,5,0.22,59.75,110637,66105,-44532,172,303,131,183767,2330,2330,2330,0,0,0,23147,16770,0,0
120000,002780,2330,2,5,0.22,59.87,110637,66235,-44402,172,304,132,183897,2330,2330,2330,130,0,1,23165,16740,0,130
120100,002780,2330,2,5,0.22,59.87,110637,66236,-44401,172,305,133,183898,2330,2330,2330,0,0,0,23035,16240,0,0
120100,002780,2330,2,5,0.22,60.14,110637,66539,-44098,172,307,135,184201,2330,2330,2330,303,0,2,23031,17065,0,303
120200,002780,2330,2,5,0.22,60.14,110637,66539,-44098,172,307,135,184201,2330,2330,2330,0,0,0,23031,17065,0,0
120200,002780,2330,2,5,0.22,60.14,110637,66541,-44096,172,308,136,184203,2330,2330,2330,2,0,1,22731,17142,0,2
120300,002780,2325,3,0,0.0,60.13,110657,66541,-44116,173,308,135,184223,2325,2325,2325,0,0,0,22729,17142,0,0
120300,002780,2325,3,0,0.0,60.13,110657,66541,-44116,173,308,135,184223,2325,2325,2325,0,0,0,22729,17142,0,0
120400,002780,2325,3,0,0.0,60.13,110657,66541,-44116,173,308,135,184223,2325,2325,2325,0,0,0,22709,17122,0,0
120500,002780,2325,3,0,0.0,59.67,111517,66541,-44976,174,308,134,185083,2325,2325,2325,0,0,0,22709,17220,0,0
120500,002780,2330,2,5,0.22,59.03,112723,66542,-46181,177,309,132,186290,2325,2330,2325,1207,3,1,22709,15978,1206,1
120600,002780,2330,2,5,0.22,59.03,112723,66544,-46179,177,310,133,186292,2330,2330,2330,0,0,0,22708,15978,0,0
120600,002780,2330,2,5,0.22,59.04,112723,66554,-46169,177,311,134,186302,2330,2330,2330,10,0,1,22696,16063,0,10
120700,002780,2330,2,5,0.22,59.04,112723,66554,-46169,177,311,134,186302,2330,2330,2330,0,0,0,22696,16063,0,0
120700,002780,2330,2,5,0.22,59.04,112723,66555,-46168,177,312,135,186303,2330,2330,2330,1,0,1,22696,17890,0,1
120800,002780,2330,2,5,0.22,59.04,112723,66555,-46168,177,312,135,186303,2330,2330,2330,0,0,0,22696,17890,0,0
120800,002780,2330,2,5,0.22,59.04,112723,66555,-46168,177,312,135,186303,2330,2330,2330,0,0,0,22695,17890,0,0
120900,002780,2330,2,5,0.22,59.04,112723,66557,-46166,177,313,136,186305,2330,2330,2330,2,0,1,22695,17890,0,2
121000,002780,2330,2,5,0.22,59.04,112723,66557,-46166,177,313,136,186305,2330,2330,2330,0,0,0,22695,17890,0,0
121000,002780,2330,2,5,0.22,59.05,112723,66559,-46164,177,314,137,186307,2330,2330,2330,2,0,1,22693,22890,0,2
121100,002780,2330,2,5,0.22,59.05,112723,66563,-46160,177,316,139,186311,2330,2330,2330,0,0,0,22689,22890,0,0
121100,002780,2330,2,5,0.22,59.05,112723,66563,-46160,177,316,139,186311,2330,2330,2330,0,0,0,22689,22890,0,0
121200,002780,2330,2,5,0.22,59.05,112723,66565,-46158,177,317,140,186313,2330,2330,2330,2,0,1,22687,22926,0,2
121200,002780,2330,2,5,0.22,59.05,112723,66565,-46158,177,317,140,186313,2330,2330,2330,2,0,1,22687,22926,0,2
121300,002780,2330,2,5,0.22,59.05,112723,66565,-46158,177,317,140,186313,2330,2330,2330,0,0,0,22685,22846,0,0
121400,002780,2330,2,5,0.22,59.14,112723,66661,-46062,177,319,142,186409,2330,2330,2330,2,0,1,22591,21139,0,2
121400,002780,2330,2,5,0.22,59.14,112723,66661,-46062,177,319,142,186409,2330,2330,2330,2,0,1,22591,21139,0,2
121500,002780,2330,2,5,0.22,59.14,112723,66661,-46062,177,319,142,186409,2330,2330,2330,0,0,0,22591,21139,0,0
121500,002780,2330,2,5,0.22,59.14,112723,66663,-46060,177,321,144,186411,2330,2330,2330,2,0,2,24776,21145,0,2
121600,002780,2330,2,5,0.22,59.14,112723,66663,-46060,177,321,144,186411,2330,2330,2330,0,0,0,24776,21145,0,0
121600,002780,2330,2,5,0.22,59.14,112723,66663,-46060,177,321,144,186411,2330,2330,2330,0,0,0,24776,21145,0,0
121700,002780,2330,2,5,0.22,59.14,112723,66665,-46058,177,322,145,186413,2330,2330,2330,2,0,1,24775,21145,0,2
121800,002780,2330,2,5,0.22,59.2,112723,66730,-45993,177,323,146,186478,2330,2330,2330,0,0,0,24773,21145,0,0
121800,002780,2330,2,5,0.22,59.2,112723,66730,-45993,177,323,146,186478,2330,2330,2330,0,0,0,24773,21145,0,0
121900,002780,2330,2,5,0.22,59.2,112723,66732,-45991,177,324,147,186480,2330,2330,2330,2,0,1,24708,20302,0,2
121900,002780,2330,2,5,0.22,59.2,112723,66732,-45991,177,324,147,186480,2330,2330,2330,2,0,1,24708,20302,0,2
122000,002780,2330,2,5,0.22,59.2,112723,66732,-45991,177,324,147,186480,2330,2330,2330,0,0,0,24708,20302,0,0
122100,002780,2320,5,5,-0.22,58.97,113243,66784,-46459,179,326,147,187052,2320,2320,2320,0,0,0,24654,20302,0,0
122100,002780,2315,5,10,-0.43,58.39,114373,66784,-47589,181,326,145,188182,2320,2320,2315,1130,2,0,24654,21106,1130,0
122200,002780,2315,5,10,-0.43,57.39,116360,66784,-49576,182,326,144,190169,2315,2315,2315,0,0,0,24654,24876,0,0
122200,002780,2315,5,10,-0.43,58.13,116360,67638,-48722,182,331,149,191023,2315,2315,2315,854,0,5,23496,26323,0,854
122300,002780,2330,2,5,0.22,58.14,116360,67648,-48712,182,332,150,191033,2330,2330,2330,0,0,0,24926,26817,0,0
122300,002780,2330,2,5,0.22,58.14,116360,67648,-48712,182,332,150,191033,2330,2330,2330,0,0,0,24926,26817,0,0
122400,002780,2330,2,5,0.22,58.14,116360,67650,-48710,182,333,151,191035,2330,2330,2330,2,0,1,28216,22536,0,2
122400,002780,2310,5,15,-0.65,56.23,120309,67650,-52659,184,333,149,194984,2330,2330,2310,3951,2,1,28214,22536,3949,2
122500,002780,2310,5,15,-0.65,57.1,120309,68701,-51608,184,337,153,196035,2310,2310,2310,1051,0,4,27197,27704,0,1051
122600,002780,2300,5,25,-1.08,53.5,129632,69351,-60281,205,338,133,206008,2300,2300,2300,0,0,0,16738,31110,0,0
122600,002780,2310,5,15,-0.65,53.5,129632,69352,-60280,205,339,134,206009,2310,2310,2310,1,0,1,13776,30696,0,1
122700,002780,2300,5,25,-1.08,53.45,129762,69353,-60409,226,340,114,206140,2290,2300,2290,4,3,1,13359,29509,3,1
122700,002780,2300,5,25,-1.08,55.58,129762,72126,-57636,226,344,118,208913,2290,2300,2290,2777,3,5,10587,31845,3,2774
122800,002780,2300,5,25,-1.08,55.8,129762,72410,-57352,226,345,119,209197,2300,2300,2300,284,0,1,10585,33777,0,284
122800,002780,2300,5,25,-1.08,55.8,129762,72410,-57352,226,345,119,209197,2300,2300,2300,284,0,1,10585,33777,0,284
122900,002780,2300,5,25,-1.08,55.8,129762,72410,-57352,226,345,119,209197,2300,2300,2300,0,0,0,13775,35552,0,0
123000,002780,2300,5,25,-1.08,55.8,129762,72410,-57352,226,345,119,209197,2300,2300,2300,0,0,0,13775,32622,0,0
123000,002780,2300,5,25,-1.08,55.8,129762,72410,-57352,226,345,119,209197,2300,2300,2300,0,0,0,13775,32652,0,0
123100,002780,2305,5,20,-0.86,55.86,129763,72488,-57275,227,349,122,209276,2305,2305,2305,0,0,0,10580,38052,0,0
123100,002780,2310,5,15,-0.65,55.86,129764,72490,-57274,228,350,122,209279,2305,2310,2305,3,1,1,14040,32622,1,2
123200,002780,2310,5,15,-0.65,55.86,129764,72490,-57274,228,350,122,209279,2310,2310,2310,0,0,0,14040,32622,0,0
123200,002780,2310,5,15,-0.65,57.13,129764,74132,-55632,228,352,124,210921,2310,2310,2310,1642,0,2,14038,32856,0,1642
123300,002780,2310,5,15,-0.65,57.13,129764,74132,-55632,228,352,124,210921,2310,2310,2310,0,0,0,14038,32856,0,0
123400,002780,2315,5,10,-0.43,57.13,129764,74133,-55631,228,353,125,210922,2315,2315,2315,0,0,0,13731,23908,0,0
123400,002780,2315,5,10,-0.43,57.13,129764,74140,-55624,228,356,128,210929,2315,2315,2315,7,0,3,14025,23926,0,7
123500,002780,2315,5,10,-0.43,57.13,129764,74140,-55624,228,356,128,210929,2315,2315,2315,0,0,0,14025,23926,0,0
123500,002780,2315,5,10,-0.43,57.13,129764,74140,-55624,228,356,128,210929,2315,2315,2315,0,0,0,14022,23926,0,0
123600,002780,2315,5,10,-0.43,57.14,129764,74142,-55622,228,357,129,210931,2315,2315,2315,0,0,0,14022,23926,0,0
123600,002780,2315,5,10,-0.43,57.14,129764,74142,-55622,228,357,129,210931,2315,2315,2315,0,0,0,14022,23926,0,0
123700,002780,2300,5,25,-1.08,57.0,130084,74142,-55942,231,357,126,211251,2310,2310,2300,320,3,0,14130,24155,320,0
123800,002780,2325,3,0,0.0,57.41,130281,74800,-55481,232,359,127,212106,2325,2325,2325,0,0,0,23094,28823,0,0
123800,002780,2325,3,0,0.0,57.41,130301,74800,-55501,233,359,126,212126,2325,2325,2325,20,1,0,23094,28646,20,0
123900,002780,2325,3,0,0.0,57.41,130301,74800,-55501,233,359,126,212126,2325,2325,2325,0,0,0,23094,28646,0,0
123900,002780,2325,3,0,0.0,57.41,130301,74801,-55500,233,360,127,212127,2325,2325,2325,1,0,1,18204,29927,0,1
124000,002780,2325,3,0,0.0,57.41,130301,74801,-55500,233,360,127,212127,2325,2325,2325,0,0,0,18204,29927,0,0
124000,002780,2325,3,0,0.0,57.41,130301,74801,-55500,233,360,127,212127,2325,2325,2325,0,0,0,13072,29927,0,0
124100,002780,2320,5,5,-0.22,57.41,130301,74808,-55493,233,362,129,212134,2320,2320,2320,0,0,0,12867,30115,0,0
124100,002780,2320,5,5,-0.22,57.41,130301,74808,-55493,233,362,129,212134,2320,2320,2320,0,0,0,12867,30115,0,0
124200,002780,2320,5,5,-0.22,57.41,130301,74808,-55493,233,362,129,212134,2320,2320,2320,0,0,0,18498,30115,0,0
124300,002780,2305,5,20,-0.86,57.38,130551,74912,-55639,234,365,131,212488,2305,2305,2305,250,1,0,19088,30979,250,0
124300,002780,2305,5,20,-0.86,57.38,130551,74912,-55639,234,365,131,212488,2305,2305,2305,250,1,0,19088,30979,250,0
124400,002780,2305,5,20,-0.86,57.38,130551,74912,-55639,234,365,131,212488,2305,2305,2305,0,0,0,19088,30979,0,0
124400,002780,2305,5,20,-0.86,57.38,130551,74912,-55639,234,365,131,212488,2305,2305,2305,0,0,0,19088,30817,0,0
124500,002780,2305,5,20,-0.86,57.38,130551,74912,-55639,234,365,131,212488,2305,2305,2305,0,0,0,19088,30719,0,0
124500,002780,2305,5,20,-0.86,57.38,130551,74912,-55639,234,365,131,212488,2305,2305,2305,0,0,0,19188,31484,0,0
124600,002780,2305,5,20,-0.86,57.38,130551,74912,-55639,234,365,131,212488,2305,2305,2305,0,0,0,13456,27002,0,0
124700,002780,2320,5,5,-0.22,57.38,130551,74913,-55638,234,366,132,212489,2320,2320,2320,0,0,0,13456,27003,0,0
124700,002780,2320,5,5,-0.22,57.38,130551,74913,-55638,234,366,132,212489,2320,2320,2320,0,0,0,13456,27003,0,0
124800,002780,2320,5,5,-0.22,57.39,130551,74920,-55631,234,368,134,212496,2320,2320,2320,0,0,0,13453,28201,0,0
124800,002780,2320,5,5,-0.22,57.46,130551,75020,-55531,234,369,135,212596,2320,2320,2320,100,0,1,13448,27701,0,100
124900,002780,2320,5,5,-0.22,57.46,130551,75020,-55531,234,369,135,212596,2320,2320,2320,0,0,0,13448,27701,0,0
124900,002780,2320,5,5,-0.22,57.47,130551,75024,-55527,234,371,137,212600,2320,2320,2320,4,0,2,13348,27701,0,4
125000,002780,2310,5,15,-0.65,57.42,130651,75024,-55627,236,371,135,212700,2310,2310,2310,0,0,0,13344,27699,0,0
125100,002780,2320,5,5,-0.22,57.43,130651,75028,-55623,236,374,138,212704,2320,2320,2320,3,0,2,13343,27651,0,3
125100,002780,2320,5,5,-0.22,57.43,130651,75028,-55623,236,374,138,212704,2320,2320,2320,3,0,2,13343,27651,0,3
125200,002780,2320,5,5,-0.22,57.43,130651,75028,-55623,236,374,138,212704,2320,2320,2320,0,0,0,13343,27651,0,0
125200,002780,2320,5,5,-0.22,57.43,130651,75030,-55621,236,375,139,212706,2320,2320,2320,2,0,1,18972,30066,0,2
125300,002780,2320,5,5,-0.22,57.43,130651,75030,-55621,236,375,139,212706,2320,2320,2320,0,0,0,18972,30066,0,0
125300,002780,2320,5,5,-0.22,57.43,130651,75030,-55621,236,375,139,212706,2320,2320,2320,0,0,0,18972,30066,0,0
125400,002780,2320,5,5,-0.22,57.43,130651,75031,-55620,236,376,140,212707,2320,2320,2320,1,0,1,18985,30096,0,1
125500,002780,2320,5,5,-0.22,57.43,130651,75031,-55620,236,376,140,212707,2320,2320,2320,0,0,0,18985,30096,0,0
125500,002780,2320,5,5,-0.22,57.43,130651,75032,-55619,236,377,141,212708,2320,2320,2320,1,0,1,18984,31213,0,1
125600,002780,2315,5,10,-0.43,57.69,130651,75368,-55283,236,379,143,213044,2320,2320,2315,336,0,2,13381,30977,0,336
125600,002780,2315,5,10,-0.43,57.64,130751,75368,-55383,237,379,142,213144,2320,2320,2315,436,1,2,18679,26793,100,336
125700,002780,2315,5,10,-0.43,57.55,131089,75446,-55643,238,380,142,213560,2315,2315,2315,416,1,1,13807,30563,338,78
125800,002780,2320,5,5,-0.22,58.62,131089,76846,-54243,238,382,144,214960,2320,2320,2320,400,0,1,18287,25487,0,400
125800,002780,2320,5,5,-0.22,58.62,131089,76846,-54243,238,382,144,214960,2320,2320,2320,400,0,1,18287,25487,0,400
125900,002780,2320,5,5,-0.22,58.67,131089,76913,-54176,238,384,146,215027,2320,2320,2320,67,0,2,17824,26220,0,67
130000,002780,2320,5,5,-0.22,58.68,131089,76923,-54166,238,385,147,215037,2320,2320,2320,0,0,0,17822,26220,0,0
130000,002780,2320,5,5,-0.22,58.68,131089,76923,-54166,238,385,147,215037,2320,2320,2320,0,0,0,17822,26220,0,0
130100,002780,2320,5,5,-0.22,58.68,131089,76924,-54165,238,386,148,215038,2320,2320,2320,1,0,1,17886,27101,0,1
130200,002780,2310,5,15,-0.65,58.66,131412,77089,-54323,241,387,146,215526,2310,2310,2310,0,0,0,23110,22644,0,0
130200,002780,2310,5,15,-0.65,58.66,131412,77089,-54323,241,387,146,215526,2310,2310,2310,0,0,0,23110,22644,0,0
130300,002780,2330,2,5,0.22,58.66,131412,77090,-54322,241,388,147,215527,2330,2330,2330,1,0,1,23110,32909,0,1
130400,002780,2330,2,5,0.22,58.66,131412,77090,-54322,241,388,147,215527,2330,2330,2330,0,0,0,23110,32909,0,0
130400,002780,2310,5,15,-0.65,57.3,135412,77590,-57822,244,389,145,220027,2320,2320,2310,4500,3,1,19219,28566,4000,500
130500,002780,2320,5,5,-0.22,56.91,136333,77590,-58743,245,389,144,220948,2320,2320,2320,0,0,0,19245,29293,0,0
130500,002780,2320,5,5,-0.22,57.23,136503,78120,-58383,246,390,144,221648,2320,2320,2320,700,1,1,20326,27680,170,530
130600,002780,2310,5,15,-0.65,57.02,137003,78122,-58881,247,391,144,222150,2320,2320,2310,502,1,1,14692,33845,500,2
130700,002780,2330,2,5,0.22,57.83,137003,79222,-57781,247,393,146,223250,2330,2330,2330,0,0,0,19624,33823,0,0
130700,002780,2330,2,5,0.22,57.83,137003,79222,-57781,247,393,146,223250,2330,2330,2330,0,0,0,19624,33823,0,0
130800,002780,2330,2,5,0.22,57.86,137003,79276,-57727,247,396,149,223304,2330,2330,2330,0,0,0,24809,32947,0,0
130800,002780,2330,2,5,0.22,58.52,137003,80171,-56832,247,398,151,224199,2330,2330,2330,895,0,2,21869,28836,0,895
130900,002780,2330,2,5,0.22,58.52,137004,80171,-56833,248,398,150,224200,2330,2330,2330,1,1,0,23818,22128,1,0
131000,002780,2330,2,5,0.22,58.52,137004,80171,-56833,248,398,150,224200,2330,2330,2330,0,0,0,23818,22128,0,0
131000,002780,2330,2,5,0.22,58.52,137004,80171,-56833,248,398,150,224200,2330,2330,2330,0,0,0,23818,22128,0,0
131100,002780,2330,2,5,0.22,58.52,137006,80171,-56835,249,398,149,224202,2330,2330,2330,2,1,0,24018,22532,2,0
131200,002780,2330,2,5,0.22,58.52,137006,80171,-56835,249,398,149,224202,2330,2330,2330,0,0,0,24018,22532,0,0
131200,002780,2330,2,5,0.22,58.56,137006,80231,-56775,249,401,152,224262,2330,2330,2330,60,0,3,22145,37051,0,60
131300,002780,2330,2,5,0.22,58.56,137006,80233,-56773,249,402,153,224264,2330,2330,2330,0,0,0,22125,37151,0,0
131300,002780,2330,2,5,0.22,58.56,137006,80233,-56773,249,402,153,224264,2330,2330,2330,0,0,0,22125,37151,0,0
131400,002780,2330,2,5,0.22,58.59,137006,80271,-56735,249,403,154,224302,2330,2330,2330,38,0,1,21323,37151,0,38
131500,002780,2320,5,5,-0.22,58.58,137029,80271,-56758,250,403,153,224327,2320,2320,2320,23,1,0,23218,33030,23,0
131500,002780,2320,5,5,-0.22,58.58,137029,80271,-56758,250,403,153,224327,2320,2320,2320,23,1,0,23218,33030,23,0
131600,002780,2320,5,5,-0.22,58.32,137640,80271,-57369,251,403,152,224938,2320,2320,2320,611,1,0,23218,33059,611,0
131700,002780,2320,5,5,-0.22,58.32,137640,80271,-57369,251,403,152,224938,2320,2320,2320,0,0,0,23218,33059,0,0
131700,002780,2335,2,10,0.43,58.33,137640,80282,-57358,251,414,163,224949,2335,2335,2335,11,0,11,23715,32490,0,11
131800,002780,2335,2,10,0.43,58.33,137640,80283,-57357,251,415,164,224950,2335,2335,2335,0,0,0,23707,32490,0,0
131800,002780,2335,2,10,0.43,58.33,137640,80283,-57357,251,415,164,224950,2335,2335,2335,0,0,0,23707,32490,0,0
131900,002780,2335,2,10,0.43,58.33,137640,80283,-57357,251,415,164,224950,2335,2335,2335,0,0,0,23706,32502,0,0
132000,002780,2335,2,10,0.43,58.33,137640,80285,-57355,251,416,165,224952,2335,2335,2335,0,0,0,23556,32502,0,0
132000,002780,2335,2,10,0.43,58.33,137640,80285,-57355,251,416,165,224952,2335,2335,2335,0,0,0,23556,32502,0,0
132100,002780,2320,5,5,-0.22,58.14,138099,80289,-57810,252,418,166,225415,2335,2335,2320,463,1,2,23984,32641,459,4
132200,002780,2320,5,5,-0.22,58.14,138099,80289,-57810,252,418,166,225415,2320,2320,2320,0,0,0,23984,32641,0,0
132200,002780,2320,5,5,-0.22,58.14,138099,80289,-57810,252,418,166,225415,2320,2320,2320,0,0,0,23984,32182,0,0
132300,002780,2320,5,5,-0.22,58.14,138099,80289,-57810,252,418,166,225415,2320,2320,2320,0,0,0,23984,32274,0,0
132300,002780,2320,5,5,-0.22,58.14,138099,80289,-57810,252,418,166,225415,2320,2320,2320,0,0,0,23983,32614,0,0
132400,002780,2320,5,5,-0.22,58.14,138101,80289,-57812,253,418,165,225417,2320,2320,2320,2,1,0,23983,32614,2,0
132500,002780,2320,5,5,-0.22,58.14,138105,80289,-57816,254,418,164,225421,2320,2320,2320,0,0,0,23983,32625,0,0
132500,002780,2320,5,5,-0.22,58.14,138105,80289,-57816,254,418,164,225421,2320,2320,2320,0,0,0,23983,32625,0,0
132600,002780,2320,5,5,-0.22,58.14,138105,80289,-57816,254,418,164,225421,2320,2320,2320,0,0,0,23983,32621,0,0
132700,002780,2320,5,5,-0.22,58.14,138105,80289,-57816,254,418,164,225421,2320,2320,2320,0,0,0,23983,32623,0,0
132700,002780,2335,2,10,0.43,58.15,138105,80309,-57796,254,419,165,225441,2335,2335,2335,20,0,1,23983,32635,0,20
132800,002780,2335,2,10,0.43,58.15,138105,80313,-57792,254,421,167,225445,2335,2335,2335,4,0,2,27693,32640,0,4
132900,002780,2335,2,10,0.43,58.15,138105,80313,-57792,254,421,167,225445,2335,2335,2335,0,0,0,27693,32640,0,0
132900,002780,2335,2,10,0.43,58.15,138105,80313,-57792,254,421,167,225445,2335,2335,2335,0,0,0,27689,32650,0,0
133000,002780,2320,5,5,-0.22,58.05,138356,80313,-58043,255,421,166,225696,2320,2320,2320,0,0,0,27689,32650,0,0
133000,002780,2320,5,5,-0.22,58.05,138356,80313,-58043,255,421,166,225696,2320,2320,2320,0,0,0,27689,32650,0,0
133100,002780,2320,5,5,-0.22,58.05,138356,80313,-58043,255,421,166,225696,2320,2320,2320,0,0,0,25266,32448,0,0
133200,002780,2320,5,5,-0.22,57.88,138846,80363,-58483,256,423,167,226236,2320,2320,2320,0,0,0,20366,35851,0,0
133200,002780,2320,5,5,-0.22,58.19,138846,80794,-58052,256,424,168,226667,2320,2320,2320,431,0,1,19905,35851,0,431
133300,002780,2320,5,5,-0.22,58.19,138846,80795,-58051,256,425,169,226668,2320,2320,2320,1,0,1,19905,35863,0,1
133300,002780,2320,5,5,-0.22,59.34,138846,82395,-56451,256,426,170,228268,2320,2320,2320,1601,0,2,19904,35863,0,1601
133400,002780,2320,5,5,-0.22,59.34,138846,82395,-56451,256,426,170,228268,2320,2320,2320,0,0,0,19904,35863,0,0
133500,002780,2320,5,5,-0.22,59.38,138846,82453,-56393,256,429,173,228326,2320,2320,2320,24,0,1,18970,35575,0,24
133500,002780,2320,5,5,-0.22,59.38,138846,82453,-56393,256,429,173,228326,2320,2320,2320,24,0,1,18970,35575,0,24
133600,002780,2320,5,5,-0.22,59.38,138846,82453,-56393,256,429,173,228326,2320,2320,2320,0,0,0,24336,35571,0,0
133700,002780,2320,5,5,-0.22,59.38,138846,82453,-56393,256,429,173,228326,2320,2320,2320,0,0,0,24336,31767,0,0
133700,002780,2320,5,5,-0.22,59.38,138846,82453,-56393,256,429,173,228326,2320,2320,2320,0,0,0,24336,31813,0,0
133800,002780,2320,5,5,-0.22,59.38,138846,82453,-56393,256,429,173,228326,2320,2320,2320,0,0,0,24336,31813,0,0
133900,002780,2320,5,5,-0.22,59.38,138846,82453,-56393,256,429,173,228326,2320,2320,2320,0,0,0,24336,32825,0,0
133900,002780,2320,5,5,-0.22,59.38,138846,82453,-56393,256,429,173,228326,2320,2320,2320,0,0,0,24336,32837,0,0
134000,002780,2330,2,5,0.22,59.27,139136,82463,-56673,257,430,173,228626,2330,2330,2330,0,0,0,26759,30227,0,0
134000,002780,2330,2,5,0.22,59.27,139136,82463,-56673,257,430,173,228626,2330,2330,2330,0,0,0,26759,30227,0,0
134100,002780,2320,5,5,-0.22,59.21,139276,82463,-56813,258,430,172,228766,2320,2320,2320,140,1,0,26759,33097,140,0
134200,002780,2315,5,10,-0.43,60.1,139777,84003,-55774,259,431,172,230807,2315,2315,2315,0,0,0,20477,40476,0,0
134200,002780,2315,5,10,-0.43,60.1,139777,84003,-55774,259,431,172,230807,2315,2315,2315,0,0,0,24327,36276,0,0
134300,002780,2315,5,10,-0.43,60.1,139777,84003,-55774,259,431,172,230807,2315,2315,2315,0,0,0,24327,36276,0,0
134300,002780,2315,5,10,-0.43,60.1,139777,84003,-55774,259,431,172,230807,2315,2315,2315,0,0,0,24327,36890,0,0
134400,002780,2315,5,10,-0.43,60.1,139777,84003,-55774,259,431,172,230807,2315,2315,2315,0,0,0,24327,37347,0,0
134500,002780,2315,5,10,-0.43,60.1,139777,84003,-55774,259,431,172,230807,2315,2315,2315,0,0,0,24327,37347,0,0
134500,002780,2315,5,10,-0.43,60.1,139777,84003,-55774,259,431,172,230807,2315,2315,2315,0,0,0,24327,37527,0,0
134600,002780,2315,5,10,-0.43,60.1,139777,84003,-55774,259,431,172,230807,2315,2315,2315,0,0,0,24327,37527,0,0
134700,002780,2315,5,10,-0.43,60.1,139777,84003,-55774,259,431,172,230807,2315,2315,2315,0,0,0,24327,37527,0,0
134700,002780,2315,5,10,-0.43,60.1,139777,84003,-55774,259,431,172,230807,2315,2315,2315,0,0,0,19137,37543,0,0
134800,002780,2315,5,10,-0.43,60.1,139777,84003,-55774,259,431,172,230807,2315,2315,2315,0,0,0,19137,38243,0,0
134800,002780,2325,3,0,0.0,60.1,139777,84004,-55773,259,432,173,230808,2325,2325,2325,1,0,1,19137,38344,0,1
134900,002780,2325,3,0,0.0,60.1,139777,84004,-55773,259,432,173,230808,2325,2325,2325,0,0,0,19137,38344,0,0
135000,002780,2325,3,0,0.0,60.15,139777,84082,-55695,259,438,179,230886,2325,2325,2325,0,0,0,19101,38756,0,0
135000,002780,2325,3,0,0.0,60.15,139777,84082,-55695,259,438,179,230886,2325,2325,2325,0,0,0,19101,38756,0,0
135100,002780,2325,3,0,0.0,60.15,139777,84082,-55695,259,438,179,230886,2325,2325,2325,0,0,0,19153,40750,0,0
135200,002780,2325,3,0,0.0,60.17,139777,84107,-55670,259,441,182,230911,2325,2325,2325,0,0,0,19159,38396,0,0
135200,002780,2325,3,0,0.0,60.17,139777,84108,-55669,259,442,183,230912,2325,2325,2325,1,0,1,19138,38576,0,1
135300,002780,2320,5,5,-0.22,60.11,139932,84108,-55824,261,442,181,231067,2320,2320,2320,0,0,0,19237,38488,0,0
135300,002780,2320,5,5,-0.22,60.11,139932,84111,-55821,261,444,183,231070,2320,2320,2320,3,0,2,13654,42261,0,3
135400,002780,2320,5,5,-0.22,60.34,139932,84440,-55492,261,445,184,231399,2320,2320,2320,0,0,0,13651,42260,0,0
135500,002780,2320,5,5,-0.22,60.34,139932,84440,-55492,261,445,184,231399,2320,2320,2320,0,0,0,19387,41987,0,0
135500,002780,2320,5,5,-0.22,60.34,139932,84440,-55492,261,445,184,231399,2320,2320,2320,0,0,0,19387,37991,0,0
135600,002780,2320,5,5,-0.22,60.34,139932,84440,-55492,261,445,184,231399,2320,2320,2320,0,0,0,19387,37116,0,0
135600,002780,2320,5,5,-0.22,60.34,139932,84440,-55492,261,445,184,231399,2320,2320,2320,0,0,0,19387,37116,0,0
135700,002780,2320,5,5,-0.22,60.34,139932,84440,-55492,261,445,184,231399,2320,2320,2320,0,0,0,19387,37929,0,0
135800,002780,2320,5,5,-0.22,60.34,139932,84440,-55492,261,445,184,231399,2320,2320,2320,0,0,0,19387,37929,0,0
135800,002780,2320,5,5,-0.22,60.34,139932,84440,-55492,261,445,184,231399,2320,2320,2320,0,0,0,19477,37929,0,0
135900,002780,2320,5,5,-0.22,60.34,139932,84440,-55492,261,445,184,231399,2320,2320,2320,0,0,0,19481,37931,0,0
140000,002780,2320,5,5,-0.22,60.34,139932,84440,-55492,261,445,184,231399,2320,2320,2320,0,0,0,19481,37943,0,0
140000,002780,2320,5,5,-0.22,60.34,139932,84440,-55492,261,445,184,231399,2320,2320,2320,0,0,0,19482,37945,0,0
140100,002780,2320,5,5,-0.22,60.27,140112,84440,-55672,262,445,183,231579,2320,2320,2320,180,1,0,19962,37945,180,0
140200,002780,2320,5,5,-0.22,60.09,140512,84440,-56072,264,445,181,231979,2320,2320,2320,0,0,0,19962,37565,0,0
140200,002780,2320,5,5,-0.22,60.09,140512,84440,-56072,264,445,181,231979,2320,2320,2320,0,0,0,19962,37565,0,0
140300,002780,2320,5,5,-0.22,60.09,140517,84440,-56077,265,445,180,231984,2320,2320,2320,5,1,0,19962,36617,5,0
140300,002780,2320,5,5,-0.22,60.09,140517,84440,-56077,265,445,180,231984,2320,2320,2320,5,1,0,19962,36617,5,0
140400,002780,2320,5,5,-0.22,60.09,140517,84440,-56077,265,445,180,231984,2320,2320,2320,0,0,0,19962,31614,0,0
140500,002780,2320,5,5,-0.22,60.09,140517,84440,-56077,265,445,180,231984,2320,2320,2320,0,0,0,19962,31664,0,0
140500,002780,2315,5,10,-0.43,58.92,143322,84440,-58882,270,445,175,234789,2320,2320,2315,2805,5,0,19962,31187,2805,0
140600,002780,2315,5,10,-0.43,58.92,143322,84440,-58882,270,445,175,234789,2315,2315,2315,0,0,0,19962,31187,0,0
140700,002780,2315,5,10,-0.43,58.24,144977,84440,-60537,271,445,174,236444,2315,2315,2315,0,0,0,19962,36719,0,0
140700,002780,2315,5,10,-0.43,58.24,144977,84440,-60537,271,445,174,236444,2315,2315,2315,0,0,0,19962,36719,0,0
140800,002780,2315,5,10,-0.43,58.24,144977,84440,-60537,271,445,174,236444,2315,2315,2315,0,0,0,13917,35118,0,0
140800,002780,2315,5,10,-0.43,58.11,145312,84441,-60871,272,446,174,236780,2320,2320,2315,336,1,1,13916,35426,335,1
140900,002780,2315,5,10,-0.43,58.11,145312,84441,-60871,272,446,174,236780,2315,2315,2315,0,0,0,13916,35426,0,0
141000,002780,2315,5,10,-0.43,58.11,145312,84441,-60871,272,446,174,236780,2315,2315,2315,0,0,0,13916,37091,0,0
141000,002780,2325,3,0,0.0,58.96,145792,85961,-59831,273,448,175,238780,2320,2325,2320,2000,1,2,23816,31745,480,1520
141100,002780,2325,3,0,0.0,58.96,145792,85961,-59831,273,448,175,238780,2325,2325,2325,0,0,0,23816,31745,0,0
141200,002780,2325,3,0,0.0,58.62,146643,85961,-60682,275,448,173,239631,2325,2325,2325,0,0,0,23916,32113,0,0
141200,002780,2325,3,0,0.0,58.62,146643,85961,-60682,275,448,173,239631,2325,2325,2325,0,0,0,23916,32113,0,0
141300,002780,2325,3,0,0.0,58.62,146643,85961,-60682,275,448,173,239631,2325,2325,2325,0,0,0,23916,35219,0,0
141300,002780,2325,3,0,0.0,58.62,146647,85961,-60686,276,448,172,239635,2325,2325,2325,4,1,0,23916,28545,4,0
141400,002780,2325,3,0,0.0,58.62,146647,85961,-60686,276,448,172,239635,2325,2325,2325,0,0,0,23916,32471,0,0
141500,002780,2325,3,0,0.0,58.62,146647,85961,-60686,276,448,172,239635,2325,2325,2325,0,0,0,23916,32471,0,0
141500,002780,2330,2,5,0.22,58.62,146647,85962,-60685,276,449,173,239636,2330,2330,2330,1,0,1,23915,35042,0,1
141600,002780,2330,2,5,0.22,58.65,146647,86012,-60635,276,450,174,239686,2330,2330,2330,0,0,0,23915,35042,0,0
141700,002780,2330,2,5,0.22,58.66,146647,86016,-60631,276,452,176,239690,2330,2330,2330,0,0,0,23863,34427,0,0
141700,002780,2330,2,5,0.22,58.66,146647,86016,-60631,276,452,176,239690,2330,2330,2330,0,0,0,23863,34427,0,0
141800,002780,2330,2,5,0.22,58.66,146647,86016,-60631,276,452,176,239690,2330,2330,2330,0,0,0,23861,34267,0,0
141900,002780,2330,2,5,0.22,58.66,146647,86017,-60630,276,453,177,239691,2330,2330,2330,0,0,0,23861,34267,0,0
141900,002780,2330,2,5,0.22,58.66,146647,86017,-60630,276,453,177,239691,2330,2330,2330,0,0,0,23860,34267,0,0
142000,002780,2330,2,5,0.22,58.66,146647,86021,-60626,276,455,179,239695,2330,2330,2330,4,0,2,23865,34407,0,4
142000,002780,2330,2,5,0.22,58.66,146647,86021,-60626,276,455,179,239695,2330,2330,2330,4,0,2,23865,34407,0,4
142100,002780,2330,2,5,0.22,58.66,146647,86021,-60626,276,455,179,239695,2330,2330,2330,0,0,0,23865,34407,0,0
142200,002780,2330,2,5,0.22,58.66,146647,86023,-60624,276,456,180,239697,2330,2330,2330,0,0,0,23861,34393,0,0
142200,002780,2330,2,5,0.22,58.66,146647,86024,-60623,276,457,181,239698,2330,2330,2330,1,0,1,23859,34393,0,1
142300,002780,2330,2,5,0.22,58.66,146647,86024,-60623,276,457,181,239698,2330,2330,2330,0,0,0,23859,34393,0,0
142300,002780,2330,2,5,0.22,58.66,146647,86026,-60621,276,458,182,239700,2330,2330,2330,2,0,1,25260,34343,0,2
142400,002780,2330,2,5,0.22,58.67,146647,86033,-60614,276,460,184,239707,2330,2330,2330,7,0,2,25257,34343,0,7
142500,002780,2330,2,5,0.22,58.67,146647,86035,-60612,276,461,185,239709,2330,2330,2330,2,0,1,25252,34353,0,2
142500,002780,2330,2,5,0.22,58.67,146647,86035,-60612,276,461,185,239709,2330,2330,2330,2,0,1,25252,34353,0,2
142600,002780,2325,3,0,0.0,58.66,146657,86036,-60621,277,462,185,239720,2325,2325,2325,11,1,1,20704,37215,10,1
142700,002780,2325,3,0,0.0,58.66,146658,86036,-60622,278,462,184,239721,2325,2325,2325,0,0,0,26050,34344,0,0
142700,002780,2310,5,15,-0.65,57.83,148770,86036,-62734,281,462,181,241833,2320,2320,2310,2112,3,0,20754,37215,2112,0
142800,002780,2310,5,15,-0.65,57.83,148771,86036,-62735,282,462,180,241834,2310,2310,2310,0,0,0,14788,43759,0,0
142900,002780,2310,5,15,-0.65,57.29,150172,86036,-64136,284,462,178,243235,2310,2310,2310,0,0,0,9007,44762,0,0
142900,002780,2315,5,10,-0.43,57.33,150172,86095,-64077,284,463,179,243294,2315,2315,2315,59,0,1,9007,43362,0,59
143000,002780,2315,5,10,-0.43,57.33,150172,86095,-64077,284,463,179,243294,2315,2315,2315,0,0,0,9007,43362,0,0
143000,002780,2300,5,25,-1.08,55.21,155953,86095,-69858,289,463,174,249075,2315,2315,2300,5781,5,0,13521,38536,5781,0
143100,002780,2300,5,25,-1.08,55.21,155953,86095,-69858,289,463,174,249075,2300,2300,2300,0,0,0,13521,38536,0,0
143200,002780,2300,5,25,-1.08,55.21,155953,86095,-69858,289,463,174,249075,2300,2300,2300,0,0,0,6312,48063,0,0
143200,002780,2310,5,15,-0.65,55.21,155953,86096,-69857,289,464,175,249076,2310,2310,2310,1,0,1,5512,46445,0,1
143300,002780,2310,5,15,-0.65,55.21,155953,86096,-69857,289,464,175,249076,2310,2310,2310,0,0,0,5512,46445,0,0
143400,002780,2310,5,15,-0.65,55.21,155953,86098,-69855,289,465,176,249078,2310,2310,2310,0,0,0,5511,43445,0,0
143400,002780,2310,5,15,-0.65,55.36,156053,86395,-69658,290,467,177,249475,2305,2310,2305,397,1,2,5708,43463,100,297
143500,002780,2305,5,20,-0.86,55.33,156665,86683,-69982,293,469,176,250375,2315,2315,2305,900,3,2,8484,45646,612,288
143500,002780,2305,5,20,-0.86,55.29,156765,86683,-70082,294,469,175,250475,2315,2315,2305,1000,4,2,8406,45738,712,288
143600,002780,2305,5,20,-0.86,55.29,156765,86683,-70082,294,469,175,250475,2305,2305,2305,0,0,0,8406,45738,0,0
143700,002780,2305,5,20,-0.86,55.26,156865,86683,-70182,295,469,174,250575,2305,2305,2305,0,0,0,8506,45494,0,0
143700,002780,2305,5,20,-0.86,55.26,156865,86683,-70182,295,469,174,250575,2305,2305,2305,0,0,0,8506,45494,0,0
143800,002780,2315,5,10,-0.43,55.26,156865,86685,-70180,295,471,176,250577,2315,2315,2315,1,0,1,8495,35385,0,1
143900,002780,2315,5,10,-0.43,55.26,156865,86690,-70175,295,474,179,250582,2315,2315,2315,0,0,0,8490,35883,0,0
143900,002780,2310,5,15,-0.65,55.26,156866,86690,-70176,296,474,178,250583,2310,2310,2310,1,1,0,8424,38913,1,0
144000,002780,2310,5,15,-0.65,55.6,156866,87217,-69649,296,476,180,251110,2310,2310,2310,527,0,2,6346,45065,0,527
144000,002780,2310,5,15,-0.65,55.6,156866,87221,-69645,296,478,182,251114,2310,2310,2310,531,0,4,5817,44612,0,531
144100,002780,2310,5,15,-0.65,55.6,156866,87221,-69645,296,478,182,251114,2310,2310,2310,0,0,0,5817,44612,0,0
144200,002780,2310,5,15,-0.65,55.77,156866,87489,-69377,296,482,186,251382,2310,2310,2310,219,0,3,5773,46309,0,219
144200,002780,2315,5,10,-0.43,55.77,156866,87490,-69376,296,483,187,251383,2310,2315,2310,220,0,4,8491,43832,0,220
144300,002780,2315,5,10,-0.43,55.77,156866,87490,-69376,296,483,187,251383,2315,2315,2315,0,0,0,8491,43832,0,0
144400,002780,2315,5,10,-0.43,55.77,156866,87492,-69374,296,484,188,251385,2315,2315,2315,0,0,0,8460,44132,0,0
144400,002780,2315,5,10,-0.43,55.77,156866,87492,-69374,296,484,188,251385,2315,2315,2315,0,0,0,8460,44132,0,0
144500,002780,2315,5,10,-0.43,55.77,156866,87492,-69374,296,484,188,251385,2315,2315,2315,0,0,0,8458,44474,0,0
144500,002780,2315,5,10,-0.43,55.88,156866,87649,-69217,296,486,190,251542,2315,2315,2315,157,0,2,9173,46464,0,157
144600,002780,2315,5,10,-0.43,55.88,156866,87649,-69217,296,486,190,251542,2315,2315,2315,0,0,0,9173,46464,0,0
144700,002780,2315,5,10,-0.43,55.79,157118,87649,-69469,297,486,189,251794,2315,2315,2315,252,1,0,13893,46446,252,0
144700,002780,2315,5,10,-0.43,55.79,157118,87649,-69469,297,486,189,251794,2315,2315,2315,252,1,0,13893,46446,252,0
144800,002780,2315,5,10,-0.43,55.79,157118,87649,-69469,297,486,189,251794,2315,2315,2315,0,0,0,13893,46446,0,0
144800,002780,2315,5,10,-0.43,55.79,157118,87651,-69467,297,487,190,251796,2315,2315,2315,2,0,1,9066,42907,0,2
144900,002780,2310,5,15,-0.65,55.5,157936,87651,-70285,298,487,189,252614,2310,2310,2310,818,1,0,9129,42907,818,0
145000,002780,2310,5,15,-0.65,55.34,158399,87651,-70748,299,487,188,253077,2310,2310,2310,0,0,0,9129,42089,0,0
145000,002780,2310,5,15,-0.65,55.34,158399,87651,-70748,299,487,188,253077,2310,2310,2310,0,0,0,9129,42089,0,0
145100,002780,2315,5,10,-0.43,55.38,158399,87716,-70683,299,488,189,253142,2315,2315,2315,0,0,0,8666,49891,0,0
145200,002780,2315,5,10,-0.43,55.38,158399,87716,-70683,299,488,189,253142,2315,2315,2315,0,0,0,13176,49889,0,0
145200,002780,2315,5,10,-0.43,55.37,158409,87716,-70693,300,488,188,253152,2315,2315,2315,10,1,0,13176,44787,10,0
145300,002780,2315,5,10,-0.43,55.19,158930,87716,-71214,301,488,187,253673,2315,2315,2315,521,1,0,13176,44195,521,0
145400,002780,2315,5,10,-0.43,55.19,158930,87716,-71214,301,488,187,253673,2315,2315,2315,0,0,0,13176,44195,0,0
145400,002780,2320,5,5,-0.22,55.51,158930,88218,-70712,301,490,189,254175,2320,2320,2320,502,0,2,13175,43676,0,502
145500,002780,2320,5,5,-0.22,55.47,159030,88218,-70812,302,490,188,254275,2320,2320,2320,100,1,0,18740,42677,100,0
145600,002780,2315,5,10,-0.43,54.95,160532,88218,-72314,306,490,184,255777,2315,2315,2315,0,0,0,19039,42598,0,0
145600,002780,2315,5,10,-0.43,54.92,160632,88218,-72414,307,490,183,255877,2315,2315,2315,100,1,0,19039,43124,100,0
145700,002780,2315,5,10,-0.43,54.92,160632,88218,-72414,307,490,183,255877,2315,2315,2315,0,0,0,19039,43124,0,0
145700,002780,2315,5,10,-0.43,54.92,160632,88218,-72414,307,490,183,255877,2315,2315,2315,0,0,0,19039,35291,0,0
145800,002780,2315,5,10,-0.43,54.92,160632,88218,-72414,307,490,183,255877,2315,2315,2315,0,0,0,18664,35289,0,0
145900,002780,2315,5,10,-0.43,54.92,160632,88218,-72414,307,490,183,255877,2315,2315,2315,0,0,0,18664,35289,0,0
145900,002780,2315,5,10,-0.43,54.92,160632,88218,-72414,307,490,183,255877,2315,2315,2315,0,0,0,18664,33306,0,0
150000,002780,2315,5,10,-0.43,54.49,161890,88219,-73671,309,491,182,257136,2325,2325,2315,1259,2,1,18664,32439,1258,1
150100,002780,2315,5,10,-0.43,54.49,161896,88219,-73677,311,491,180,257142,2315,2315,2315,0,0,0,12603,33203,0,0
150100,002780,2315,5,10,-0.43,54.49,161896,88219,-73677,311,491,180,257142,2315,2315,2315,0,0,0,12603,33203,0,0
150200,002780,2320,5,5,-0.22,54.49,161896,88223,-73673,311,494,183,257146,2320,2320,2320,4,0,3,12608,35323,0,4
150200,002780,2320,5,5,-0.22,54.49,161896,88223,-73673,311,494,183,257146,2320,2320,2320,4,0,3,12608,35323,0,4
150300,002780,2340,2,15,0.65,54.61,161896,88407,-73489,311,495,184,258625,2320,2340,2320,1479,0,1,28394,35023,0,184
150400,002780,2335,2,10,0.43,54.61,161896,88411,-73485,311,497,186,258629,2335,2335,2335,0,0,0,27074,33445,0,0
150400,002780,2330,2,5,0.22,54.71,161908,88581,-73327,312,500,188,258811,2330,2340,2330,182,1,3,29200,26488,12,170
150500,002780,2310,5,15,-0.65,54.45,162670,88581,-74089,316,500,184,259573,2310,2310,2310,0,0,0,30210,33573,0,0
150500,002780,2310,5,15,-0.65,54.45,162670,88581,-74089,316,500,184,259573,2310,2310,2310,0,0,0,30210,33573,0,0
150600,002780,2320,5,5,-0.22,54.48,162670,88621,-74049,316,501,185,259613,2320,2320,2320,40,0,1,16212,37588,0,40
150700,002780,2320,5,5,-0.22,54.48,162675,88621,-74054,317,501,184,259618,2320,2320,2320,0,0,0,22238,35124,0,0
150700,002780,2320,5,5,-0.22,54.48,162675,88621,-74054,317,501,184,259618,2320,2320,2320,0,0,0,22238,35124,0,0
150800,002780,2325,3,0,0.0,54.48,162675,88622,-74053,317,502,185,259619,2325,2325,2325,1,0,1,24205,40644,0,1
150900,002780,2325,3,0,0.0,54.48,162675,88624,-74051,317,503,186,259621,2325,2325,2325,0,0,0,24504,40698,0,0
150900,002780,2325,3,0,0.0,55.37,162675,90079,-72596,317,505,188,261076,2325,2325,2325,1455,0,2,26667,40698,0,1455
151000,002780,2325,3,0,0.0,55.37,162675,90080,-72595,317,506,189,261077,2325,2325,2325,1,0,1,26046,40698,0,1
151000,002780,2320,5,5,-0.22,55.38,162678,90083,-72595,318,508,190,261083,2325,2325,2320,7,1,3,26043,40697,3,4
151100,002780,2320,5,5,-0.22,55.36,162720,90084,-72636,319,509,190,261126,2325,2325,2320,43,1,1,26043,40694,42,1
151200,002780,2320,5,5,-0.22,55.36,162720,90084,-72636,319,509,190,261126,2320,2320,2320,0,0,0,26043,40694,0,0
151200,002780,2320,5,5,-0.22,55.06,163620,90084,-73536,321,509,188,262026,2320,2320,2320,900,2,0,25642,39906,900,0
151300,002780,2320,5,5,-0.22,54.84,164290,90089,-74201,322,510,188,262701,2320,2320,2320,0,0,0,20942,41132,0,0
151400,002780,2320,5,5,-0.22,54.84,164290,90090,-74200,322,511,189,262702,2320,2320,2320,0,0,0,20937,41045,0,0
151400,002780,2320,5,5,-0.22,54.84,164290,90090,-74200,322,511,189,262702,2320,2320,2320,0,0,0,20937,41045,0,0
151500,002780,2320,5,5,-0.22,55.02,164290,90386,-73904,322,513,191,262998,2320,2320,2320,0,0,0,20643,42972,0,0
151600,002780,2320,5,5,-0.22,55.64,164290,91408,-72882,322,516,194,264020,2320,2320,2320,0,0,0,19678,41169,0,0
151600,002780,2320,5,5,-0.22,55.66,164290,91448,-72842,322,518,196,264060,2320,2320,2320,40,0,2,19998,39392,0,40
151700,002780,2320,5,5,-0.22,55.96,164967,92310,-72657,324,519,195,265599,2325,2325,2320,1361,1,1,25180,39129,499,862
151700,002780,2325,3,0,0.0,56.25,164967,92790,-72177,324,521,197,266079,2325,2325,2320,1841,1,3,24730,38631,499,1342
151800,002780,2325,3,0,0.0,56.39,165065,93087,-71978,325,524,199,266474,2325,2325,2325,300,1,2,29753,36436,98,202
151900,002780,2325,3,0,0.0,56.86,165265,93969,-71296,326,526,200,267556,2325,2325,2325,882,0,2,27616,37514,0,882
151900,002780,2325,3,0,0.0,56.86,165265,93969,-71296,326,526,200,267556,2325,2325,2325,882,0,2,27616,37514,0,882
152000,002780,2325,3,0,0.0,57.4,165265,94861,-70404,326,527,201,268448,2325,2325,2325,0,0,0,28383,37727,0,0
152000,002780,2330,2,5,0.22,57.49,165265,95013,-70252,326,528,202,268600,2330,2330,2330,152,0,1,32847,37446,0,152
152000,002780,2330,2,5,0.22,57.49,165265,95013,-70252,326,528,202,268600,2330,2330,2330,152,0,1,32847,37446,0,152
152000,002780,2330,2,5,0.22,57.49,165265,95013,-70252,326,528,202,268600,2330,2330,2330,152,0,1,32847,37446,0,152
152000,002780,2330,2,5,0.22,57.49,165265,95013,-70252,326,528,202,268600,2330,2330,2330,152,0,1,32847,37446,0,152
152000,002780,2330,2,5,0.22,57.49,165265,95013,-70252,326,528,202,268600,2330,2330,2330,152,0,1,32847,37446,0,152
152000,002780,2330,2,5,0.22,57.49,165265,95013,-70252,326,528,202,268600,2330,2330,2330,152,0,1,32847,37446,0,152
152000,002780,2330,2,5,0.22,57.49,165265,95013,-70252,326,528,202,268600,2330,2330,2330,152,0,1,32847,37446,0,152
152000,002780,2330,2,5,0.22,57.49,165265,95013,-70252,326,528,202,268600,2330,2330,2330,152,0,1,32847,37446,0,152
152000,002780,2330,2,5,0.22,57.49,165265,95013,-70252,326,528,202,268600,2330,2330,2330,152,0,1,32847,37446,0,152
152000,002780,2330,2,5,0.22,57.49,165265,95013,-70252,326,528,202,268600,2330,2330,2330,152,0,1,32847,37446,0,152
152000,002780,2330,2,5,0.22,57.49,165265,95013,-70252,326,528,202,268600,2330,2330,2330,152,0,1,32847,37446,0,152
152000,002780,2330,2,5,0.22,57.49,165265,95013,-70252,326,528,202,268600,2330,2330,2330,152,0,1,32847,37446,0,152
152000,002780,2330,2,5,0.22,57.49,165265,95013,-70252,326,528,202,268600,2330,2330,2330,152,0,1,32847,37446,0,152
152000,002780,2330,2,5,0.22,57.49,165265,95013,-70252,326,528,202,268600,2330,2330,2330,152,0,1,32847,37446,0,152
152000,002780,2330,2,5,0.22,57.49,165265,95013,-70252,326,528,202,268600,2330,2330,2330,152,0,1,32847,37446,0,152
152000,002780,2330,2,5,0.22,57.49,165265,95013,-70252,326,528,202,268600,2330,2330,2330,152,0,1,32847,37446,0,152
152000,002780,2330,2,5,0.22,57.49,165265,95013,-70252,326,528,202,268600,2330,2330,2330,152,0,1,32847,37446,0,152
153000,002780,2330,2,5,0.22,57.49,165265,95013,-70252,326,528,202,278479,2330,2330,2330,9879,0,0,32695,33136,0,0
153000,002780,2330,2,5,0.22,57.49,165265,95013,-70252,326,528,202,278479,2330,2330,2330,9879,0,0,32695,33136,0,0
153000,002780,2330,2,5,0.22,57.49,165265,95013,-70252,326,528,202,278479,2330,2330,2330,9879,0,0,32695,33136,0,0
