090200,009580,4355,2,5,0.11,61.56,2778,1710,-1068,5,9,4,9954,4355,4360,4355,2685,3,1,12988,17247,2683,2
090300,009580,4350,3,0,0.0,56.83,3097,1760,-1337,7,10,3,10323,4350,4350,4350,319,2,0,13776,18949,319,0
090300,009580,4350,3,0,0.0,51.76,3549,1837,-1712,12,13,1,10852,4350,4350,4335,848,7,3,13499,20367,771,77
090400,009580,4350,3,0,0.0,54.02,3549,1917,-1632,12,15,3,10932,4350,4350,4350,80,0,2,19348,16906,0,80
090500,009580,4345,5,5,-0.11,51.98,3688,1917,-1771,14,15,1,11071,4345,4345,4345,0,0,0,19318,16756,0,0
090500,009580,4345,5,5,-0.11,51.98,3688,1917,-1771,14,15,1,11071,4345,4345,4345,0,0,0,19318,16756,0,0
090600,009580,4350,3,0,0.0,62.85,3688,2318,-1370,14,17,3,11472,4350,4350,4350,401,0,2,20599,19187,0,401
090700,009580,4350,3,0,0.0,74.73,3787,2830,-957,15,19,4,12083,4350,4350,4350,99,1,0,20654,18845,99,0
090800,009580,4350,3,0,0.0,74.38,3805,2830,-975,16,19,3,12101,4350,4350,4350,0,0,0,20654,18756,0,0
090800,009580,4345,5,5,-0.11,64.34,4406,2835,-1571,18,20,2,12707,4355,4355,4345,606,2,1,21565,13441,601,5
090900,009580,4345,5,5,-0.11,62.86,4510,2835,-1675,19,20,1,12811,4345,4345,4345,104,1,0,21670,16961,104,0
090900,009580,4350,3,0,0.0,53.99,5510,2975,-2535,20,22,2,13951,4345,4350,4345,1244,2,2,20257,19209,1104,140
091000,009580,4350,3,0,0.0,56.81,5510,3130,-2380,20,24,4,14106,4350,4350,4350,155,0,2,20297,19209,0,155
091100,009580,4350,3,0,0.0,53.73,5825,3130,-2695,23,24,1,14421,4350,4350,4350,0,0,0,21994,14899,0,0
091100,009580,4350,3,0,0.0,51.26,6106,3130,-2976,25,24,-1,14702,4350,4350,4350,281,2,0,21994,14948,281,0
091200,009580,4350,3,0,0.0,51.82,6106,3164,-2942,25,26,1,14736,4350,4350,4350,34,0,2,21393,19146,0,34
091300,009580,4345,5,5,-0.11,54.16,8106,4390,-3716,27,27,0,17962,4345,4345,4345,0,0,0,22145,16100,0,0
091300,009580,4350,3,0,0.0,55.33,8836,4889,-3947,29,32,3,19191,4345,4350,4345,1229,2,5,20678,18605,730,499
091400,009580,4350,3,0,0.0,56.58,9297,5260,-4037,32,35,3,20023,4350,4350,4350,461,3,0,22665,14373,461,0
091500,009580,4345,5,5,-0.11,48.59,10827,5261,-5566,37,36,-1,21554,4345,4350,4345,1410,4,1,24838,16552,1409,1
091600,009580,4350,3,0,0.0,48.78,10827,5281,-5546,37,37,0,21574,4350,4350,4350,0,0,0,24838,16792,0,0
091600,009580,4345,5,5,-0.11,48.23,10972,5292,-5680,38,38,0,21730,4350,4350,4345,156,1,1,24969,17922,145,11
091700,009580,4350,3,0,0.0,49.02,11084,5433,-5651,39,40,1,21983,4345,4350,4345,253,1,2,25003,20601,112,141
091800,009580,4350,3,0,0.0,48.16,11284,5434,-5850,40,41,1,22184,4350,4350,4350,1,0,1,24606,20717,0,1
091900,009580,4350,3,0,0.0,48.17,11284,5435,-5849,40,42,2,22185,4350,4350,4350,1,0,1,24805,23675,0,1
091900,009580,4350,3,0,0.0,48.4,11284,5461,-5823,40,44,4,22211,4350,4350,4350,27,0,3,25106,25644,0,27
092000,009580,4345,5,5,-0.11,47.82,11495,5497,-5998,41,45,4,22458,4345,4345,4345,211,1,0,26179,29812,211,0
092100,009580,4350,3,0,0.0,47.7,11535,5502,-6033,42,46,4,22503,4350,4350,4350,5,0,1,26486,29913,0,5
092100,009580,4350,3,0,0.0,56.89,11535,6562,-4973,42,52,10,23563,4350,4350,4350,1065,0,7,26427,32491,0,1065
092200,009580,4350,3,0,0.0,58.82,11575,6808,-4767,52,55,3,23849,4350,4350,4350,143,10,1,28358,29223,40,103
092300,009580,4350,3,0,0.0,58.63,11611,6808,-4803,61,55,-6,23885,4350,4350,4350,0,0,0,28358,29183,0,0
092300,009580,4350,3,0,0.0,72.15,12069,8708,-3361,62,60,-2,26243,4355,4355,4350,2358,1,5,26458,34166,458,1900
092400,009580,4350,3,0,0.0,72.15,12069,8708,-3361,62,60,-2,26243,4350,4350,4350,0,0,0,26458,34166,0,0
092400,009580,4355,2,5,0.11,74.4,12125,9021,-3104,63,65,2,26612,4355,4355,4350,369,1,5,26420,31229,56,313
092500,009580,4350,3,0,0.0,74.57,12133,9047,-3086,65,67,2,26646,4355,4355,4350,34,2,2,25590,33977,8,26
092600,009580,4355,2,5,0.11,75.53,12133,9164,-2969,65,69,4,26763,4355,4355,4355,0,0,0,25493,34089,0,0
092600,009580,4350,3,0,0.0,80.63,12137,9786,-2351,66,80,14,27389,4355,4360,4350,626,1,11,27544,33706,4,622
092700,009580,4360,2,10,0.23,81.13,12138,9848,-2290,67,88,21,27452,4355,4360,4355,30,1,6,27672,33760,1,29
092800,009580,4360,2,10,0.23,99.03,12138,12020,-118,67,100,33,29624,4355,4360,4355,1893,0,6,27830,31029,0,1893
092900,009580,4360,2,10,0.23,100.07,12231,12239,8,81,108,27,29940,4360,4360,4360,0,0,0,26689,27014,0,0
092900,009580,4365,2,15,0.34,115.42,12487,14412,1925,96,114,18,32369,4360,4365,4360,2429,15,6,26846,29595,256,2173
093000,009580,4365,2,15,0.34,112.87,12814,14463,1649,97,116,19,32747,4365,4365,4365,50,0,1,27015,28898,0,50
093100,009580,4365,2,15,0.34,120.4,12931,15569,2638,99,121,22,33970,4365,4365,4365,0,0,0,27056,28863,0,0
093100,009580,4375,2,25,0.57,147.77,12949,19135,6186,100,126,26,37554,4365,4375,4365,3584,1,5,21411,28584,18,3566
093200,009580,4375,2,25,0.57,175.34,13195,23136,9941,101,135,34,41801,4370,4375,4370,3636,1,5,21411,27956,246,3390
093300,009580,4375,2,25,0.57,172.74,13731,23719,9988,103,139,36,42920,4375,4375,4375,0,0,0,18495,23706,0,0
093300,009580,4380,2,30,0.69,187.93,13731,25804,12073,103,144,41,45005,4375,4385,4375,2085,0,5,20150,22897,0,2085
093400,009580,4380,2,30,0.69,184.58,13982,25808,11826,105,147,42,45260,4380,4380,4375,254,1,3,20668,23915,250,4
093500,009580,4380,2,30,0.69,185.9,15320,28480,13160,107,153,46,49270,4380,4380,4380,1000,0,1,19636,24976,0,1000
093500,009580,4385,2,35,0.8,191.02,15388,29394,14006,108,158,50,50252,4380,4385,4380,1982,1,6,18313,23889,68,1914
093600,009580,4390,2,40,0.92,211.57,15389,32559,17170,109,167,58,53418,4385,4390,4385,3065,1,7,16839,23444,1,3064
093700,009580,4390,2,40,0.92,210.69,15454,32560,17106,110,168,58,53484,4390,4390,4390,0,0,0,16113,23447,0,0
093700,009580,4390,2,40,0.92,217.82,15699,34195,18496,111,175,64,55364,4390,4395,4385,1880,1,7,10055,18602,245,1635
093800,009580,4395,2,45,1.03,231.02,15700,36270,20570,112,181,69,57440,4395,4395,4395,1928,1,3,10543,17422,1,1927
093900,009580,4395,2,45,1.03,228.89,15959,36528,20569,116,187,71,57957,4395,4395,4395,100,1,0,11209,12936,100,0
093900,009580,4390,2,40,0.92,213.49,17127,36565,19438,120,194,74,59162,4395,4400,4390,1305,5,7,11423,17212,1268,37
094000,009580,4395,2,45,1.03,215.81,17127,36961,19834,120,201,81,59558,4395,4395,4395,5,0,1,11693,17209,0,5
094000,009580,4390,2,40,0.92,213.09,17359,36990,19631,122,203,81,59819,4395,4395,4390,266,2,3,11593,18841,232,34
094100,009580,4385,2,35,0.8,208.88,17709,36990,19281,123,203,80,60169,4385,4385,4385,350,1,0,13697,19040,350,0
094200,009580,4385,2,35,0.8,202.3,18285,36991,18706,124,204,80,60746,4385,4385,4385,0,0,0,12504,24694,0,0
094200,009580,4385,2,35,0.8,201.8,18331,36992,18661,125,205,80,60793,4380,4385,4380,47,1,1,12583,24846,46,1
094300,009580,4385,2,35,0.8,201.8,18331,36992,18661,125,205,80,60793,4385,4385,4385,0,0,0,12583,24846,0,0
094300,009580,4385,2,35,0.8,201.8,18331,36992,18661,125,205,80,60793,4385,4385,4385,0,0,0,13582,24377,0,0
094400,009580,4385,2,35,0.8,202.08,18331,37043,18712,125,207,82,60844,4385,4385,4385,51,0,2,14186,24488,0,51
094500,009580,4385,2,35,0.8,206.69,18644,38535,19891,127,212,85,62649,4385,4385,4385,0,0,0,12979,23909,0,0
094500,009580,4390,2,40,0.92,206.95,18644,38584,19940,127,214,87,62698,4390,4390,4390,49,0,2,14031,17831,0,49
094600,009580,4390,2,40,0.92,212.94,18644,39700,21056,127,216,89,63814,4390,4390,4390,1116,0,2,13710,20133,0,1116
094600,009580,4390,2,40,0.92,212.75,18739,39867,21128,129,221,92,64076,4390,4395,4390,1378,2,7,14243,18267,95,1283
094700,009580,4400,2,50,1.15,236.3,18739,44281,25542,129,229,100,68490,4400,4400,4395,2469,0,6,11526,13291,0,2469
094800,009580,4400,2,50,1.15,238.41,18739,44676,25937,129,232,103,68885,4400,4400,4400,0,0,0,11945,12952,0,0
094800,009580,4395,2,45,1.03,237.84,19023,45244,26221,130,235,105,69737,4400,4400,4395,852,1,3,12104,17887,284,568
094900,009580,4395,2,45,1.03,236.3,19423,45897,26474,131,237,106,70790,4395,4395,4395,0,0,0,14010,12832,0,0
094900,009580,4395,2,45,1.03,223.4,20599,46018,25419,133,240,107,72087,4395,4395,4395,1297,2,3,12784,17962,1176,121
095000,009580,4395,2,45,1.03,223.66,20599,46071,25472,133,243,110,72140,4395,4395,4395,0,0,0,12783,18252,0,0
095000,009580,4395,2,45,1.03,224.68,20599,46281,25682,133,244,111,72350,4395,4395,4395,210,0,1,12833,18535,0,210
095100,009580,4395,2,45,1.03,219.77,21059,46281,25222,136,244,108,72810,4395,4395,4395,460,3,0,14313,13542,460,0
095200,009580,4400,2,50,1.15,220.11,21059,46352,25293,136,247,111,72881,4400,4400,4400,0,0,0,14245,13473,0,0
095200,009580,4400,2,50,1.15,225.98,21197,47900,26703,137,249,112,74567,4395,4400,4395,1686,1,2,12942,13519,138,1548
095300,009580,4400,2,50,1.15,226.07,21197,47921,26724,137,251,114,74588,4400,4400,4400,21,0,2,13397,13521,0,21
095300,009580,4400,2,50,1.15,226.41,21197,47992,26795,137,254,117,74659,4400,4400,4400,92,0,5,13976,13532,0,92
095400,009580,4395,2,45,1.03,224.58,21370,47992,26622,138,254,116,74832,4395,4395,4395,0,0,0,14726,13532,0,0
095500,009580,4395,2,45,1.03,224.58,21370,47992,26622,138,254,116,74832,4395,4395,4395,0,0,0,16226,13363,0,0
095500,009580,4395,2,45,1.03,224.39,21419,48063,26644,141,255,114,74952,4395,4400,4395,120,3,1,16155,13364,49,71
095600,009580,4395,2,45,1.03,224.52,21419,48091,26672,141,257,116,74980,4395,4395,4395,7,0,1,14365,18688,0,7
095600,009580,4395,2,45,1.03,224.52,21419,48091,26672,141,257,116,74980,4395,4395,4395,7,0,1,14365,18688,0,7
095700,009580,4390,2,40,0.92,211.97,22692,48101,25409,143,258,115,76263,4390,4390,4390,1279,1,1,15590,19496,1269,10
095800,009580,4395,2,45,1.03,218.04,23120,50412,27292,144,263,119,79002,4385,4395,4385,2310,0,4,14525,25600,0,2310
095800,009580,4385,2,35,0.8,228.94,23333,53418,30085,146,266,120,82221,4385,4400,4385,5529,2,7,18859,26164,213,5316
095900,009580,4400,2,50,1.15,228.94,23333,53419,30086,146,267,121,82222,4400,4400,4400,0,0,0,17731,17958,0,0
100000,009580,4395,2,45,1.03,228.95,23333,53422,30089,146,269,123,82225,4395,4395,4395,0,0,0,16268,19856,0,0
100000,009580,4395,2,45,1.03,226.71,23564,53423,29859,148,270,122,82457,4385,4395,4380,232,2,1,16976,25976,231,1
100100,009580,4395,2,45,1.03,225.78,23666,53432,29766,150,273,123,82568,4390,4395,4390,107,1,1,16995,17828,100,7
100100,009580,4395,2,45,1.03,225.78,23666,53433,29767,150,274,124,82569,4390,4395,4390,108,1,2,16988,17828,100,8
100200,009580,4395,2,45,1.03,225.78,23666,53434,29768,150,275,125,82570,4395,4395,4395,1,0,1,17517,18357,0,1
100300,009580,4395,2,45,1.03,225.78,23666,53434,29768,150,275,125,82570,4395,4395,4395,0,0,0,17517,18357,0,0
100300,009580,4395,2,45,1.03,224.97,23755,53441,29686,152,278,126,82666,4390,4395,4390,96,2,3,17649,20389,89,7
100400,009580,4395,2,45,1.03,225.0,23755,53448,29693,152,280,128,82673,4395,4395,4395,1,0,1,19112,21466,0,1
100500,009580,4400,2,50,1.15,235.31,23755,55899,32144,152,283,131,85124,4400,4400,4400,0,0,0,20171,14661,0,0
100500,009580,4400,2,50,1.15,235.31,23755,55899,32144,152,283,131,85124,4400,4400,4400,0,0,0,20171,14661,0,0
100600,009580,4400,2,50,1.15,235.36,23755,55909,32154,152,284,132,85134,4400,4400,4400,10,0,1,20501,14474,0,10
100600,009580,4395,2,45,1.03,236.12,23784,56159,32375,153,287,134,85413,4400,4400,4395,289,1,4,22372,14283,29,260
100700,009580,4395,2,45,1.03,235.62,23835,56159,32324,155,287,132,85464,4395,4395,4395,51,2,0,22372,14255,51,0
100800,009580,4395,2,45,1.03,235.6,23837,56160,32323,156,288,132,85467,4395,4395,4395,0,0,0,22371,14540,0,0
100800,009580,4400,2,50,1.15,230.8,24334,56162,31828,158,290,132,85966,4395,4400,4390,499,2,2,22370,14637,497,2
100900,009580,4400,2,50,1.15,230.82,24334,56168,31834,158,291,133,85972,4400,4400,4400,6,0,1,22529,14637,0,6
100900,009580,4395,2,45,1.03,230.78,24338,56168,31830,159,291,132,85976,4400,4400,4395,10,1,1,23056,14639,4,6
101000,009580,4395,2,45,1.03,230.78,24338,56168,31830,159,291,132,85976,4395,4395,4395,0,0,0,23056,14639,0,0
101000,009580,4400,2,50,1.15,230.91,24338,56199,31861,159,293,134,86007,4400,4400,4400,31,0,2,23026,14740,0,31
101100,009580,4395,2,45,1.03,230.39,24393,56199,31806,160,293,133,86062,4395,4395,4395,55,1,0,23025,14742,55,0
101200,009580,4400,2,50,1.15,230.44,24393,56211,31818,160,297,137,86074,4400,4400,4400,0,0,0,23023,15880,0,0
101200,009580,4400,2,50,1.15,230.36,24402,56212,31810,161,298,137,86084,4395,4400,4395,10,1,1,23022,15874,9,1
101300,009580,4400,2,50,1.15,230.37,24403,56217,31814,162,299,137,86090,4400,4400,4400,5,0,1,24114,15486,0,5
101300,009580,4400,2,50,1.15,230.38,24403,56220,31817,162,300,138,86093,4400,4400,4400,8,0,2,24609,15489,0,8
101400,009580,4400,2,50,1.15,230.41,24403,56226,31823,162,301,139,86099,4400,4400,4400,6,0,1,24606,15672,0,6
101400,009580,4395,2,45,1.03,230.39,24405,56226,31821,164,301,137,86101,4400,4400,4395,8,2,1,24599,15671,2,6
101500,009580,4400,2,50,1.15,230.73,24415,56333,31918,165,302,137,86218,4395,4400,4395,117,1,1,24598,15682,10,107
101600,009580,4400,2,50,1.15,230.73,24415,56333,31918,165,302,137,86218,4400,4400,4400,0,0,0,24598,15682,0,0
101600,009580,4400,2,50,1.15,230.73,24415,56333,31918,165,302,137,86218,4400,4400,4400,0,0,0,24612,15522,0,0
101700,009580,4400,2,50,1.15,230.76,24415,56340,31925,165,303,138,86225,4400,4400,4400,0,0,0,24654,15525,0,0
101700,009580,4400,2,50,1.15,236.04,24415,57629,33214,165,307,142,87514,4400,4400,4400,1289,0,4,24546,15767,0,1289
101800,009580,4395,2,45,1.03,235.99,24420,57629,33209,166,307,141,87519,4395,4395,4395,5,1,0,23540,15449,5,0
101800,009580,4395,2,45,1.03,234.88,24579,57730,33151,167,308,141,87779,4395,4400,4395,265,2,1,23439,14829,164,101
101900,009580,4400,2,50,1.15,234.8,24590,57737,33147,168,310,142,87797,4395,4400,4395,17,1,1,23439,14671,11,6
102000,009580,4395,2,45,1.03,234.05,24670,57739,33069,170,312,142,87879,4395,4395,4395,0,0,0,23650,14557,0,0
102000,009580,4395,2,45,1.03,231.83,24906,57739,32833,174,312,138,88115,4395,4395,4395,236,4,0,23850,14908,236,0
102100,009580,4395,2,45,1.03,231.83,24906,57739,32833,174,312,138,88115,4395,4395,4395,0,0,0,23850,14908,0,0
102100,009580,4400,2,50,1.15,232.45,24906,57894,32988,174,314,140,88270,4400,4400,4400,155,0,2,23696,14835,0,155
102200,009580,4400,2,50,1.15,232.48,24906,57901,32995,174,315,141,88277,4400,4400,4400,7,0,1,23695,14837,0,7
102300,009580,4395,2,45,1.03,231.88,25088,58173,33085,175,316,141,88731,4395,4395,4395,0,0,0,22692,15036,0,0
102300,009580,4395,2,45,1.03,231.73,25104,58173,33069,177,316,139,88747,4395,4395,4395,16,2,0,24823,14987,16,0
102400,009580,4395,2,45,1.03,230.6,25227,58173,32946,178,316,138,88870,4395,4395,4395,0,0,0,25114,14978,0,0
102400,009580,4400,2,50,1.15,230.63,25227,58181,32954,178,318,140,88878,4400,4400,4400,8,0,2,25113,14991,0,8
102500,009580,4395,2,45,1.03,227.03,25627,58181,32554,179,318,139,89278,4395,4395,4395,400,1,0,25112,15091,400,0
102500,009580,4395,2,45,1.03,226.15,25727,58181,32454,180,318,138,89378,4395,4395,4395,500,2,0,25112,15325,500,0
102600,009580,4400,2,50,1.15,220.95,26333,58182,31849,183,319,136,89985,4395,4400,4395,607,3,1,25206,14534,606,1
102700,009580,4395,2,45,1.03,218.98,26571,58186,31615,185,320,135,90227,4395,4395,4395,0,0,0,23304,19509,0,0
102700,009580,4390,2,40,0.92,215.79,27341,58999,31658,188,326,138,91810,4400,4400,4390,1583,3,6,22543,21486,770,813
102800,009580,4390,2,40,0.92,209.95,28101,58999,30898,192,326,134,92570,4390,4390,4390,0,0,0,24132,19730,0,0
102800,009580,4395,2,45,1.03,209.99,28101,59010,30909,192,328,136,92581,4395,4395,4395,11,0,2,21960,22274,0,11
102900,009580,4395,2,45,1.03,210.03,28101,59020,30919,192,329,137,92591,4395,4395,4395,10,0,1,23525,24276,0,10
102900,009580,4390,2,40,0.92,211.02,28115,59327,31212,194,331,137,92912,4395,4395,4385,331,2,3,19309,25195,14,317
103000,009580,4390,2,40,0.92,212.94,28115,59869,31754,194,332,138,93454,4390,4390,4390,542,0,1,19009,25197,0,542
103100,009580,4390,2,40,0.92,212.94,28115,59869,31754,194,332,138,93454,4390,4390,4390,0,0,0,19009,25197,0,0
103100,009580,4390,2,40,0.92,212.94,28115,59869,31754,194,332,138,93454,4390,4390,4390,0,0,0,23352,21824,0,0
103200,009580,4395,2,45,1.03,212.88,28124,59871,31747,195,334,139,93465,4390,4395,4390,10,1,1,23628,21827,9,1
103200,009580,4400,2,50,1.15,237.69,28518,67784,39266,202,344,142,101772,4390,4400,4390,8317,8,11,18048,17463,403,7914
103300,009580,4405,2,55,1.26,237.69,28518,67785,39267,202,345,143,101773,4405,4405,4405,1,0,1,22855,17465,0,1
103400,009580,4405,2,55,1.26,237.7,28518,67786,39268,202,346,144,101774,4405,4405,4405,0,0,0,23401,12368,0,0
103400,009580,4400,2,50,1.15,237.48,28785,68358,39573,203,347,144,102613,4400,4400,4400,839,1,1,19543,16518,267,572
103500,009580,4405,2,55,1.26,236.46,28912,68366,39454,206,349,143,102748,4405,4405,4405,8,0,2,23891,12406,0,8
103500,009580,4405,2,55,1.26,236.46,28912,68366,39454,206,349,143,102748,4405,4405,4405,8,0,2,23891,12406,0,8
103600,009580,4405,2,55,1.26,236.46,28912,68366,39454,206,349,143,102748,4405,4405,4405,0,0,0,23891,12406,0,0
103600,009580,4400,2,50,1.15,233.24,29312,68367,39055,207,350,143,103149,4405,4405,4400,401,1,1,25038,12430,400,1
103700,009580,4395,2,45,1.03,228.59,30045,68681,38636,210,354,144,104196,4400,4400,4395,1047,3,4,24098,15391,733,314
103800,009580,4395,2,45,1.03,227.86,30145,68688,38543,211,356,145,104303,4395,4395,4395,0,0,0,24091,15991,0,0
103800,009580,4405,2,55,1.26,228.19,30145,68789,38644,211,359,148,104404,4400,4405,4400,101,0,3,24591,15893,0,101
103900,009580,4400,2,50,1.15,228.55,30145,68895,38750,211,362,151,104510,4400,4400,4400,5,0,1,19665,15895,0,5
103900,009580,4395,2,45,1.03,227.9,30231,68895,38664,214,362,148,104596,4400,4400,4395,91,3,1,20031,15755,86,5
104000,009580,4400,2,50,1.15,227.91,30237,68914,38677,215,366,151,104621,4400,4400,4395,24,1,3,20021,15741,6,18
104000,009580,4400,2,50,1.15,228.83,30237,69191,38954,215,368,153,104898,4400,4400,4395,301,1,5,20007,15746,6,295
104100,009580,4400,2,50,1.15,226.58,30537,69192,38655,217,369,152,105199,4395,4400,4390,301,2,1,20207,20275,300,1
104200,009580,4400,2,50,1.15,226.59,30537,69193,38656,217,370,153,105200,4400,4400,4400,0,0,0,20206,20275,0,0
104200,009580,4400,2,50,1.15,226.48,30552,69194,38642,219,371,152,105216,4390,4400,4390,16,2,1,20305,23093,15,1
104300,009580,4400,2,50,1.15,226.5,30552,69200,38648,219,372,153,105222,4400,4400,4400,0,0,0,20587,23095,0,0
104400,009580,4400,2,50,1.15,226.5,30552,69201,38649,219,373,154,105223,4400,4400,4400,0,0,0,20789,24076,0,0
104400,009580,4400,2,50,1.15,229.78,30552,70201,39649,219,374,155,106223,4400,4400,4400,1000,0,1,20798,26108,0,1000
104500,009580,4390,2,40,0.92,229.67,30566,70201,39635,221,374,153,106237,4390,4390,4390,6,1,0,20010,26969,6,0
104500,009580,4400,2,50,1.15,229.73,30566,70219,39653,221,377,156,106255,4390,4400,4390,24,1,3,20002,22342,6,18
104600,009580,4400,2,50,1.15,229.73,30566,70220,39654,221,378,157,106256,4400,4400,4400,1,0,1,20137,24413,0,1
104700,009580,4400,2,50,1.15,233.81,30566,71466,40900,221,381,160,107502,4400,4400,4400,0,0,0,20134,26513,0,0
104700,009580,4400,2,50,1.15,230.46,31027,71505,40478,224,383,159,108002,4405,4405,4400,500,3,2,23818,25111,461,39
104800,009580,4405,2,55,1.26,230.07,31127,71614,40487,225,388,163,108211,4405,4405,4405,108,0,4,23909,29494,0,108
104900,009580,4405,2,55,1.26,241.32,31127,75117,43990,225,393,168,111714,4405,4405,4405,0,0,0,23645,75175,0,0
104900,009580,4410,2,60,1.38,239.99,31313,75148,43835,226,395,169,111931,4405,4410,4405,217,1,2,21035,74232,186,31
105000,009580,4405,2,55,1.26,239.88,31328,75150,43822,228,397,169,111948,4405,4410,4405,16,2,1,21832,74222,15,1
105000,009580,4410,2,60,1.38,240.05,31328,75204,43876,228,401,173,112002,4405,4410,4405,70,2,5,21885,74217,15,55
105100,009580,4410,2,60,1.38,239.96,31341,75205,43864,229,402,173,112016,4405,4410,4405,14,1,1,23872,74204,13,1
105200,009580,4410,2,60,1.38,240.24,31341,75295,43954,229,405,176,112106,4410,4410,4410,0,0,0,23818,74214,0,0
105200,009580,4405,2,55,1.26,241.23,31628,76297,44669,231,408,177,113395,4405,4410,4405,1289,2,3,23088,74355,287,1002
105300,009580,4405,2,55,1.26,237.43,32134,76297,44163,233,408,175,113901,4405,4405,4405,500,1,0,22608,74340,500,0
105300,009580,4410,2,60,1.38,240.19,32134,77182,45048,233,413,180,114786,4405,4410,4405,1385,1,5,19435,74086,500,885
105400,009580,4420,2,70,1.61,245.78,32134,78979,46845,233,423,190,116583,4415,4420,4415,1692,0,5,16809,70043,0,1692
105400,009580,4415,2,65,1.49,246.57,32159,79296,47137,234,425,191,116925,4415,4420,4415,2034,1,7,16804,72749,25,2009
105500,009580,4425,2,75,1.72,246.33,32273,79498,47225,237,428,191,117241,4420,4425,4415,316,3,3,19118,19520,114,202
105600,009580,4425,2,75,1.72,246.38,32273,79515,47242,237,430,193,117258,4425,4425,4425,0,0,0,19547,18779,0,0
105600,009580,4420,2,70,1.61,245.62,32373,79515,47142,238,430,192,117358,4420,4420,4420,100,1,0,19863,18916,100,0
105700,009580,4425,2,75,1.72,248.49,32373,80445,48072,238,433,195,118288,4425,4425,4425,1,0,1,18220,18799,0,1
105700,009580,4420,2,70,1.61,248.43,32382,80445,48063,239,433,194,118297,4425,4425,4420,10,1,1,20254,18810,9,1
105800,009580,4420,2,70,1.61,248.38,32388,80445,48057,240,433,193,118303,4420,4420,4420,0,0,0,20545,18803,0,0
105800,009580,4425,2,75,1.72,248.4,32388,80452,48064,240,434,194,118310,4425,4425,4425,7,0,1,21439,18797,0,7
105900,009580,4425,2,75,1.72,247.15,32557,80464,47907,241,437,196,118491,4420,4425,4420,181,1,3,22025,18729,169,12
110000,009580,4425,2,75,1.72,247.15,32557,80464,47907,241,437,196,118491,4425,4425,4425,0,0,0,22025,18729,0,0
110000,009580,4415,2,65,1.49,241.21,33359,80464,47105,244,437,193,119293,4420,4420,4415,802,3,0,20156,20670,802,0
110100,009580,4420,2,70,1.61,243.49,33459,81470,48011,246,440,194,120399,4420,4420,4420,6,0,1,19456,23197,0,6
110100,009580,4420,2,70,1.61,243.52,33459,81480,48021,246,442,196,120409,4420,4420,4420,16,0,3,19461,23747,0,16
110200,009580,4420,2,70,1.61,243.52,33459,81480,48021,246,442,196,120409,4420,4420,4420,0,0,0,19461,23747,0,0
110200,009580,4415,2,65,1.49,242.37,33619,81482,47863,248,444,196,120571,4420,4420,4415,162,2,2,19965,21034,160,2
110300,009580,4420,2,70,1.61,242.56,33634,81583,47949,250,449,199,120687,4410,4420,4410,98,1,4,19995,23531,6,92
110400,009580,4420,2,70,1.61,244.99,33634,82401,48767,250,452,202,121505,4420,4420,4420,0,0,0,19300,21141,0,0
110400,009580,4425,2,75,1.72,245.0,33634,82403,48769,250,454,204,121507,4425,4425,4425,2,0,2,21529,21101,0,2
110500,009580,4420,2,70,1.61,245.01,33634,82405,48771,250,456,206,121509,4420,4420,4420,0,0,0,20874,21101,0,0
110500,009580,4415,2,65,1.49,244.9,33649,82407,48758,253,458,205,121526,4420,4420,4415,17,3,2,31016,20555,15,2
110600,009580,4415,2,65,1.49,243.81,33800,82408,48608,255,459,204,121678,4415,4415,4415,0,0,0,31450,22993,0,0
110600,009580,4415,2,65,1.49,243.83,33800,82416,48616,255,462,207,121686,4415,4415,4415,8,0,3,31750,23173,0,8
110700,009580,4415,2,65,1.49,243.84,33800,82417,48617,255,463,208,121687,4415,4415,4415,1,0,1,31955,23105,0,1
110700,009580,4420,2,70,1.61,248.12,33800,83866,50066,255,466,211,123136,4415,4420,4415,1450,0,4,32663,23205,0,1450
110800,009580,4410,2,60,1.38,247.59,33915,83970,50055,258,470,212,123355,4410,4420,4410,219,3,4,31800,23112,115,104
110900,009580,4415,2,65,1.49,247.58,33920,83978,50058,259,472,213,123368,4415,4415,4415,0,0,0,31598,23053,0,0
110900,009580,4415,2,65,1.49,247.59,33920,83983,50063,259,475,216,123373,4415,4415,4415,5,0,3,31588,23051,0,5
111000,009580,4415,2,65,1.49,247.61,33920,83988,50068,259,478,219,123378,4415,4415,4415,2,0,2,33662,23221,0,2
111000,009580,4415,2,65,1.49,234.75,35825,84098,48273,263,480,217,125393,4415,4415,4400,2017,4,4,33661,22732,1905,112
111100,009580,4410,2,60,1.38,234.1,35925,84099,48174,264,481,217,125494,4415,4415,4410,101,1,1,33659,22658,100,1
111200,009580,4415,2,65,1.49,234.81,35925,84357,48432,264,485,221,125752,4415,4415,4415,0,0,0,33652,22898,0,0
111200,009580,4415,2,65,1.49,234.82,35925,84359,48434,264,487,223,125754,4415,4415,4415,2,0,2,33774,22826,0,2
111300,009580,4405,2,55,1.26,234.76,35934,84359,48425,265,487,222,125763,4405,4405,4405,9,1,0,33773,22826,9,0
111300,009580,4410,2,60,1.38,234.75,35941,84370,48429,266,489,223,125781,4405,4415,4405,27,2,2,31135,22910,16,11
111400,009580,4410,2,60,1.38,234.77,35941,84378,48437,266,491,225,125789,4410,4410,4410,7,0,1,31472,22546,0,7
111400,009580,4415,2,65,1.49,235.72,35941,84720,48779,266,495,229,126131,4410,4415,4410,349,0,5,33786,22651,0,349
111500,009580,4410,2,60,1.38,235.93,35941,84795,48854,266,498,232,126206,4410,4410,4410,59,0,2,31257,23651,0,59
111600,009580,4405,2,55,1.26,236.47,35955,85024,49069,268,500,232,126449,4405,4405,4405,0,0,0,33784,23663,0,0
111600,009580,4415,2,65,1.49,237.3,35955,85323,49368,268,504,236,126748,4410,4415,4410,299,0,4,33784,23507,0,299
111700,009580,4415,2,65,1.49,238.15,35955,85627,49672,268,508,240,127052,4415,4415,4415,296,0,1,33765,23167,0,296
111700,009580,4415,2,65,1.49,238.44,35955,85730,49775,268,510,242,127155,4415,4415,4415,399,0,3,33468,23054,0,399
111800,009580,4415,2,65,1.49,238.44,35955,85730,49775,268,510,242,127155,4415,4415,4415,0,0,0,33468,23054,0,0
111800,009580,4415,2,65,1.49,238.31,35975,85731,49756,271,511,240,127176,4410,4415,4410,21,3,1,34136,23036,20,1
111900,009580,4415,2,65,1.49,238.33,35975,85740,49765,271,514,243,127185,4415,4415,4415,9,0,3,34726,23036,0,9
111900,009580,4415,2,65,1.49,238.33,35975,85741,49766,271,515,244,127186,4415,4415,4415,10,0,4,34719,23036,0,10
112000,009580,4410,2,60,1.38,236.57,36244,85741,49497,274,515,241,127455,4410,4410,4410,29,2,0,34697,21917,29,0
112100,009580,4410,2,60,1.38,236.48,36258,85742,49484,276,516,240,127470,4410,4410,4410,0,0,0,34696,22501,0,0
112100,009580,4410,2,60,1.38,236.72,36279,85881,49602,277,520,243,127630,4415,4415,4410,160,1,4,31908,23132,21,139
112200,009580,4415,2,65,1.49,238.05,36279,86363,50084,277,525,248,128112,4410,4415,4410,26,0,2,34631,23561,0,26
112200,009580,4410,2,60,1.38,236.66,36492,86363,49871,278,525,247,128325,4410,4415,4410,239,1,2,34630,23356,213,26
112300,009580,4410,2,60,1.38,236.69,36492,86374,49882,278,527,249,128336,4410,4410,4410,11,0,2,33034,23361,0,11
112300,009580,4410,2,60,1.38,236.54,36516,86375,49859,281,528,247,128361,4410,4410,4405,36,3,3,33024,23338,24,12
112400,009580,4410,2,60,1.38,236.54,36516,86376,49860,281,529,248,128362,4410,4410,4410,1,0,1,33023,25540,0,1
112500,009580,4410,2,60,1.38,236.56,36516,86383,49867,281,530,249,128369,4410,4410,4410,0,0,0,33022,25540,0,0
112500,009580,4410,2,60,1.38,236.56,36516,86384,49868,281,531,250,128370,4410,4410,4410,1,0,1,33015,25540,0,1
112600,009580,4410,2,60,1.38,236.79,36530,86500,49970,283,534,251,128500,4410,4410,4405,121,1,2,33012,25526,6,115
112600,009580,4405,2,55,1.26,235.92,36665,86500,49835,284,534,250,128635,4410,4410,4405,256,2,2,33098,26648,141,115
112700,009580,4410,2,60,1.38,235.94,36665,86507,49842,284,536,252,128642,4410,4410,4410,6,0,1,33097,26513,0,6
112700,009580,4410,2,60,1.38,236.38,36665,86667,50002,284,540,256,128802,4410,4410,4410,166,0,5,32932,26513,0,166
112800,009580,4410,2,60,1.38,236.41,36665,86679,50014,284,543,259,128814,4410,4410,4410,11,0,2,32920,26513,0,11
112800,009580,4405,2,55,1.26,234.97,36890,86679,49789,287,543,256,129039,4410,4410,4405,236,3,2,32919,26498,225,11
112900,009580,4405,2,55,1.26,234.87,36952,86790,49838,289,545,256,129212,4410,4410,4405,173,2,2,32908,26805,62,111
113000,009580,4410,2,60,1.38,234.98,36985,86908,49923,290,550,260,129363,4410,4410,4410,3,0,3,32892,26727,0,3
113000,009580,4410,2,60,1.38,235.33,36985,87036,50051,290,551,261,129491,4410,4410,4410,131,0,4,32890,26726,0,131
113100,009580,4405,2,55,1.26,235.38,36999,87087,50088,292,553,261,129556,4410,4410,4405,65,2,2,32711,26174,14,51
113100,009580,4405,2,55,1.26,235.38,36999,87087,50088,292,553,261,129556,4410,4410,4405,65,2,2,32711,26174,14,51
113200,009580,4410,2,60,1.38,234.59,37126,87094,49968,294,554,260,129690,4405,4410,4405,37,1,1,32853,26043,30,7
113200,009580,4410,2,60,1.38,234.71,37126,87138,50012,294,555,261,129734,4405,4410,4405,81,1,2,32846,26043,30,51
113300,009580,4410,2,60,1.38,234.71,37126,87138,50012,294,555,261,129734,4410,4410,4410,0,0,0,32846,26043,0,0
113400,009580,4405,2,55,1.26,234.61,37141,87138,49997,296,555,259,129749,4405,4405,4405,0,0,0,32802,25955,0,0
113400,009580,4410,2,60,1.38,234.74,37141,87185,50044,296,557,261,129796,4410,4410,4410,47,0,2,32756,25949,0,47
113500,009580,4410,2,60,1.38,234.76,37141,87191,50050,296,558,262,129802,4410,4410,4410,0,0,0,32756,25954,0,0
113500,009580,4410,2,60,1.38,234.92,37141,87250,50109,296,559,263,129861,4410,4410,4410,59,0,1,32750,25954,0,59
113600,009580,4405,2,55,1.26,234.87,37149,87250,50101,297,559,262,129869,4405,4405,4405,8,1,0,32691,25954,8,0
113600,009580,4405,2,55,1.26,234.82,37156,87250,50094,298,559,261,129876,4405,4405,4405,15,2,0,32691,25946,15,0
113700,009580,4400,2,50,1.15,220.02,39656,87250,47594,300,559,259,132376,4405,4405,4400,2500,2,0,32691,25940,2500,0
113800,009580,4410,2,60,1.38,220.03,39656,87257,47601,300,560,260,132383,4410,4410,4410,0,0,0,32691,24380,0,0
113800,009580,4405,2,55,1.26,220.09,39656,87277,47621,300,562,262,132403,4405,4405,4405,20,0,2,32020,24603,0,20
113900,009580,4400,2,50,1.15,220.0,39671,87277,47606,302,562,260,132418,4400,4400,4400,0,0,0,32060,24810,0,0
113900,009580,4400,2,50,1.15,220.0,39671,87277,47606,302,562,260,132418,4400,4400,4400,0,0,0,32060,24810,0,0
114000,009580,4405,2,55,1.26,221.03,39671,87683,48012,302,564,262,132824,4405,4405,4405,406,0,2,31660,24701,0,406
114000,009580,4400,2,50,1.15,216.38,40523,87683,47160,304,564,260,133676,4405,4405,4400,1258,2,2,31639,24686,852,406
114100,009580,4400,2,50,1.15,216.29,40539,87683,47144,306,564,258,133692,4400,4400,4400,16,2,0,31639,23981,16,0
114100,009580,4400,2,50,1.15,212.59,41245,87683,46438,309,564,255,134398,4400,4400,4400,722,5,0,31139,23266,722,0
114200,009580,4400,2,50,1.15,212.59,41245,87683,46438,309,564,255,134398,4400,4400,4400,0,0,0,31139,23266,0,0
114300,009580,4400,2,50,1.15,210.98,41564,87690,46126,310,565,255,134724,4400,4400,4400,0,0,0,31257,23462,0,0
114300,009580,4400,2,50,1.15,210.98,41564,87691,46127,310,566,256,134725,4400,4400,4400,1,0,1,27168,27604,0,1
114400,009580,4395,2,45,1.03,210.9,41579,87691,46112,312,566,254,134740,4395,4395,4395,6,1,0,27367,27845,6,0
114400,009580,4395,2,45,1.03,210.9,41579,87691,46112,312,566,254,134740,4395,4395,4395,6,1,0,27367,27845,6,0
114500,009580,4395,2,45,1.03,210.9,41579,87691,46112,312,566,254,134740,4395,4395,4395,0,0,0,27367,27845,0,0
114500,009580,4400,2,50,1.15,210.94,41579,87708,46129,312,569,257,134757,4400,4400,4400,17,0,3,27559,28184,0,17
114600,009580,4400,2,50,1.15,210.94,41579,87708,46129,312,569,257,134757,4400,4400,4400,0,0,0,27559,28184,0,0
114700,009580,4395,2,45,1.03,210.87,41593,87708,46115,314,569,255,134771,4395,4395,4395,0,0,0,27549,29176,0,0
114700,009580,4395,2,45,1.03,209.53,41859,87708,45849,316,569,253,135037,4395,4395,4395,266,2,0,27551,29004,266,0
114800,009580,4400,2,50,1.15,209.55,41859,87715,45856,316,570,254,135044,4400,4400,4400,0,0,0,27550,28915,0,0
114800,009580,4400,2,50,1.15,209.55,41859,87715,45856,316,570,254,135044,4400,4400,4400,0,0,0,27550,28915,0,0
114900,009580,4395,2,45,1.03,209.47,41874,87715,45841,318,570,252,135059,4395,4395,4395,15,2,0,27543,29108,15,0
114900,009580,4395,2,45,1.03,209.47,41874,87715,45841,318,570,252,135059,4395,4395,4395,15,2,0,27543,29108,15,0
115000,009580,4395,2,45,1.03,204.59,42874,87715,44841,319,570,251,136059,4395,4395,4395,1000,1,0,27782,29103,1000,0
115000,009580,4400,2,50,1.15,204.6,42874,87721,44847,319,571,252,136065,4395,4400,4395,1006,1,1,27782,28173,1000,6
115100,009580,4400,2,50,1.15,204.6,42874,87721,44847,319,571,252,136065,4400,4400,4400,0,0,0,27782,28173,0,0
115200,009580,4395,2,45,1.03,203.82,43083,87810,44727,322,572,250,136363,4395,4395,4395,0,0,0,27685,28484,0,0
115200,009580,4395,2,45,1.03,203.82,43083,87810,44727,322,572,250,136363,4395,4395,4395,0,0,0,27685,28484,0,0
115300,009580,4400,2,50,1.15,203.83,43083,87817,44734,322,573,251,136370,4400,4400,4400,7,0,1,37682,28890,0,7
115300,009580,4400,2,50,1.15,203.83,43083,87817,44734,322,573,251,136370,4400,4400,4400,7,0,1,37682,28890,0,7
115400,009580,4395,2,45,1.03,203.76,43098,87817,44719,324,573,249,136385,4395,4395,4395,15,2,0,37675,29646,15,0
115400,009580,4395,2,45,1.03,203.19,43220,87817,44597,326,573,247,136507,4395,4395,4395,137,4,0,37675,29640,137,0
115500,009580,4395,2,45,1.03,203.19,43220,87817,44597,326,573,247,136507,4395,4395,4395,0,0,0,37675,29640,0,0
115600,009580,4400,2,50,1.15,203.2,43220,87823,44603,326,574,248,136513,4400,4400,4400,0,0,0,37715,29519,0,0
115600,009580,4400,2,50,1.15,203.21,43220,87826,44606,326,577,251,136516,4400,4400,4400,3,0,3,37709,29519,0,3
115700,009580,4395,2,45,1.03,203.14,43234,87826,44592,328,577,249,136530,4395,4395,4395,0,0,0,37806,29706,0,0
115700,009580,4400,2,50,1.15,203.16,43234,87836,44602,328,578,250,136540,4400,4400,4400,10,0,1,37806,29750,0,10
115800,009580,4400,2,50,1.15,203.16,43234,87836,44602,328,578,250,136540,4400,4400,4400,0,0,0,37806,29750,0,0
115800,009580,4400,2,50,1.15,203.18,43234,87845,44611,328,581,253,136549,4400,4400,4400,9,0,3,37788,29760,0,9
115900,009580,4395,2,45,1.03,203.11,43250,87845,44595,330,581,251,136565,4395,4395,4395,16,2,0,37787,29873,16,0
115900,009580,4395,2,45,1.03,203.11,43250,87845,44595,330,581,251,136565,4395,4395,4395,16,2,0,37787,29873,16,0
120000,009580,4395,2,45,1.03,200.94,43717,87845,44128,333,581,248,137032,4395,4395,4395,467,3,0,37905,30699,467,0
120100,009580,4400,2,50,1.15,200.25,43872,87852,43980,334,582,248,137194,4400,4400,4400,7,0,1,37905,29609,0,7
120100,009580,4400,2,50,1.15,200.25,43872,87852,43980,334,582,248,137194,4400,4400,4400,7,0,1,37905,29609,0,7
120200,009580,4400,2,50,1.15,200.2,43886,87859,43973,336,584,248,137215,4400,4400,4400,7,0,2,37893,30462,0,7
120200,009580,4400,2,50,1.15,200.51,43886,87997,44111,336,586,250,137353,4400,4400,4400,145,0,4,37775,30308,0,145
120300,009580,4400,2,50,1.15,200.52,43886,87999,44113,336,588,252,137355,4400,4400,4400,2,0,2,37753,30453,0,2
120300,009580,4395,2,45,1.03,200.14,43969,87999,44030,337,588,251,137438,4400,4400,4395,85,1,2,37752,30487,83,2
120400,009580,4395,2,45,1.03,200.1,43978,87999,44021,338,588,250,137447,4395,4395,4395,9,1,0,37752,29304,9,0
120500,009580,4395,2,45,1.03,200.07,43984,87999,44015,339,588,249,137453,4395,4395,4395,0,0,0,37752,29295,0,0
120500,009580,4400,2,50,1.15,201.1,43984,88452,44468,339,589,250,137906,4400,4400,4400,453,0,1,37752,29289,0,453
120600,009580,4400,2,50,1.15,201.1,43984,88452,44468,339,589,250,137906,4400,4400,4400,0,0,0,37752,29289,0,0
120600,009580,4400,2,50,1.15,201.1,43984,88452,44468,339,589,250,137906,4400,4400,4400,0,0,0,41743,25204,0,0
120700,009580,4400,2,50,1.15,201.0,44005,88452,44447,342,589,247,137927,4400,4400,4400,14,2,0,41743,25189,14,0
120700,009580,4400,2,50,1.15,201.0,44005,88452,44447,342,589,247,137927,4400,4400,4400,14,2,0,41743,25189,14,0
120800,009580,4400,2,50,1.15,200.21,44179,88452,44273,344,589,245,138101,4400,4400,4400,174,2,0,41743,25134,174,0
120900,009580,4400,2,50,1.15,200.21,44179,88452,44273,344,589,245,138101,4400,4400,4400,0,0,0,41743,25134,0,0
120900,009580,4400,2,50,1.15,200.17,44188,88452,44264,345,589,244,138110,4400,4400,4400,9,1,0,41743,25165,9,0
121000,009580,4400,2,50,1.15,200.14,44194,88452,44258,346,589,243,138116,4400,4400,4400,0,0,0,41743,25156,0,0
121000,009580,4405,2,55,1.26,200.15,44194,88453,44259,346,590,244,138117,4405,4405,4405,1,0,1,41793,25151,0,1
121100,009580,4405,2,55,1.26,200.15,44194,88453,44259,346,590,244,138117,4405,4405,4405,0,0,0,41793,25151,0,0
121100,009580,4400,2,50,1.15,199.16,44694,89011,44317,347,592,245,139175,4405,4405,4400,1058,1,2,33011,24663,500,558
121200,009580,4410,2,60,1.38,199.1,44708,89012,44304,349,593,244,139190,4400,4410,4400,15,2,1,33011,24656,14,1
121300,009580,4410,2,60,1.38,199.1,44708,89012,44304,349,593,244,139190,4410,4410,4410,0,0,0,33011,24656,0,0
121300,009580,4410,2,60,1.38,199.1,44708,89012,44304,349,593,244,139190,4410,4410,4410,0,0,0,33010,24656,0,0
121400,009580,4410,2,60,1.38,199.1,44708,89015,44307,349,596,247,139193,4410,4410,4410,3,0,3,34040,24656,0,3
121400,009580,4400,2,50,1.15,199.14,44717,89049,44332,350,597,247,139236,4410,4410,4400,46,1,4,34003,24746,9,37
121500,009580,4400,2,50,1.15,199.11,44723,89049,44326,351,597,246,139242,4400,4400,4400,0,0,0,34003,24737,0,0
121500,009580,4400,2,50,1.15,199.11,44723,89049,44326,351,597,246,139242,4400,4400,4400,0,0,0,34003,24737,0,0
121600,009580,4400,2,50,1.15,199.11,44723,89049,44326,351,597,246,139242,4400,4400,4400,0,0,0,34003,24831,0,0
121700,009580,4410,2,60,1.38,199.54,44723,89241,44518,351,598,247,139434,4410,4410,4410,0,0,0,34257,24846,0,0
121700,009580,4400,2,50,1.15,199.48,44737,89241,44504,353,598,245,139448,4400,4400,4400,14,2,0,34165,24724,14,0
121800,009580,4400,2,50,1.15,199.48,44737,89241,44504,353,598,245,139448,4400,4400,4400,0,0,0,34165,24724,0,0
121800,009580,4400,2,50,1.15,199.48,44737,89241,44504,353,598,245,139448,4400,4400,4400,0,0,0,34365,24944,0,0
121900,009580,4400,2,50,1.15,199.48,44737,89241,44504,353,598,245,139448,4400,4400,4400,0,0,0,33865,25100,0,0
121900,009580,4400,2,50,1.15,198.97,44852,89241,44389,356,598,242,139563,4400,4400,4400,115,3,0,33865,25021,115,0
122000,009580,4400,2,50,1.15,198.53,44952,89241,44289,357,598,241,139663,4400,4400,4400,100,1,0,33865,24915,100,0
122100,009580,4400,2,50,1.15,198.04,45062,89241,44179,358,598,240,139773,4400,4400,4400,0,0,0,33865,24929,0,0
122100,009580,4400,2,50,1.15,198.04,45062,89241,44179,358,598,240,139773,4400,4400,4400,0,0,0,33865,24929,0,0
122200,009580,4400,2,50,1.15,198.04,45062,89241,44179,358,598,240,139773,4400,4400,4400,0,0,0,34758,29301,0,0
122200,009580,4395,2,45,1.03,197.97,45077,89241,44164,360,598,238,139788,4395,4395,4395,15,2,0,34758,29293,15,0
122300,009580,4395,2,45,1.03,196.23,45477,89241,43764,361,598,237,140188,4395,4395,4395,400,1,0,33941,29287,400,0
122300,009580,4395,2,45,1.03,196.23,45478,89241,43763,362,598,236,140189,4395,4395,4395,401,2,0,34926,28919,401,0
122400,009580,4395,2,45,1.03,196.23,45478,89241,43763,362,598,236,140189,4395,4395,4395,0,0,0,34926,28919,0,0
122500,009580,4395,2,45,1.03,196.16,45493,89241,43748,364,598,234,140204,4395,4395,4395,0,0,0,34926,29121,0,0
122500,009580,4395,2,45,1.03,196.16,45493,89241,43748,364,598,234,140204,4395,4395,4395,0,0,0,34926,29121,0,0
122600,009580,4395,2,45,1.03,195.73,45593,89241,43648,365,598,233,140304,4395,4395,4395,0,0,0,35101,29116,0,0
122600,009580,4400,2,50,1.15,194.38,45911,89241,43330,367,598,231,140622,4400,4400,4400,318,2,0,35102,74852,318,0
122700,009580,4400,2,50,1.15,194.38,45911,89241,43330,367,598,231,140622,4400,4400,4400,0,0,0,35102,74852,0,0
122700,009580,4400,2,50,1.15,194.32,45925,89241,43316,369,598,229,140636,4400,4400,4400,14,2,0,35102,74784,14,0
122800,009580,4400,2,50,1.15,194.32,45925,89241,43316,369,598,229,140636,4400,4400,4400,0,0,0,35102,74784,0,0
122800,009580,4405,2,55,1.26,195.9,45925,89966,44041,369,602,233,141361,4405,4405,4405,725,0,4,34777,75278,0,725
122900,009580,4405,2,55,1.26,196.36,45925,90177,44252,369,604,235,141572,4405,4405,4405,211,0,2,34177,75409,0,211
123000,009580,4405,2,55,1.26,197.2,45940,90593,44653,371,606,235,142003,4410,4410,4405,315,2,1,34849,73940,15,300
123000,009580,4405,2,55,1.26,197.2,45940,90593,44653,371,606,235,142003,4410,4410,4405,315,2,1,34849,73940,15,300
123100,009580,4405,2,55,1.26,197.2,45940,90593,44653,371,606,235,142003,4405,4405,4405,0,0,0,34849,73940,0,0
123100,009580,4405,2,55,1.26,197.2,45940,90593,44653,371,606,235,142003,4405,4405,4405,0,0,0,34849,74582,0,0
123200,009580,4405,2,55,1.26,196.54,46093,90593,44500,372,606,234,142156,4405,4405,4405,0,0,0,34850,74383,0,0
123200,009580,4405,2,55,1.26,196.48,46107,90593,44486,374,606,232,142170,4405,4405,4405,14,2,0,34850,74242,14,0
123300,009580,4405,2,55,1.26,196.48,46107,90593,44486,374,606,232,142170,4405,4405,4405,0,0,0,34850,74242,0,0
123400,009580,4405,2,55,1.26,196.48,46107,90593,44486,374,606,232,142170,4405,4405,4405,0,0,0,35030,74386,0,0
123400,009580,4405,2,55,1.26,196.48,46108,90593,44485,375,606,231,142171,4405,4405,4405,1,1,0,35279,24789,1,0
123500,009580,4405,2,55,1.26,194.69,46617,90759,44142,377,607,230,142846,4410,4410,4405,675,2,1,35113,24416,509,166
123500,009580,4405,2,55,1.26,194.54,46654,90759,44105,379,607,228,142883,4410,4410,4405,712,4,1,35113,25481,546,166
123600,009580,4405,2,55,1.26,194.49,46664,90759,44095,380,607,227,142893,4405,4405,4405,10,1,0,35113,25440,10,0
123600,009580,4405,2,55,1.26,194.49,46664,90759,44095,380,607,227,142893,4405,4405,4405,10,1,0,35113,25440,10,0
123700,009580,4405,2,55,1.26,194.49,46664,90759,44095,380,607,227,142893,4405,4405,4405,0,0,0,35113,25440,0,0
123800,009580,4410,2,60,1.38,198.45,46678,92631,45953,382,609,227,144779,4410,4410,4410,0,0,0,34153,25464,0,0
123800,009580,4415,2,65,1.49,198.24,46728,92632,45904,383,610,227,144830,4410,4415,4410,51,1,1,35922,22564,50,1
123900,009580,4415,2,65,1.49,198.24,46728,92635,45907,383,611,228,144833,4415,4415,4415,0,0,0,35921,22564,0,0
123900,009580,4410,2,60,1.38,199.37,46728,93160,46432,383,612,229,145358,4410,4410,4410,525,0,1,33852,24254,0,525
124000,009580,4405,2,55,1.26,199.33,46737,93160,46423,384,612,228,145367,4405,4405,4405,9,1,0,34119,25726,9,0
124000,009580,4405,2,55,1.26,199.22,46763,93160,46397,386,612,226,145393,4405,4405,4405,35,3,0,34969,25712,35,0
124100,009580,4405,2,55,1.26,199.22,46763,93160,46397,386,612,226,145393,4405,4405,4405,0,0,0,34969,25712,0,0
124200,009580,4405,2,55,1.26,197.75,47109,93160,46051,387,612,225,145739,4405,4405,4405,0,0,0,35116,25982,0,0
124200,009580,4405,2,55,1.26,197.75,47109,93160,46051,387,612,225,145739,4405,4405,4405,0,0,0,33803,26927,0,0
124300,009580,4400,2,50,1.15,197.7,47123,93161,46038,389,613,224,145754,4400,4400,4400,0,0,0,33802,27249,0,0
124300,009580,4400,2,50,1.15,197.7,47123,93161,46038,389,613,224,145754,4400,4400,4400,0,0,0,33802,27249,0,0
124400,009580,4400,2,50,1.15,197.7,47123,93161,46038,389,613,224,145754,4400,4400,4400,0,0,0,33902,27243,0,0
124400,009580,4400,2,50,1.15,194.32,47963,93202,45239,391,614,223,146635,4400,4400,4400,881,2,1,28701,30403,840,41
124500,009580,4400,2,50,1.15,194.43,47963,93254,45291,391,615,224,146687,4400,4400,4400,0,0,0,28660,30554,0,0
124600,009580,4400,2,50,1.15,194.36,47979,93254,45275,393,615,222,146703,4400,4400,4400,0,0,0,33902,26453,0,0
124600,009580,4400,2,50,1.15,194.36,47979,93254,45275,393,615,222,146703,4400,4400,4400,0,0,0,33902,26446,0,0
124700,009580,4400,2,50,1.15,194.33,47988,93254,45266,394,615,221,146712,4400,4400,4400,0,0,0,34043,26446,0,0
124700,009580,4400,2,50,1.15,194.33,47988,93254,45266,394,615,221,146712,4400,4400,4400,0,0,0,34043,26446,0,0
124800,009580,4405,2,55,1.26,193.9,48094,93255,45161,397,616,219,146819,4400,4405,4400,107,3,1,34043,26331,106,1
124800,009580,4400,2,50,1.15,193.83,48111,93255,45144,398,616,218,146836,4400,4405,4400,124,4,1,34042,26345,123,1
124900,009580,4400,2,50,1.15,195.02,48111,93826,45715,398,620,222,147407,4400,4400,4400,571,0,4,28482,30535,0,571
124900,009580,4405,2,55,1.26,195.02,48111,93828,45717,398,621,223,147409,4400,4405,4400,573,0,5,33754,30869,0,573
125000,009580,4400,2,50,1.15,194.6,48216,93829,45613,399,622,223,147515,4405,4405,4400,106,1,1,33751,26767,105,1
125100,009580,4395,2,45,1.03,194.54,48231,93829,45598,401,622,221,147530,4395,4395,4395,0,0,0,33751,30493,0,0
125100,009580,4405,2,55,1.26,194.55,48231,93832,45601,401,624,223,147533,4405,4405,4405,3,0,2,33749,30725,0,3
125200,009580,4405,2,55,1.26,194.55,48231,93833,45602,401,625,224,147534,4405,4405,4405,1,0,1,33748,30725,0,1
125200,009580,4405,2,55,1.26,194.56,48231,93836,45605,401,626,225,147537,4405,4405,4405,4,0,2,33747,30725,0,4
125300,009580,4395,2,45,1.03,194.49,48246,93836,45590,404,626,222,147552,4395,4395,4395,15,3,0,33744,30711,15,0
125300,009580,4395,2,45,1.03,194.49,48246,93836,45590,404,626,222,147552,4395,4395,4395,15,3,0,33744,30711,15,0
125400,009580,4395,2,45,1.03,194.49,48246,93836,45590,404,626,222,147552,4395,4395,4395,0,0,0,33880,30759,0,0
125500,009580,4395,2,45,1.03,193.81,48417,93836,45419,405,626,221,147723,4395,4395,4395,0,0,0,33880,30710,0,0
125500,009580,4395,2,45,1.03,193.75,48432,93836,45404,407,626,219,147738,4395,4395,4395,15,2,0,33910,30688,15,0
125600,009580,4395,2,45,1.03,193.54,48487,93842,45355,409,628,219,147799,4395,4395,4395,0,0,0,33904,30629,0,0
125700,009580,4400,2,50,1.15,193.82,48487,93979,45492,409,629,220,147936,4400,4400,4400,0,0,0,28606,30777,0,0
125700,009580,4400,2,50,1.15,193.82,48487,93979,45492,409,629,220,147936,4400,4400,4400,0,0,0,28606,30777,0,0
125800,009580,4400,2,50,1.15,194.29,48502,94236,45734,411,630,219,148208,4405,4405,4400,272,2,1,33506,26367,15,257
125800,009580,4405,2,55,1.26,194.44,48502,94308,45806,411,631,220,148280,4405,4405,4400,344,2,2,33628,26325,15,329
125900,009580,4405,2,55,1.26,194.44,48502,94308,45806,411,631,220,148280,4405,4405,4405,0,0,0,33628,26325,0,0
130000,009580,4405,2,55,1.26,195.27,48502,94708,46206,411,632,221,148680,4405,4405,4405,0,0,0,33634,30334,0,0
130000,009580,4395,2,45,1.03,195.64,48518,94919,46401,413,637,224,148907,4405,4405,4395,227,2,5,33153,30503,16,211
130100,009580,4395,2,45,1.03,195.64,48518,94919,46401,413,637,224,148907,4395,4395,4395,0,0,0,33153,30503,0,0
130200,009580,4405,2,55,1.26,195.2,48628,94920,46292,414,638,224,149018,4395,4405,4395,111,1,1,33553,30172,110,1
130200,009580,4405,2,55,1.26,195.04,48741,95064,46323,415,639,224,149275,4395,4405,4395,368,2,2,33552,30065,223,145
130300,009580,4405,2,55,1.26,195.13,48741,95110,46369,415,640,225,149321,4405,4405,4405,46,0,1,33573,26057,0,46
130400,009580,4405,2,55,1.26,195.23,48741,95156,46415,415,641,226,149367,4405,4405,4405,0,0,0,33527,26207,0,0
130400,009580,4405,2,55,1.26,195.23,48741,95157,46416,415,642,227,149368,4405,4405,4405,1,0,1,33481,26216,0,1
130500,009580,4405,2,55,1.26,195.23,48741,95157,46416,415,642,227,149368,4405,4405,4405,0,0,0,33481,26216,0,0
130500,009580,4405,2,55,1.26,195.23,48741,95157,46416,415,642,227,149368,4405,4405,4405,0,0,0,33481,26216,0,0
130600,009580,4405,2,55,1.26,195.41,48741,95244,46503,415,644,229,149455,4405,4405,4405,87,0,2,34433,26296,0,87
130700,009580,4400,2,50,1.15,195.11,48815,95245,46430,416,645,229,149530,4400,4400,4400,0,0,0,34392,26401,0,0
130700,009580,4400,2,50,1.15,195.11,48815,95245,46430,416,645,229,149530,4400,4400,4400,0,0,0,34392,26401,0,0
130800,009580,4395,2,45,1.03,195.07,48825,95245,46420,417,645,228,149540,4395,4395,4395,0,0,0,30098,30544,0,0
130900,009580,4400,2,50,1.15,195.15,48825,95284,46459,417,646,229,149579,4400,4400,4400,0,0,0,30098,30539,0,0
130900,009580,4400,2,50,1.15,195.16,48825,95286,46461,417,648,231,149581,4400,4400,4400,2,0,2,30059,30521,0,2
131000,009580,4395,2,45,1.03,194.75,48927,95286,46359,418,648,230,149683,4395,4395,4395,102,1,0,30057,29520,102,0
131000,009580,4400,2,50,1.15,197.23,48927,96500,47573,418,650,232,150897,4395,4400,4395,1316,1,2,28857,29669,102,1214
131100,009580,4395,2,45,1.03,196.45,49390,97029,47639,420,652,232,151889,4400,4400,4395,992,2,2,29602,34605,463,529
131200,009580,4405,2,55,1.26,196.58,49390,97091,47701,420,654,234,151951,4405,4405,4405,45,0,1,34350,26047,0,45
131200,009580,4405,2,55,1.26,196.58,49390,97091,47701,420,654,234,151951,4405,4405,4405,45,0,1,34350,26047,0,45
131300,009580,4405,2,55,1.26,196.58,49390,97091,47701,420,654,234,151951,4405,4405,4405,0,0,0,34350,26047,0,0
131400,009580,4400,2,50,1.15,195.98,49541,97092,47551,421,655,234,152103,4400,4400,4400,151,1,0,34740,27106,151,0
131400,009580,4405,2,55,1.26,196.01,49541,97107,47566,421,656,235,152118,4400,4405,4400,166,1,1,35933,26961,151,15
131500,009580,4405,2,55,1.26,196.13,49541,97163,47622,421,657,236,152174,4405,4405,4405,56,0,1,35933,26961,0,56
131500,009580,4405,2,55,1.26,196.13,49541,97164,47623,421,658,237,152175,4405,4405,4405,57,0,2,36143,26986,0,57
131600,009580,4405,2,55,1.26,196.13,49541,97164,47623,421,658,237,152175,4405,4405,4405,0,0,0,36143,26986,0,0
131700,009580,4405,2,55,1.26,196.13,49541,97164,47623,421,658,237,152175,4405,4405,4405,0,0,0,36142,26991,0,0
131700,009580,4405,2,55,1.26,196.13,49541,97164,47623,421,658,237,152175,4405,4405,4405,0,0,0,36142,27110,0,0
131800,009580,4405,2,55,1.26,196.14,49541,97171,47630,421,661,240,152182,4405,4405,4405,5,0,1,37440,27009,0,5
131800,009580,4405,2,55,1.26,196.14,49541,97171,47630,421,661,240,152182,4405,4405,4405,5,0,1,37440,27009,0,5
131900,009580,4405,2,55,1.26,196.14,49541,97171,47630,421,661,240,152182,4405,4405,4405,0,0,0,37435,26929,0,0
132000,009580,4400,2,50,1.15,196.04,49610,97253,47643,422,663,241,152333,4400,4400,4400,70,1,1,32135,30946,69,1
132000,009580,4400,2,50,1.15,196.04,49610,97253,47643,422,663,241,152333,4400,4400,4400,70,1,1,32135,30946,69,1
132100,009580,4400,2,50,1.15,196.04,49610,97253,47643,422,663,241,152333,4400,4400,4400,0,0,0,32135,30946,0,0
132200,009580,4400,2,50,1.15,196.04,49610,97253,47643,422,663,241,152333,4400,4400,4400,0,0,0,32634,31311,0,0
132200,009580,4395,2,45,1.03,195.42,49766,97254,47488,423,664,241,152490,4400,4400,4395,157,1,1,33433,31316,156,1
132300,009580,4395,2,45,1.03,195.42,49766,97254,47488,423,664,241,152490,4395,4395,4395,0,0,0,33433,31316,0,0
132300,009580,4395,2,45,1.03,195.42,49766,97254,47488,423,664,241,152490,4395,4395,4395,0,0,0,33433,31316,0,0
132400,009580,4395,2,45,1.03,193.86,50166,97254,47088,424,664,240,152890,4395,4395,4395,400,1,0,34123,32238,400,0
132500,009580,4395,2,45,1.03,188.35,51635,97254,45619,426,664,238,154359,4395,4395,4395,0,0,0,34123,32602,0,0
132500,009580,4395,2,45,1.03,188.35,51635,97254,45619,426,664,238,154359,4395,4395,4395,0,0,0,34123,32602,0,0
132600,009580,4395,2,45,1.03,189.94,51635,98075,46440,426,666,240,155180,4395,4395,4395,821,0,2,30159,37417,0,821
132700,009580,4395,2,45,1.03,189.94,51635,98075,46440,426,666,240,155180,4395,4395,4395,0,0,0,30159,37417,0,0
132700,009580,4400,2,50,1.15,190.35,51735,98475,46740,427,667,240,155680,4395,4400,4395,500,1,1,32815,32318,100,400
132800,009580,4400,2,50,1.15,190.35,51735,98475,46740,427,667,240,155680,4400,4400,4400,0,0,0,32815,32318,0,0
132900,009580,4400,2,50,1.15,190.55,51838,98776,46938,428,669,241,156084,4400,4400,4400,0,0,0,32314,32024,0,0
132900,009580,4400,2,50,1.15,190.55,51838,98776,46938,428,669,241,156084,4400,4400,4400,0,0,0,32314,32024,0,0
133000,009580,4400,2,50,1.15,190.74,51838,98876,47038,428,670,242,156184,4400,4400,4400,0,0,0,32314,32114,0,0
133000,009580,4400,2,50,1.15,190.74,51838,98878,47040,428,671,243,156186,4400,4400,4400,2,0,1,32214,32160,0,2
133100,009580,4400,2,50,1.15,191.13,51838,99079,47241,428,673,245,156387,4400,4400,4400,201,0,2,32211,32483,0,201
133200,009580,4400,2,50,1.15,191.71,51838,99381,47543,428,674,246,156689,4400,4400,4400,0,0,0,32061,32496,0,0
133200,009580,4395,2,45,1.03,191.81,51961,99667,47706,429,676,247,157098,4400,4400,4395,409,1,2,31473,33618,123,286
133300,009580,4395,2,45,1.03,191.81,51961,99667,47706,429,676,247,157098,4395,4395,4395,0,0,0,31473,33618,0,0
133300,009580,4395,2,45,1.03,191.81,51961,99667,47706,429,676,247,157098,4395,4395,4395,0,0,0,31473,33618,0,0
133400,009580,4405,2,55,1.26,199.89,51961,103867,51906,429,678,249,161298,4400,4405,4400,4200,0,2,32100,33632,0,4200
133500,009580,4410,2,60,1.38,200.41,51961,104134,52173,429,680,251,161565,4410,4410,4410,0,0,0,34135,29809,0,0
133500,009580,4410,2,60,1.38,200.63,51961,104248,52287,429,682,253,161679,4410,4410,4410,114,0,2,33783,29620,0,114
133600,009580,4410,2,60,1.38,200.63,51961,104248,52287,429,682,253,161679,4410,4410,4410,0,0,0,33783,29620,0,0
133700,009580,4410,2,60,1.38,200.63,51961,104248,52287,429,682,253,161679,4410,4410,4410,0,0,0,34446,29388,0,0
133700,009580,4410,2,60,1.38,200.63,51961,104249,52288,429,683,254,161680,4410,4410,4410,1,0,1,34446,29429,0,1
133800,009580,4410,2,60,1.38,200.63,51961,104249,52288,429,683,254,161680,4410,4410,4410,0,0,0,34446,29429,0,0
133900,009580,4410,2,60,1.38,200.63,51961,104251,52290,429,684,255,161682,4410,4410,4410,0,0,0,34563,29465,0,0
133900,009580,4410,2,60,1.38,200.63,51961,104251,52290,429,684,255,161682,4410,4410,4410,0,0,0,34561,29493,0,0
134000,009580,4410,2,60,1.38,200.64,51961,104253,52292,429,686,257,161684,4410,4410,4410,0,0,0,34561,28538,0,0
134000,009580,4410,2,60,1.38,200.64,51961,104253,52292,429,686,257,161684,4410,4410,4410,0,0,0,34561,28538,0,0
134100,009580,4400,2,50,1.15,200.08,52161,104365,52204,430,687,257,161996,4410,4410,4400,312,1,1,34447,27927,200,112
134200,009580,4400,2,50,1.15,199.45,52327,104365,52038,431,687,256,162162,4400,4400,4400,0,0,0,34467,28132,0,0
134200,009580,4400,2,50,1.15,199.45,52327,104365,52038,431,687,256,162162,4400,4400,4400,0,0,0,34467,28132,0,0
134300,009580,4410,2,60,1.38,199.07,52427,104367,51940,432,689,257,162264,4410,4410,4400,102,1,2,34466,29169,100,2
134400,009580,4410,2,60,1.38,199.08,52427,104372,51945,432,693,261,162269,4410,4410,4410,0,0,0,34513,29328,0,0
134400,009580,4410,2,60,1.38,199.08,52427,104373,51946,432,694,262,162270,4410,4410,4410,1,0,1,34512,29342,0,1
134500,009580,4405,2,55,1.26,199.74,52427,104718,52291,432,698,266,162615,4405,4405,4405,33,0,1,33265,29360,0,33
134500,009580,4410,2,60,1.38,199.74,52427,104719,52292,432,699,267,162616,4405,4410,4405,34,0,2,34209,26755,0,34
134600,009580,4410,2,60,1.38,199.74,52427,104719,52292,432,699,267,162616,4410,4410,4410,0,0,0,34209,26755,0,0
134700,009580,4410,2,60,1.38,199.74,52427,104720,52293,432,700,268,162617,4410,4410,4410,0,0,0,34453,26891,0,0
134700,009580,4405,2,55,1.26,199.39,52578,104835,52257,433,701,268,162883,4410,4410,4405,266,1,1,34337,26603,151,115
134800,009580,4405,2,55,1.26,199.28,52608,104835,52227,434,701,267,162913,4405,4405,4405,0,0,0,34397,26557,0,0
134800,009580,4410,2,60,1.38,199.44,52608,104921,52313,434,704,270,162999,4410,4410,4410,86,0,3,34533,26562,0,86
134900,009580,4410,2,60,1.38,199.44,52608,104921,52313,434,704,270,162999,4410,4410,4410,0,0,0,34533,26562,0,0
135000,009580,4410,2,60,1.38,199.44,52608,104921,52313,434,704,270,162999,4410,4410,4410,0,0,0,34331,26582,0,0
135000,009580,4410,2,60,1.38,199.44,52608,104921,52313,434,704,270,162999,4410,4410,4410,0,0,0,34471,26596,0,0
135100,009580,4405,2,55,1.26,198.88,52796,105000,52204,435,707,272,163266,4410,4410,4405,266,1,2,33875,28991,188,78
135200,009580,4405,2,55,1.26,198.88,52796,105000,52204,435,707,272,163266,4405,4405,4405,0,0,0,33875,28991,0,0
135200,009580,4405,2,55,1.26,198.88,52796,105000,52204,435,707,272,163266,4405,4405,4405,0,0,0,33526,29305,0,0
135300,009580,4405,2,55,1.26,199.76,52933,105739,52806,436,712,276,164142,4405,4405,4400,200,1,2,33465,29294,137,63
135300,009580,4405,2,55,1.26,199.76,52933,105739,52806,436,712,276,164142,4405,4405,4400,200,1,2,33465,29294,137,63
135400,009580,4405,2,55,1.26,199.92,52933,105826,52893,436,713,277,164229,4405,4405,4405,87,0,1,33464,29330,0,87
135500,009580,4410,2,60,1.38,199.93,52933,105827,52894,436,714,278,164230,4410,4410,4410,0,0,0,34344,27158,0,0
135500,009580,4410,2,60,1.38,200.87,52933,106328,53395,436,716,280,164731,4410,4410,4410,501,0,2,33843,27277,0,501
135600,009580,4410,2,60,1.38,200.87,52933,106328,53395,436,716,280,164731,4410,4410,4410,0,0,0,33843,27277,0,0
135700,009580,4410,2,60,1.38,200.87,52933,106328,53395,436,716,280,164731,4410,4410,4410,0,0,0,33842,27313,0,0
135700,009580,4410,2,60,1.38,200.87,52933,106329,53396,436,717,281,164732,4410,4410,4410,1,0,1,33922,27404,0,1
135800,009580,4410,2,60,1.38,200.87,52933,106329,53396,436,717,281,164732,4410,4410,4410,0,0,0,33922,27404,0,0
135800,009580,4410,2,60,1.38,201.82,52933,106830,53897,436,719,283,165233,4410,4410,4410,501,0,2,34046,28940,0,501
135900,009580,4410,2,60,1.38,201.87,52933,106856,53923,436,720,284,165259,4410,4410,4410,0,0,0,33546,29018,0,0
140000,009580,4410,2,60,1.38,201.47,53043,106864,53821,437,724,287,165377,4410,4410,4410,6,0,2,33517,29123,0,6
140000,009580,4405,2,55,1.26,201.29,53143,106969,53826,438,725,287,165582,4410,4410,4405,211,1,3,34218,28209,100,111
140100,009580,4410,2,60,1.38,202.7,53143,107719,54576,438,728,290,166332,4410,4410,4410,749,0,2,34216,28024,0,749
140200,009580,4415,2,65,1.49,203.6,53143,108198,55055,438,733,295,166811,4415,4415,4415,0,0,0,35660,28051,0,0
140200,009580,4415,2,65,1.49,203.7,53143,108254,55111,438,736,298,166867,4415,4415,4415,56,0,3,35788,28065,0,56
140300,009580,4415,2,65,1.49,203.72,53143,108264,55121,438,737,299,166877,4415,4415,4415,0,0,0,35787,28093,0,0
140300,009580,4415,2,65,1.49,203.72,53143,108264,55121,438,737,299,166877,4415,4415,4415,0,0,0,35787,28093,0,0
140400,009580,4415,2,65,1.49,203.72,53143,108265,55122,438,738,300,166878,4415,4415,4415,1,0,1,35777,28136,0,1
140500,009580,4405,2,55,1.26,203.08,53312,108265,54953,439,738,299,167047,4405,4405,4405,169,1,0,35776,28177,169,0
140500,009580,4415,2,65,1.49,203.08,53312,108266,54954,439,739,300,167048,4405,4415,4405,170,1,1,35776,28354,169,1
140600,009580,4415,2,65,1.49,203.08,53312,108267,54955,439,740,301,167049,4415,4415,4415,1,0,1,35975,28376,0,1
140700,009580,4415,2,65,1.49,203.18,53312,108317,55005,439,741,302,167099,4415,4415,4415,0,0,0,35974,28490,0,0
140700,009580,4415,2,65,1.49,203.18,53312,108317,55005,439,741,302,167099,4415,4415,4415,0,0,0,35974,28490,0,0
140800,009580,4415,2,65,1.49,203.18,53312,108317,55005,439,741,302,167099,4415,4415,4415,0,0,0,35924,28463,0,0
140900,009580,4415,2,65,1.49,203.18,53312,108318,55006,439,742,303,167100,4415,4415,4415,0,0,0,35905,28500,0,0
140900,009580,4415,2,65,1.49,205.62,53312,109619,56307,439,744,305,168401,4415,4415,4415,1301,0,2,35922,28515,0,1301
141000,009580,4415,2,65,1.49,205.62,53312,109619,56307,439,744,305,168401,4415,4415,4415,0,0,0,35922,28515,0,0
141000,009580,4415,2,65,1.49,205.69,53312,109655,56343,439,747,308,168437,4415,4415,4415,36,0,3,37722,28576,0,36
141100,009580,4415,2,65,1.49,205.2,53441,109661,56220,440,749,309,168572,4415,4415,4405,135,1,2,37716,28460,129,6
141200,009580,4415,2,65,1.49,205.2,53441,109661,56220,440,749,309,168572,4415,4415,4415,0,0,0,37716,28460,0,0
141200,009580,4415,2,65,1.49,205.16,53451,109662,56211,441,750,309,168583,4410,4415,4410,11,1,1,37715,25756,10,1
141300,009580,4415,2,65,1.49,205.17,53451,109663,56212,441,751,310,168584,4415,4415,4415,0,0,0,37714,25783,0,0
141400,009580,4415,2,65,1.49,205.17,53451,109663,56212,441,751,310,168584,4415,4415,4415,0,0,0,37713,25800,0,0
141400,009580,4415,2,65,1.49,205.17,53451,109663,56212,441,751,310,168584,4415,4415,4415,0,0,0,37713,25832,0,0
141500,009580,4410,2,60,1.38,204.62,53594,109663,56069,442,751,309,168727,4410,4410,4410,143,1,0,37723,25911,143,0
141600,009580,4410,2,60,1.38,204.59,53602,109663,56061,443,751,308,168735,4410,4410,4410,0,0,0,37723,25784,0,0
141600,009580,4415,2,65,1.49,203.91,53802,109709,55907,444,752,308,168981,4410,4415,4410,246,1,1,37523,25612,200,46
141700,009580,4415,2,65,1.49,203.91,53802,109709,55907,444,752,308,168981,4415,4415,4415,0,0,0,37523,25612,0,0
141700,009580,4415,2,65,1.49,203.91,53802,109710,55908,444,753,309,168982,4415,4415,4415,1,0,1,37385,25633,0,1
141800,009580,4415,2,65,1.49,203.91,53802,109710,55908,444,753,309,168982,4415,4415,4415,0,0,0,37385,25633,0,0
141900,009580,4415,2,65,1.49,205.55,53802,110590,56788,444,756,312,169862,4415,4415,4415,0,0,0,36717,26223,0,0
141900,009580,4415,2,65,1.49,205.55,53802,110591,56789,444,757,313,169863,4415,4415,4415,1,0,1,36650,26070,0,1
142000,009580,4410,2,60,1.38,205.51,53812,110591,56779,445,757,312,169873,4410,4410,4410,10,1,0,36768,26114,10,0
142000,009580,4410,2,60,1.38,205.51,53812,110591,56779,445,757,312,169873,4410,4410,4410,10,1,0,36768,26114,10,0
142100,009580,4415,2,65,1.49,205.14,53912,110593,56681,446,759,313,169975,4415,4415,4410,102,1,2,36617,26340,100,2
142200,009580,4415,2,65,1.49,205.15,53912,110599,56687,446,762,316,169981,4415,4415,4415,4,0,1,36614,31049,0,4
142200,009580,4415,2,65,1.49,205.15,53912,110599,56687,446,762,316,169981,4415,4415,4415,4,0,1,36614,31049,0,4
142300,009580,4415,2,65,1.49,205.15,53912,110599,56687,446,762,316,169981,4415,4415,4415,0,0,0,36614,31049,0,0
142400,009580,4415,2,65,1.49,205.15,53912,110600,56688,446,763,317,169982,4415,4415,4415,0,0,0,36770,26588,0,0
142400,009580,4415,2,65,1.49,205.53,53912,110805,56893,446,765,319,170187,4415,4415,4415,205,0,2,36814,34386,0,205
142500,009580,4415,2,65,1.49,205.9,53912,111005,57093,446,766,320,170387,4415,4415,4415,200,0,1,36614,34386,0,200
142500,009580,4410,2,60,1.38,205.32,54064,111005,56941,447,766,319,170539,4415,4415,4410,352,1,1,36414,34222,152,200
142600,009580,4415,2,65,1.49,205.35,54064,111022,56958,447,768,321,170556,4415,4415,4415,17,0,2,36569,33838,0,17
142700,009580,4415,2,65,1.49,205.35,54064,111022,56958,447,768,321,170556,4415,4415,4415,0,0,0,36569,33838,0,0
142700,009580,4415,2,65,1.49,205.4,54064,111046,56982,447,769,322,170580,4415,4415,4415,24,0,1,36556,33886,0,24
142800,009580,4415,2,65,1.49,205.41,54064,111052,56988,447,771,324,170586,4415,4415,4415,6,0,2,36531,33852,0,6
142900,009580,4410,2,60,1.38,204.88,54204,111052,56848,448,771,323,170726,4410,4410,4410,0,0,0,36526,33852,0,0
142900,009580,4410,2,60,1.38,204.45,54318,111052,56734,449,771,322,170840,4410,4410,4410,114,1,0,36526,35022,114,0
143000,009580,4410,2,60,1.38,203.78,54497,111052,56555,451,771,320,171019,4410,4410,4410,139,1,0,36588,34904,139,0
143100,009580,4410,2,60,1.38,203.67,54528,111057,56529,452,772,320,171055,4410,4410,4410,0,0,0,36583,34745,0,0
143100,009580,4410,2,60,1.38,203.67,54528,111057,56529,452,772,320,171055,4410,4410,4410,0,0,0,36583,34745,0,0
143200,009580,4415,2,65,1.49,203.68,54528,111065,56537,452,773,321,171063,4415,4415,4415,0,0,0,36583,34783,0,0
143200,009580,4415,2,65,1.49,203.7,54528,111071,56543,452,776,324,171069,4415,4415,4415,6,0,3,36571,34940,0,6
143300,009580,4415,2,65,1.49,204.25,54528,111371,56843,452,777,325,171369,4415,4415,4415,300,0,1,36569,35972,0,300
143400,009580,4410,2,60,1.38,203.66,54686,111371,56685,453,777,324,171527,4410,4410,4410,0,0,0,36285,35986,0,0
143400,009580,4415,2,65,1.49,203.06,54849,111377,56528,454,779,325,171696,4415,4415,4410,169,1,2,36284,36394,163,6
143500,009580,4415,2,65,1.49,203.06,54849,111378,56529,454,780,326,171697,4415,4415,4415,0,0,0,36279,36394,0,0
143500,009580,4415,2,65,1.49,203.06,54849,111378,56529,454,780,326,171697,4415,4415,4415,0,0,0,36279,36394,0,0
143600,009580,4410,2,60,1.38,202.69,54949,111378,56429,455,780,325,171797,4410,4410,4410,100,1,0,36278,36682,100,0
143700,009580,4415,2,65,1.49,202.73,54949,111398,56449,455,783,328,171817,4415,4415,4415,16,0,2,36759,36718,0,16
143700,009580,4415,2,65,1.49,202.73,54949,111399,56450,455,784,329,171818,4415,4415,4415,17,0,3,36778,36718,0,17
143800,009580,4415,2,65,1.49,202.73,54949,111399,56450,455,784,329,171818,4415,4415,4415,0,0,0,36777,36755,0,0
143900,009580,4410,2,60,1.38,202.27,55078,111404,56326,456,785,329,171952,4410,4410,4410,129,1,0,36772,36791,129,0
143900,009580,4410,2,60,1.38,202.27,55078,111404,56326,456,785,329,171952,4410,4410,4410,129,1,0,36772,36791,129,0
144000,009580,4410,2,60,1.38,202.27,55078,111404,56326,456,785,329,171952,4410,4410,4410,0,0,0,36772,36791,0,0
144000,009580,4415,2,65,1.49,202.27,55078,111409,56331,456,786,330,171957,4415,4415,4415,5,0,1,36808,37213,0,5
144100,009580,4410,2,60,1.38,201.63,55254,111409,56155,457,786,329,172133,4410,4410,4410,176,1,0,36803,37253,176,0
144200,009580,4410,2,60,1.38,200.98,55433,111409,55976,459,786,327,172312,4410,4410,4410,113,1,0,36751,37063,113,0
144200,009580,4410,2,60,1.38,200.98,55433,111409,55976,459,786,327,172312,4410,4410,4410,113,1,0,36751,37063,113,0
144300,009580,4410,2,60,1.38,200.69,55513,111409,55896,460,786,326,172392,4410,4410,4410,80,1,0,37151,37010,80,0
144400,009580,4410,2,60,1.38,200.69,55513,111409,55896,460,786,326,172392,4410,4410,4410,0,0,0,37151,37010,0,0
144400,009580,4410,2,60,1.38,198.9,56013,111409,55396,461,786,325,172892,4410,4410,4410,500,1,0,37151,36945,500,0
144500,009580,4410,2,60,1.38,198.33,56173,111409,55236,464,786,322,173052,4410,4410,4410,159,2,0,36651,36647,159,0
144500,009580,4415,2,65,1.49,198.34,56173,111412,55239,464,789,325,173055,4410,4415,4410,162,2,3,36648,36717,159,3
144600,009580,4415,2,65,1.49,198.34,56173,111414,55241,464,791,327,173057,4415,4415,4415,0,0,0,36648,36717,0,0
144700,009580,4415,2,65,1.49,198.34,56173,111414,55241,464,791,327,173057,4415,4415,4415,0,0,0,36646,36716,0,0
144700,009580,4410,2,60,1.38,192.51,57873,111414,53541,465,791,326,174757,4410,4410,4410,1700,1,0,36646,36753,1700,0
144800,009580,4420,2,70,1.61,218.24,57923,126414,68491,466,793,327,189807,4410,4420,4410,15050,1,2,36646,35491,50,15000
144900,009580,4415,2,65,1.49,218.21,57933,126414,68481,467,793,326,189817,4415,4415,4415,10,1,0,22353,33141,10,0
144900,009580,4415,2,65,1.49,218.02,57983,126414,68431,472,793,321,189867,4415,4415,4415,60,6,0,22343,33145,60,0
145000,009580,4420,2,70,1.61,217.95,58003,126415,68412,473,794,321,189888,4420,4420,4420,1,0,1,22293,34084,0,1
145000,009580,4420,2,70,1.61,217.95,58003,126416,68413,473,795,322,189889,4420,4420,4420,2,0,2,22482,34121,0,2
145100,009580,4420,2,70,1.61,217.95,58003,126416,68413,473,795,322,189889,4420,4420,4420,0,0,0,22481,34127,0,0
145200,009580,4420,2,70,1.61,217.95,58003,126416,68413,473,795,322,189889,4420,4420,4420,0,0,0,22608,34161,0,0
145200,009580,4420,2,70,1.61,217.95,58003,126417,68414,473,796,323,189890,4420,4420,4420,1,0,1,22767,34629,0,1
145300,009580,4415,2,65,1.49,215.16,58755,126417,67662,474,796,322,190642,4415,4415,4415,752,1,0,22770,34629,752,0
145400,009580,4420,2,70,1.61,215.2,58755,126438,67683,474,797,323,190663,4420,4420,4420,0,0,0,22770,33900,0,0
145400,009580,4420,2,70,1.61,215.2,58755,126440,67685,474,799,325,190665,4420,4420,4420,2,0,2,22981,34010,0,2
145500,009580,4420,2,70,1.61,215.2,58755,126440,67685,474,799,325,190665,4420,4420,4420,0,0,0,22981,34010,0,0
145600,009580,4420,2,70,1.61,215.2,58755,126440,67685,474,799,325,190665,4420,4420,4420,0,0,0,22979,34009,0,0
145600,009580,4420,2,70,1.61,215.2,58755,126440,67685,474,799,325,190665,4420,4420,4420,0,0,0,22979,34454,0,0
145700,009580,4415,2,65,1.49,214.71,58891,126442,67551,475,801,326,190803,4415,4415,4415,136,1,0,23010,34489,136,0
145700,009580,4420,2,70,1.61,214.71,58891,126443,67552,475,802,327,190804,4415,4420,4415,137,1,1,23020,34365,136,1
145800,009580,4415,2,65,1.49,214.22,59026,126443,67417,477,802,325,190939,4415,4415,4415,135,2,0,23079,34285,135,0
145900,009580,4415,2,65,1.49,214.22,59026,126443,67417,477,802,325,190939,4415,4415,4415,0,0,0,23079,34285,0,0
145900,009580,4415,2,65,1.49,214.22,59026,126443,67417,477,802,325,190939,4415,4415,4415,0,0,0,23079,34553,0,0
150000,009580,4415,2,65,1.49,213.73,59159,126443,67284,479,802,323,191072,4415,4415,4415,126,1,0,23079,34583,126,0
150100,009580,4415,2,65,1.49,212.4,59545,126472,66927,480,805,325,191487,4415,4415,4415,0,0,0,22513,36709,0,0
150100,009580,4415,2,65,1.49,212.94,59545,126796,67251,480,807,327,191811,4415,4415,4415,324,0,2,23138,36740,0,324
150200,009580,4415,2,65,1.49,213.0,59545,126831,67286,480,808,328,191846,4415,4415,4415,35,0,1,22989,36690,0,35
150200,009580,4415,2,65,1.49,213.67,59545,127231,67686,480,809,329,192246,4415,4415,4415,435,0,2,23394,36557,0,435
150300,009580,4410,2,60,1.38,213.29,59652,127232,67580,481,810,329,192354,4410,4410,4410,107,1,0,24092,36570,107,0
150400,009580,4420,2,70,1.61,213.29,59652,127233,67581,481,811,330,192355,4420,4420,4420,0,0,0,24172,36577,0,0
150400,009580,4410,2,60,1.38,211.52,60217,127368,67151,482,812,330,193055,4410,4410,4410,700,1,1,24447,38843,565,135
150500,009580,4420,2,70,1.61,219.82,60217,132368,72151,482,814,332,198055,4415,4420,4415,5000,0,2,27420,39094,0,5000
150500,009580,4420,2,70,1.61,218.55,60567,132369,71802,483,815,332,198406,4415,4420,4410,5351,1,3,23009,35780,350,5001
150600,009580,4410,2,60,1.38,218.2,60667,132373,71706,484,816,332,198510,4420,4420,4410,104,1,1,24197,36034,100,4
150700,009580,4410,2,60,1.38,218.2,60667,132373,71706,484,816,332,198510,4410,4410,4410,0,0,0,24197,36034,0,0
150700,009580,4415,2,65,1.49,213.07,62167,132457,70290,486,819,333,200094,4415,4415,4405,1584,2,3,23667,34982,1500,84
150800,009580,4415,2,65,1.49,213.07,62167,132458,70291,486,820,334,200095,4415,4415,4415,0,0,0,23650,36870,0,0
150900,009580,4415,2,65,1.49,213.07,62167,132458,70291,486,820,334,200095,4415,4415,4415,0,0,0,23799,36904,0,0
150900,009580,4410,2,60,1.38,212.95,62222,132503,70281,487,821,334,200195,4410,4410,4410,100,1,1,21514,36728,55,45
151000,009580,4410,2,60,1.38,212.95,62222,132504,70282,487,822,335,200196,4410,4410,4410,1,0,1,22287,36769,0,1
151000,009580,4410,2,60,1.38,213.33,62222,132740,70518,487,823,336,200432,4410,4410,4410,237,0,2,22403,36805,0,237
151100,009580,4410,2,60,1.38,213.33,62222,132740,70518,487,823,336,200432,4410,4410,4410,0,0,0,22403,36805,0,0
151200,009580,4405,2,55,1.26,212.43,62486,132740,70254,489,823,334,200696,4405,4405,4405,117,1,0,22050,36898,117,0
151200,009580,4405,2,55,1.26,207.83,64148,133321,69173,490,826,336,202939,4405,4410,4405,2360,2,3,24089,38883,1779,581
151300,009580,4405,2,55,1.26,207.83,64148,133321,69173,490,826,336,202939,4405,4405,4405,0,0,0,24089,37337,0,0
151400,009580,4415,2,65,1.49,207.84,64148,133322,69174,490,827,337,202940,4415,4415,4415,0,0,0,24146,37337,0,0
151400,009580,4415,2,65,1.49,207.85,64148,133330,69182,490,829,339,202948,4415,4415,4415,8,0,2,24124,37512,0,8
151500,009580,4415,2,65,1.49,208.08,64148,133481,69333,490,831,341,203099,4410,4415,4410,151,0,2,23973,37552,0,151
151600,009580,4410,2,60,1.38,207.58,64308,133489,69181,491,833,342,203267,4410,4410,4410,160,1,0,24514,34455,160,0
151600,009580,4410,2,60,1.38,207.58,64325,133526,69201,492,837,345,203321,4410,4415,4410,214,2,4,21768,37479,177,37
151700,009580,4415,2,65,1.49,207.58,64325,133527,69202,492,838,346,203322,4415,4415,4415,1,0,1,24365,34505,0,1
151800,009580,4410,2,60,1.38,207.02,64499,133528,69029,494,839,345,203497,4410,4410,4410,0,0,0,24306,34533,0,0
151800,009580,4410,2,60,1.38,210.91,64502,136040,71538,495,845,350,206012,4415,4420,4410,2515,1,6,22320,34430,3,2512
151900,009580,4425,2,75,1.72,211.13,64502,136182,71680,495,850,355,206154,4425,4425,4425,2,0,2,24580,34130,0,2
151900,009580,4425,2,75,1.72,211.62,64502,136497,71995,495,858,363,206469,4425,4425,4425,317,0,10,24380,34128,0,317
152000,009580,4425,2,75,1.72,211.87,64502,136659,72157,495,868,373,206631,4425,4425,4425,159,0,9,24445,34057,0,159
152000,009580,4425,2,75,1.72,211.48,64640,136700,72060,496,873,377,206810,4425,4425,4410,338,1,14,25262,33925,138,200
152000,009580,4425,2,75,1.72,211.48,64640,136700,72060,496,873,377,206810,4425,4425,4410,338,1,14,25262,33925,138,200
152000,009580,4425,2,75,1.72,211.48,64640,136700,72060,496,873,377,206810,4425,4425,4410,338,1,14,25262,33925,138,200
152000,009580,4425,2,75,1.72,211.48,64640,136700,72060,496,873,377,206810,4425,4425,4410,338,1,14,25262,33925,138,200
152000,009580,4425,2,75,1.72,211.48,64640,136700,72060,496,873,377,206810,4425,4425,4410,338,1,14,25262,33925,138,200
152000,009580,4425,2,75,1.72,211.48,64640,136700,72060,496,873,377,206810,4425,4425,4410,338,1,14,25262,33925,138,200
152000,009580,4425,2,75,1.72,211.48,64640,136700,72060,496,873,377,206810,4425,4425,4410,338,1,14,25262,33925,138,200
152000,009580,4425,2,75,1.72,211.48,64640,136700,72060,496,873,377,206810,4425,4425,4410,338,1,14,25262,33925,138,200
152000,009580,4425,2,75,1.72,211.48,64640,136700,72060,496,873,377,206810,4425,4425,4410,338,1,14,25262,33925,138,200
152000,009580,4425,2,75,1.72,211.48,64640,136700,72060,496,873,377,206810,4425,4425,4410,338,1,14,25262,33925,138,200
152000,009580,4425,2,75,1.72,211.48,64640,136700,72060,496,873,377,206810,4425,4425,4410,338,1,14,25262,33925,138,200
152000,009580,4425,2,75,1.72,211.48,64640,136700,72060,496,873,377,206810,4425,4425,4410,338,1,14,25262,33925,138,200
152000,009580,4425,2,75,1.72,211.48,64640,136700,72060,496,873,377,206810,4425,4425,4410,338,1,14,25262,33925,138,200
152000,009580,4425,2,75,1.72,211.48,64640,136700,72060,496,873,377,206810,4425,4425,4410,338,1,14,25262,33925,138,200
152000,009580,4425,2,75,1.72,211.48,64640,136700,72060,496,873,377,206810,4425,4425,4410,338,1,14,25262,33925,138,200
152000,009580,4425,2,75,1.72,211.48,64640,136700,72060,496,873,377,206810,4425,4425,4410,338,1,14,25262,33925,138,200
152000,009580,4425,2,75,1.72,211.48,64640,136700,72060,496,873,377,206810,4425,4425,4410,338,1,14,25262,33925,138,200
153000,009580,4405,2,55,1.26,211.48,64640,136700,72060,496,873,377,212474,4405,4405,4405,5664,0,0,25261,33921,0,0
153000,009580,4405,2,55,1.26,211.48,64640,136700,72060,496,873,377,212474,4405,4405,4405,5664,0,0,25261,33921,0,0
153000,009580,4405,2,55,1.26,211.48,64640,136700,72060,496,873,377,212474,4405,4405,4405,5664,0,0,25261,33921,0,0
