090200,020000,31400,5,50,-0.16,1036.61,112,1161,1049,9,29,20,2015,31350,31400,31300,112,3,8,1349,4007,9,103
090200,020000,31400,5,50,-0.16,279.32,793,2215,1422,19,50,31,3750,31350,31750,31300,1847,13,29,844,2987,690,1157
090300,020000,31550,2,100,0.32,269.36,829,2233,1404,22,51,29,3804,31400,31550,31400,29,2,1,638,3241,11,18
090400,020000,31300,5,150,-0.48,207.13,1108,2295,1187,37,62,25,4145,31350,31350,31300,16,3,0,535,3450,16,0
090400,020000,31400,5,50,-0.16,212.61,1142,2428,1286,41,71,30,4312,31350,31400,31300,183,7,9,658,3569,50,133
090500,020000,31350,5,100,-0.32,208.48,1203,2508,1305,48,82,34,4453,31350,31400,31350,88,2,7,677,3459,27,61
090600,020000,31300,5,150,-0.48,162.12,1555,2521,966,52,83,31,4818,31300,31300,31300,0,0,0,650,5131,0,0
090600,020000,31300,5,150,-0.48,153.94,1663,2560,897,54,88,34,4965,31300,31300,31250,147,2,5,633,5146,108,39
090700,020000,31250,5,200,-0.64,144.15,1796,2589,793,61,89,28,5127,31250,31300,31250,157,4,1,932,5227,128,29
090800,020000,31300,5,150,-0.48,142.41,1837,2616,779,66,90,24,5195,31250,31300,31250,34,3,1,1124,5284,7,27
090800,020000,31250,5,200,-0.64,140.27,1865,2616,751,71,90,19,5223,31250,31300,31250,62,8,1,1147,5350,35,27
090900,020000,31200,5,250,-0.79,113.54,2304,2616,312,81,90,9,5662,31250,31250,31200,439,10,0,1211,5042,439,0
091000,020000,31200,5,250,-0.79,110.37,2382,2629,247,89,91,2,5753,31200,31250,31200,24,2,1,1247,5311,11,13
091000,020000,31150,5,300,-0.95,89.87,2931,2634,-297,100,92,-8,6307,31200,31250,31150,578,13,2,1455,5124,560,18
091100,020000,31150,5,300,-0.95,89.09,2979,2654,-325,104,96,-8,6375,31200,31200,31150,44,2,3,1478,5690,26,18
091200,020000,31100,5,350,-1.11,83.38,3303,2754,-549,112,97,-15,6799,31100,31100,31100,0,0,0,1107,5774,0,0
091200,020000,31200,5,250,-0.79,95.2,3374,3212,-162,116,108,-8,7328,31150,31200,31100,529,4,11,742,5670,71,458
091300,020000,31300,5,150,-0.48,106.4,3388,3605,217,119,118,-1,7736,31250,31300,31250,191,3,3,615,5733,14,177
091300,020000,31350,5,100,-0.32,111.87,3588,4014,426,126,128,2,8345,31250,31650,31250,800,10,13,2406,5643,214,586
091400,020000,31400,5,50,-0.16,112.2,3630,4073,443,131,136,5,8446,31550,31550,31350,101,5,8,613,5637,42,59
091500,020000,31350,5,100,-0.32,108.64,3786,4113,327,138,140,2,8642,31450,31450,31350,165,5,2,653,5946,145,20
091600,020000,31300,5,150,-0.48,107.92,3811,4113,302,141,140,-1,8667,31300,31300,31300,24,2,0,685,5848,24,0
091700,020000,31350,5,100,-0.32,109.63,3895,4270,375,148,142,-6,8908,31350,31350,31350,0,0,0,723,6108,0,0
091700,020000,31450,3,0,0.0,121.98,3922,4784,862,153,153,0,9449,31350,31800,31350,541,5,11,2311,5512,27,514
091800,020000,31450,3,0,0.0,115.72,4180,4837,657,161,155,-6,9760,31450,31650,31450,311,8,2,2065,5665,258,53
091900,020000,31500,2,50,0.16,116.53,4192,4885,693,164,156,-8,9820,31450,31500,31450,60,3,1,2028,4009,12,48
092000,020000,31450,3,0,0.0,117.15,4327,5069,742,175,166,-9,10139,31450,31450,31450,0,0,0,2114,5924,0,0
092000,020000,31400,5,50,-0.16,104.95,4833,5072,239,184,167,-17,10648,31450,31450,31400,509,9,1,2191,6065,506,3
092100,020000,31350,5,100,-0.32,103.05,4922,5072,150,188,167,-21,10737,31350,31350,31350,2,1,0,863,5866,2,0
092200,020000,31350,5,100,-0.32,100.83,5030,5072,42,201,167,-34,10845,31350,31350,31350,0,0,0,870,5852,0,0
092200,020000,31300,5,150,-0.48,100.6,5042,5072,30,204,167,-37,10857,31300,31300,31300,12,3,0,950,6128,12,0
092300,020000,31500,2,50,0.16,104.53,5077,5307,230,209,177,-32,11127,31550,31550,31500,8,0,2,703,5814,0,8
092300,020000,31400,5,50,-0.16,103.11,5147,5307,160,214,177,-37,11197,31550,31550,31400,78,5,2,783,6082,70,8
092400,020000,31400,5,50,-0.16,102.47,5183,5311,128,220,178,-42,11237,31500,31500,31400,36,6,0,1986,6220,36,0
092500,020000,31400,5,50,-0.16,102.8,5208,5354,146,223,179,-44,11305,31550,31550,31400,53,1,1,2073,6205,10,43
092500,020000,31450,3,0,0.0,97.83,5477,5358,-119,233,180,-53,11578,31550,31550,31400,326,11,2,910,5952,279,47
092600,020000,31450,3,0,0.0,97.7,5513,5386,-127,237,181,-56,11642,31450,31450,31450,24,2,0,1239,5935,24,0
092700,020000,31450,3,0,0.0,94.74,5685,5386,-299,244,181,-63,11814,31450,31450,31450,1,1,0,1486,6021,1,0
092800,020000,31400,5,50,-0.16,84.5,6380,5391,-989,263,182,-81,12514,31400,31400,31400,0,0,0,1412,5935,0,0
092800,020000,31400,5,50,-0.16,83.67,6455,5401,-1054,269,184,-85,12599,31400,31450,31400,85,6,2,1477,6338,75,10
092900,020000,31400,5,50,-0.16,82.9,6516,5402,-1114,276,185,-91,12661,31400,31400,31400,36,4,0,1500,6402,36,0
093000,020000,31400,5,50,-0.16,82.39,6571,5414,-1157,285,186,-99,12728,31400,31400,31400,0,0,0,1475,6444,0,0
093000,020000,31400,5,50,-0.16,82.11,6623,5438,-1185,290,187,-103,12804,31400,31450,31400,76,5,1,1488,7100,52,24
093100,020000,31450,3,0,0.0,84.87,6743,5723,-1020,299,195,-104,13209,31450,31450,31450,381,5,6,1448,6827,101,280
093100,020000,31500,2,50,0.16,91.85,6746,6196,-550,302,201,-101,13685,31450,31500,31450,857,8,12,1362,6857,104,753
093200,020000,31500,2,50,0.16,92.77,6821,6328,-493,310,206,-104,13892,31500,31550,31500,97,7,4,2476,4765,65,32
093300,020000,31700,2,250,0.79,93.21,7029,6552,-477,327,215,-112,14324,31600,31700,31550,350,16,7,3344,1820,207,143
093400,020000,31700,2,250,0.79,91.12,7445,6784,-661,339,218,-121,14972,31650,31700,31650,22,2,0,3352,2658,22,0
093400,020000,31650,2,200,0.64,84.86,8063,6842,-1221,349,220,-129,15648,31650,31700,31650,698,12,2,3362,3467,640,58
093500,020000,31700,2,250,0.79,85.86,8119,6971,-1148,356,224,-132,15833,31650,31700,31650,152,7,2,3386,3517,56,96
093600,020000,31750,2,300,0.95,85.92,8156,7008,-1148,362,229,-133,15907,31750,31750,31750,1,0,1,3416,3512,0,1
093600,020000,31750,2,300,0.95,88.55,8186,7249,-937,367,232,-135,16178,31750,31750,31700,272,5,4,3676,3473,30,242
093700,020000,31700,2,250,0.79,81.42,8933,7273,-1660,377,234,-143,16949,31750,31750,31700,769,9,1,3751,2171,746,23
093700,020000,31700,2,250,0.79,83.45,8936,7457,-1479,379,240,-139,17136,31750,31800,31700,956,11,7,3262,10985,749,207
093800,020000,31750,2,300,0.95,83.57,8953,7482,-1471,386,243,-143,17178,31800,31800,31700,40,5,3,3304,2939,15,25
093900,020000,31750,2,300,0.95,83.19,9008,7494,-1514,389,245,-144,17245,31750,31750,31750,12,0,2,3050,2942,0,12
093900,020000,31700,2,250,0.79,73.24,10233,7495,-2738,412,246,-166,18471,31750,31750,31700,1238,23,3,3062,2188,1225,13
094000,020000,31700,2,250,0.79,72.88,10290,7499,-2791,415,247,-168,18532,31750,31750,31700,15,2,1,3105,2472,11,4
094100,020000,31700,2,250,0.79,72.79,10303,7500,-2803,418,248,-170,18546,31700,31700,31700,10,1,0,3140,2486,10,0
094100,020000,31750,2,300,0.95,72.8,10321,7514,-2807,419,250,-169,18578,31700,31750,31700,42,2,2,3241,2594,28,14
094200,020000,31700,2,250,0.79,68.56,10960,7514,-3446,431,250,-181,19217,31700,31700,31700,626,9,0,3566,2214,626,0
094200,020000,31500,2,50,0.16,65.81,11417,7514,-3903,459,250,-209,19674,31700,31700,31500,1083,37,0,3028,4054,1083,0
094300,020000,31550,2,100,0.32,65.53,11468,7515,-3953,468,251,-217,19726,31500,31550,31500,52,9,1,2964,4160,51,1
094400,020000,31500,2,50,0.16,67.2,11481,7715,-3766,471,252,-219,19939,31500,31500,31500,10,1,0,2814,4190,10,0
094400,020000,31550,2,100,0.32,67.19,11504,7730,-3774,474,254,-220,19977,31500,31550,31500,48,4,2,2744,4208,33,15
094500,020000,31550,2,100,0.32,66.56,11625,7738,-3887,481,256,-225,20106,31500,31550,31500,52,3,1,2790,4195,48,4
094500,020000,31500,2,50,0.16,66.5,11636,7738,-3898,483,256,-227,20117,31500,31550,31500,63,5,1,2960,4231,59,4
094600,020000,31550,2,100,0.32,66.36,11663,7739,-3924,488,257,-231,20145,31500,31550,31500,28,5,1,3099,4301,27,1
094700,020000,31500,2,50,0.16,70.29,11671,8203,-3468,492,258,-234,20617,31500,31500,31500,0,0,0,2679,4416,0,0
094700,020000,31500,2,50,0.16,71.22,11696,8330,-3366,495,265,-230,20769,31500,31550,31500,152,3,7,2739,4366,25,127
094800,020000,31600,2,150,0.48,71.94,11709,8424,-3285,499,268,-231,20876,31550,31600,31500,16,2,2,3102,4383,2,14
094800,020000,31550,2,100,0.32,72.12,11742,8468,-3274,505,271,-234,20953,31550,31600,31500,93,8,5,3203,4125,35,58
094900,020000,31500,2,50,0.16,72.21,11857,8562,-3295,511,272,-239,21162,31550,31550,31500,208,5,1,3019,4420,114,94
094900,020000,31550,2,100,0.32,72.22,11879,8579,-3300,512,275,-237,21201,31550,31550,31500,247,6,4,3042,4391,136,111
095000,020000,31500,2,50,0.16,73.07,11896,8692,-3204,519,277,-242,21331,31550,31550,31500,130,7,2,2765,4504,17,113
095100,020000,31500,2,50,0.16,70.86,12266,8692,-3574,521,277,-244,21701,31500,31500,31500,360,1,0,2771,4393,360,0
095100,020000,31550,2,100,0.32,70.7,12301,8697,-3604,524,279,-245,21741,31500,31550,31500,400,4,2,2917,4079,395,5
095200,020000,31500,2,50,0.16,69.4,12534,8698,-3836,529,280,-249,21975,31500,31500,31450,94,2,1,2832,6612,93,1
095200,020000,31450,3,0,0.0,69.25,12560,8698,-3862,533,280,-253,22001,31500,31500,31450,120,6,1,2926,6606,119,1
095300,020000,31450,3,0,0.0,69.02,12622,8712,-3910,537,282,-255,22077,31450,31500,31450,76,4,2,2953,6581,62,14
095400,020000,31500,2,50,0.16,67.5,12917,8719,-4198,541,284,-257,22379,31500,31500,31500,7,0,2,2841,6424,0,7
095400,020000,31450,3,0,0.0,68.47,12948,8865,-4083,544,291,-253,22556,31500,31500,31450,184,3,9,2670,6405,31,153
095500,020000,31500,2,50,0.16,68.26,12990,8867,-4123,546,292,-254,22600,31450,31500,31450,27,1,1,2768,6502,25,2
095500,020000,31450,3,0,0.0,68.19,13004,8868,-4136,549,293,-256,22615,31450,31500,31450,42,4,2,2804,6607,39,3
095600,020000,31450,3,0,0.0,68.03,13055,8881,-4174,553,295,-258,22679,31500,31500,31450,44,3,2,2820,6669,31,13
095700,020000,31450,3,0,0.0,67.81,13096,8881,-4215,559,295,-264,22720,31450,31450,31450,0,0,0,2870,7120,0,0
095700,020000,31500,2,50,0.16,67.91,13177,8949,-4228,563,296,-267,22869,31450,31500,31450,149,4,1,1621,6782,81,68
095800,020000,31500,2,50,0.16,67.92,13178,8951,-4227,564,298,-266,22872,31500,31500,31500,1,0,1,1714,6782,0,1
095900,020000,31500,2,50,0.16,68.09,13198,8987,-4211,568,303,-265,22928,31500,31500,31500,0,0,0,1664,6290,0,0
095900,020000,31550,2,100,0.32,70.34,13213,9294,-3919,571,307,-264,23250,31500,31550,31450,322,3,4,2768,3976,15,307
100000,020000,31500,2,50,0.16,70.16,13247,9294,-3953,574,307,-267,23284,31500,31500,31500,1,1,0,2713,4091,1,0
100000,020000,31500,2,50,0.16,69.86,13306,9295,-4011,584,308,-276,23344,31500,31550,31500,61,11,1,2884,4054,60,1
100100,020000,31450,3,0,0.0,69.42,13396,9299,-4097,594,310,-284,23438,31450,31550,31450,88,7,2,2955,6434,84,4
100200,020000,31500,2,50,0.16,70.27,13399,9415,-3984,596,313,-283,23557,31500,31500,31500,16,0,2,1894,6404,0,16
100200,020000,31450,3,0,0.0,70.14,13446,9431,-4015,601,316,-285,23620,31500,31500,31450,79,5,5,1894,6439,47,32
100300,020000,31450,3,0,0.0,69.91,13502,9439,-4063,607,317,-290,23684,31500,31500,31450,52,3,1,1750,6510,44,8
100400,020000,31450,3,0,0.0,70.14,13531,9491,-4040,613,322,-291,23765,31450,31450,31450,0,0,0,1698,6477,0,0
100400,020000,31450,3,0,0.0,69.61,13636,9492,-4144,623,323,-300,23871,31450,31500,31450,106,10,1,1720,6311,105,1
100500,020000,31350,5,100,-0.32,66.97,14196,9507,-4689,636,325,-311,24446,31400,31400,31350,269,5,0,1527,6402,269,0
100500,020000,31300,5,150,-0.48,65.59,14497,9508,-4989,652,326,-326,24748,31400,31400,31300,571,21,1,1550,6495,570,1
100600,020000,31250,5,200,-0.64,64.94,14674,9530,-5144,671,328,-343,24947,31300,31300,31250,149,17,2,1391,6406,127,22
100700,020000,31200,5,250,-0.79,63.93,14967,9569,-5398,683,331,-352,25279,31150,31200,31150,24,3,2,1076,6636,4,20
100700,020000,31150,5,300,-0.95,64.1,14978,9601,-5377,685,333,-352,25322,31150,31200,31150,67,5,4,926,6604,15,52
100800,020000,31150,5,300,-0.95,64.47,15028,9689,-5339,690,337,-353,25460,31200,31200,31150,14,1,1,1053,6611,10,4
100800,020000,31150,5,300,-0.95,64.32,15064,9689,-5375,694,337,-357,25496,31200,31200,31150,50,5,1,1062,6576,46,4
100900,020000,31150,5,300,-0.95,63.24,15480,9789,-5691,701,343,-358,26012,31150,31200,31150,414,4,4,1018,6272,388,26
101000,020000,31150,5,300,-0.95,63.11,15512,9790,-5722,705,344,-361,26045,31150,31150,31150,0,0,0,1089,6704,0,0
101000,020000,31150,5,300,-0.95,63.82,15593,9952,-5641,713,346,-367,26288,31150,31250,31150,243,8,2,1424,6560,81,162
101100,020000,31200,5,250,-0.79,67.24,15605,10493,-5112,716,350,-366,26841,31200,31200,31200,30,0,1,1031,6699,0,30
101100,020000,31200,5,250,-0.79,67.92,15618,10608,-5010,720,355,-365,26969,31200,31200,31150,158,4,6,999,7499,13,145
101200,020000,31200,5,250,-0.79,69.61,15668,10906,-4762,728,358,-370,27317,31200,31200,31200,33,4,0,875,7420,33,0
101200,020000,31250,5,200,-0.64,69.69,15680,10927,-4753,731,361,-370,27350,31200,31250,31200,66,7,3,961,7395,45,21
101300,020000,31200,5,250,-0.79,69.65,15703,10937,-4766,734,362,-372,27383,31250,31250,31200,33,3,1,952,7385,23,10
101400,020000,31200,5,250,-0.79,70.66,15741,11122,-4619,739,366,-373,27606,31200,31200,31200,2,1,0,812,6608,2,0
101400,020000,31200,5,250,-0.79,70.93,15753,11174,-4579,742,370,-372,27670,31200,31250,31200,66,4,4,867,6666,14,52
101500,020000,31200,5,250,-0.79,70.87,15766,11174,-4592,745,370,-375,27683,31200,31200,31200,10,1,0,896,6630,10,0
101500,020000,31250,5,200,-0.64,71.18,15804,11249,-4555,749,373,-376,27796,31200,31250,31200,123,5,3,873,6655,48,75
101600,020000,31200,5,250,-0.79,71.04,15837,11250,-4587,752,374,-378,27830,31200,31200,31200,23,2,0,874,6634,23,0
101600,020000,31250,5,200,-0.64,71.12,15871,11287,-4584,757,379,-378,27901,31200,31250,31200,94,7,5,898,6649,57,37
101700,020000,31200,5,250,-0.79,71.24,15883,11315,-4568,760,383,-377,27941,31250,31250,31200,40,3,4,942,6713,12,28
101800,020000,31250,5,200,-0.64,70.65,16037,11330,-4707,764,384,-380,28110,31200,31250,31200,16,1,1,943,6726,1,15
101800,020000,31250,5,200,-0.64,70.58,16087,11354,-4733,767,385,-382,28184,31200,31250,31200,90,4,2,1006,6969,51,39
101900,020000,31250,5,200,-0.64,72.31,16100,11642,-4458,771,392,-379,28485,31250,31250,31250,184,0,2,848,7277,0,184
101900,020000,31300,5,150,-0.48,72.4,16112,11665,-4447,774,396,-378,28520,31250,31300,31250,219,3,6,1103,6603,12,207
102000,020000,31250,5,200,-0.64,72.24,16151,11667,-4484,779,397,-382,28561,31250,31250,31250,18,3,0,1161,6242,18,0
102000,020000,31300,5,150,-0.48,71.75,16263,11668,-4595,784,398,-386,28674,31250,31300,31250,131,8,1,1218,6185,130,1
102100,020000,31250,5,200,-0.64,71.6,16296,11668,-4628,789,398,-391,28707,31250,31250,31250,33,5,0,1318,6218,33,0
102200,020000,31300,5,150,-0.48,73.66,16344,12039,-4305,793,402,-391,29126,31300,31300,31300,0,0,0,1018,6391,0,0
102200,020000,31300,5,150,-0.48,74.3,16357,12153,-4204,796,408,-388,29253,31350,31400,31300,127,3,6,1088,6482,13,114
102300,020000,31350,5,100,-0.32,74.6,16380,12220,-4160,799,411,-388,29343,31400,31400,31300,27,1,2,977,6635,20,7
102300,020000,31300,5,150,-0.48,74.52,16399,12221,-4178,802,412,-390,29363,31400,31400,31300,47,4,3,1021,6542,39,8
102400,020000,31300,5,150,-0.48,74.45,16414,12221,-4193,807,412,-395,29378,31300,31300,31300,13,3,0,1059,6576,13,0
102400,020000,31300,5,150,-0.48,74.34,16444,12224,-4220,811,414,-397,29411,31300,31350,31300,46,7,2,1069,6591,43,3
102500,020000,31350,5,100,-0.32,74.28,16476,12239,-4237,814,416,-398,29458,31300,31350,31300,47,3,2,1123,6661,32,15
102600,020000,31300,5,150,-0.48,74.16,16505,12240,-4265,817,417,-400,29488,31300,31300,31300,0,0,0,1164,6650,0,0
102600,020000,31250,5,200,-0.64,72.45,16929,12265,-4664,825,420,-405,29937,31300,31300,31250,449,8,3,1208,6600,424,25
102700,020000,31250,5,200,-0.64,72.4,16941,12266,-4675,828,421,-407,29950,31250,31250,31250,11,2,0,1233,6692,11,0
102700,020000,31250,5,200,-0.64,72.27,16976,12268,-4708,831,423,-408,29987,31250,31300,31250,48,5,2,1241,6894,46,2
102800,020000,31300,5,150,-0.48,72.31,16989,12284,-4705,834,426,-408,30016,31250,31300,31250,19,2,3,1263,7261,3,16
102900,020000,31250,5,200,-0.64,72.23,17010,12286,-4724,841,427,-414,30039,31250,31250,31250,0,0,0,1300,7432,0,0
102900,020000,31250,5,200,-0.64,72.02,17059,12286,-4773,845,427,-418,30088,31250,31250,31250,49,4,0,1306,7481,49,0
103000,020000,31250,5,200,-0.64,71.88,17094,12288,-4806,851,428,-423,30125,31250,31250,31250,12,3,0,1325,7455,12,0
103000,020000,31250,5,200,-0.64,71.82,17183,12340,-4843,856,431,-425,30266,31250,31300,31250,153,8,3,1302,7326,101,52
103100,020000,31300,5,150,-0.48,72.1,17200,12401,-4799,861,433,-428,30344,31250,31300,31250,67,3,2,1261,7290,6,61
103100,020000,31300,5,150,-0.48,72.18,17211,12423,-4788,863,434,-429,30377,31250,31300,31250,100,5,3,1253,7086,17,83
103200,020000,31300,5,150,-0.48,72.18,17246,12448,-4798,867,436,-431,30437,31250,31300,31250,60,4,2,1231,7181,35,25
103300,020000,31250,5,200,-0.64,72.01,17286,12448,-4838,873,436,-437,30477,31250,31250,31250,20,1,0,1277,7185,20,0
103300,020000,31250,5,200,-0.64,71.83,17330,12449,-4881,878,437,-441,30522,31250,31300,31250,65,6,1,1291,7229,64,1
103400,020000,31250,5,200,-0.64,71.77,17348,12450,-4898,885,438,-447,30541,31250,31250,31250,2,1,0,1302,7210,2,0
103400,020000,31250,5,200,-0.64,71.73,17376,12463,-4913,889,439,-450,30582,31250,31300,31250,43,5,1,1316,7190,30,13
103500,020000,31300,5,150,-0.48,71.62,17404,12464,-4940,892,440,-452,30611,31250,31300,31250,4,2,1,1349,7234,3,1
103500,020000,31250,5,200,-0.64,71.57,17416,12464,-4952,895,440,-455,30623,31250,31300,31250,16,5,1,1380,7224,15,1
103600,020000,31250,5,200,-0.64,70.4,17713,12470,-5243,904,442,-462,30926,31250,31300,31250,303,9,2,1396,7143,297,6
103700,020000,31200,5,250,-0.79,68.7,18192,12498,-5694,912,445,-467,31433,31200,31200,31200,0,0,0,1144,6935,0,0
103700,020000,31250,5,200,-0.64,68.79,18220,12534,-5686,916,449,-467,31497,31250,31250,31200,64,4,4,1335,6888,28,36
103800,020000,31200,5,250,-0.79,68.52,18293,12534,-5759,920,449,-471,31570,31200,31200,31200,48,3,0,1450,6881,48,0
103800,020000,31200,5,250,-0.79,68.54,18350,12578,-5772,926,451,-475,31671,31200,31250,31200,149,9,2,1428,7267,105,44
103900,020000,31200,5,250,-0.79,68.48,18399,12600,-5799,932,453,-479,31742,31200,31250,31200,71,6,2,1392,7202,49,22
104000,020000,31200,5,250,-0.79,68.34,18469,12621,-5848,939,454,-485,31833,31200,31200,31200,0,0,0,1538,7192,0,0
104000,020000,31200,5,250,-0.79,68.42,18471,12637,-5834,941,457,-484,31851,31250,31250,31200,18,2,3,1533,7147,2,16
104100,020000,31200,5,250,-0.79,68.39,18508,12658,-5850,946,459,-487,31909,31250,31250,31200,3,2,1,1547,7107,2,1
104100,020000,31250,5,200,-0.64,68.69,18544,12738,-5806,950,461,-489,32025,31250,31250,31200,119,6,3,1474,7071,38,81
104200,020000,31200,5,250,-0.79,68.93,18556,12791,-5765,953,465,-488,32090,31200,31250,31200,13,3,1,1427,7173,12,1
104300,020000,31200,5,250,-0.79,69.39,18588,12898,-5690,957,469,-488,32229,31200,31200,31200,10,1,0,1331,7162,10,0
104300,020000,31250,5,200,-0.64,70.27,18636,13096,-5540,959,474,-485,32475,31200,31250,31200,256,3,5,1449,7092,58,198
104400,020000,31200,5,250,-0.79,70.24,18649,13099,-5550,962,475,-487,32491,31200,31200,31200,1,1,0,1355,7080,1,0
104400,020000,31200,5,250,-0.79,70.08,18718,13118,-5600,967,477,-490,32579,31200,31250,31200,89,6,2,1351,6993,70,19
104500,020000,31250,5,200,-0.64,70.09,18754,13144,-5610,971,482,-489,32641,31250,31250,31200,59,3,4,1421,6937,35,24
104600,020000,31250,5,200,-0.64,70.17,18781,13179,-5602,975,485,-490,32703,31200,31250,31200,32,2,1,1407,6929,11,21
104600,020000,31200,5,250,-0.79,70.03,18820,13179,-5641,979,485,-494,32742,31200,31250,31200,71,6,1,1421,6975,50,21
104700,020000,31200,5,250,-0.79,69.87,18893,13200,-5693,984,486,-498,32836,31200,31250,31200,61,3,1,1437,7048,40,21
104700,020000,31200,5,250,-0.79,69.78,18922,13204,-5718,989,487,-502,32869,31200,31250,31200,94,8,2,1448,7016,69,25
104800,020000,31200,5,250,-0.79,69.66,18993,13231,-5762,995,491,-504,32967,31200,31250,31200,98,6,4,1435,6924,71,27
104900,020000,31200,5,250,-0.79,69.64,19045,13262,-5783,1000,493,-507,33050,31200,31200,31200,50,4,0,1418,6878,50,0
104900,020000,31150,5,300,-0.95,68.03,19565,13310,-6255,1020,496,-524,33618,31200,31250,31150,618,24,3,1253,6933,570,48
105000,020000,31200,5,250,-0.79,69.42,19582,13593,-5989,1023,499,-524,33918,31150,31200,31150,286,2,3,1034,6909,3,283
105100,020000,31200,5,250,-0.79,69.28,19624,13596,-6028,1028,502,-526,33963,31150,31200,31150,21,2,1,1086,6621,20,1
105100,020000,31200,5,250,-0.79,69.09,19680,13597,-6083,1034,503,-531,34020,31150,31200,31150,78,8,2,1159,6566,76,2
105200,020000,31150,5,300,-0.95,69.23,19692,13633,-6059,1037,505,-532,34068,31150,31150,31150,11,2,0,1154,6593,11,0
105200,020000,31150,5,300,-0.95,68.89,19880,13696,-6184,1046,509,-537,34319,31150,31200,31150,262,11,4,1145,6753,199,63
105300,020000,31200,5,250,-0.79,68.89,19882,13697,-6185,1048,510,-538,34322,31150,31200,31150,3,2,1,1148,6875,2,1
105400,020000,31200,5,250,-0.79,68.92,19895,13712,-6183,1052,512,-540,34350,31200,31200,31200,1,0,1,1144,6852,0,1
105400,020000,31150,5,300,-0.95,68.7,19958,13712,-6246,1058,512,-546,34413,31200,31200,31150,64,6,1,1167,6790,63,1
105500,020000,31150,5,300,-0.95,68.75,19997,13747,-6250,1062,515,-547,34487,31150,31200,31150,40,3,1,1116,6744,38,2
105500,020000,31150,5,300,-0.95,68.75,20016,13761,-6255,1066,516,-550,34520,31150,31200,31150,73,7,2,1161,6547,57,16
105600,020000,31150,5,300,-0.95,68.63,20153,13832,-6321,1073,519,-554,34728,31150,31200,31150,175,5,2,1103,6562,106,69
105600,020000,31150,5,300,-0.95,68.59,20165,13832,-6333,1075,519,-556,34740,31150,31200,31150,187,7,2,1125,6596,118,69
105700,020000,31150,5,300,-0.95,68.64,20188,13858,-6330,1082,523,-559,34789,31200,31200,31150,39,5,3,1160,6551,14,25
105800,020000,31200,5,250,-0.79,68.59,20243,13885,-6358,1086,525,-561,34871,31150,31200,31150,68,2,1,1276,6674,53,15
105800,020000,31150,5,300,-0.95,67.62,20534,13886,-6648,1096,526,-570,35163,31150,31200,31100,360,12,2,1085,6615,344,16
105900,020000,31150,5,300,-0.95,67.53,20565,13888,-6677,1100,528,-572,35196,31150,31150,31150,1,0,1,1109,6584,0,1
105900,020000,31150,5,300,-0.95,68.66,20635,14169,-6466,1109,533,-576,35547,31150,31200,31100,352,9,6,1029,6258,70,282
110000,020000,31200,5,250,-0.79,68.91,20646,14227,-6419,1112,538,-574,35616,31150,31200,31100,57,1,4,1045,6226,1,56
110000,020000,31200,5,250,-0.79,68.85,20683,14240,-6443,1116,539,-577,35666,31150,31200,31100,107,5,5,1038,6210,38,69
110100,020000,31150,5,300,-0.95,68.83,20711,14255,-6456,1121,541,-580,35709,31150,31200,31150,41,4,2,1185,6284,26,15
110100,020000,31150,5,300,-0.95,68.77,20743,14264,-6479,1126,542,-584,35750,31150,31200,31150,82,9,3,1125,6313,58,24
110200,020000,31150,5,300,-0.95,68.71,20761,14265,-6496,1130,543,-587,35769,31200,31200,31150,19,4,1,1148,6287,18,1
110300,020000,31150,5,300,-0.95,68.68,20794,14281,-6513,1136,545,-591,35818,31150,31150,31150,1,1,0,1134,6453,1,0
110300,020000,31150,5,300,-0.95,68.69,20828,14307,-6521,1143,548,-595,35878,31150,31200,31150,61,8,3,1153,6412,35,26
110400,020000,31200,5,250,-0.79,68.57,20872,14311,-6561,1148,550,-598,35926,31150,31200,31150,14,2,1,1159,6395,11,3
110400,020000,31150,5,300,-0.95,68.53,20882,14311,-6571,1151,550,-601,35936,31150,31200,31150,24,5,1,1154,6408,21,3
110500,020000,31150,5,300,-0.95,68.47,20929,14330,-6599,1160,551,-609,36002,31150,31200,31150,51,5,1,1143,6721,32,19
110500,020000,31150,5,300,-0.95,68.59,20966,14381,-6585,1167,556,-611,36090,31150,31200,31150,139,12,6,1071,6673,69,70
110600,020000,31200,5,250,-0.79,68.62,20999,14409,-6590,1172,560,-612,36151,31150,31200,31150,61,5,4,1183,6639,33,28
110700,020000,31150,5,300,-0.95,68.95,21074,14530,-6544,1183,564,-619,36347,31150,31150,31150,1,1,0,1128,6580,1,0
110700,020000,31150,5,300,-0.95,68.9,21089,14530,-6559,1187,564,-623,36362,31150,31150,31150,16,5,0,1126,6638,16,0
110800,020000,31200,5,250,-0.79,68.96,21100,14551,-6549,1189,565,-624,36394,31200,31200,31200,0,0,0,1127,6647,0,0
110800,020000,31200,5,250,-0.79,68.87,21136,14556,-6580,1193,567,-626,36435,31150,31200,31150,41,4,2,1001,6625,36,5
110900,020000,31200,5,250,-0.79,68.84,21197,14591,-6606,1199,571,-628,36531,31150,31200,31150,95,6,3,950,6632,61,34
110900,020000,31150,5,300,-0.95,68.76,21232,14600,-6632,1205,572,-633,36575,31150,31200,31150,139,12,4,954,6605,96,43
111000,020000,31200,5,250,-0.79,69.04,21248,14670,-6578,1210,574,-636,36661,31150,31200,31150,86,5,2,984,6734,16,70
111100,020000,31350,5,100,-0.32,70.83,21449,15192,-6257,1223,585,-638,37384,31350,31350,31350,22,2,0,1112,4984,22,0
111100,020000,31350,5,100,-0.32,70.44,21573,15195,-6378,1229,587,-642,37511,31350,31350,31300,149,8,2,1263,5547,146,3
111200,020000,31300,5,150,-0.48,70.32,21607,15195,-6412,1238,587,-651,37545,31300,31300,31300,19,4,0,1291,5768,19,0
111200,020000,31350,5,100,-0.32,70.85,21673,15355,-6318,1245,590,-655,37771,31300,31400,31300,245,11,3,1236,5670,85,160
111300,020000,31300,5,150,-0.48,70.6,21750,15356,-6394,1253,591,-662,37849,31350,31350,31300,75,6,1,1271,6009,74,1
111300,020000,31300,5,150,-0.48,70.61,21753,15360,-6393,1255,592,-663,37856,31350,31350,31300,82,8,2,1305,5600,77,5
111400,020000,31200,5,250,-0.79,68.93,22355,15409,-6946,1266,595,-671,38507,31300,31300,31200,338,7,3,1146,5853,289,49
111500,020000,31150,5,300,-0.95,68.77,22408,15410,-6998,1276,596,-680,38561,31150,31150,31150,1,1,0,972,6686,1,0
111500,020000,31150,5,300,-0.95,68.77,22427,15423,-7004,1284,598,-686,38593,31150,31200,31150,33,9,2,1001,6671,20,13
111600,020000,31200,5,250,-0.79,68.7,22485,15447,-7038,1292,602,-690,38675,31200,31200,31150,17,1,2,992,6622,3,14
111600,020000,31200,5,250,-0.79,68.63,22525,15460,-7065,1299,604,-695,38728,31200,31200,31150,70,8,4,1006,6606,43,27
111700,020000,31150,5,300,-0.95,68.62,22566,15484,-7082,1304,605,-699,38793,31150,31150,31150,38,3,0,974,6816,38,0
111700,020000,31150,5,300,-0.95,68.62,22593,15503,-7090,1308,607,-701,38839,31150,31200,31150,84,7,2,957,6776,65,19
111800,020000,31150,5,300,-0.95,68.72,22601,15532,-7069,1313,609,-704,38876,31150,31200,31150,36,4,2,950,6523,7,29
111900,020000,31150,5,300,-0.95,68.57,22652,15532,-7120,1318,609,-709,38927,31150,31150,31150,0,0,0,951,6475,0,0
111900,020000,31150,5,300,-0.95,68.5,22706,15553,-7153,1326,611,-715,39002,31150,31200,31150,75,8,2,1150,6856,54,21
112000,020000,31200,5,250,-0.79,68.35,22770,15564,-7206,1343,614,-729,39077,31150,31200,31150,28,12,1,1192,6807,24,4
112000,020000,31100,5,350,-1.11,68.5,22796,15615,-7181,1351,619,-732,39154,31150,31200,31100,105,20,6,1102,7278,50,55
112100,020000,31200,5,250,-0.79,66.11,23848,15767,-8081,1358,622,-736,40358,31200,31250,31200,59,3,1,1158,5475,46,13
112100,020000,31250,5,200,-0.64,66.84,23879,15961,-7918,1364,630,-734,40583,31200,31300,31200,284,9,9,1141,5514,77,207
112200,020000,31250,5,200,-0.64,66.73,23922,15962,-7960,1370,631,-739,40627,31250,31250,31250,41,5,0,1151,5756,41,0
112200,020000,31250,5,200,-0.64,66.57,23978,15962,-8016,1375,631,-744,40683,31250,31250,31250,97,10,0,1189,5709,97,0
112300,020000,31250,5,200,-0.64,66.37,24056,15966,-8090,1387,633,-754,40765,31250,31300,31250,82,12,2,1240,5635,78,4
112400,020000,31300,5,150,-0.48,66.31,24095,15978,-8117,1395,634,-761,40816,31300,31300,31300,12,0,1,1247,5974,0,12
112400,020000,31200,5,250,-0.79,66.16,24153,15980,-8173,1403,635,-768,40876,31300,31300,31150,72,8,2,938,6238,58,14
112500,020000,31200,5,250,-0.79,66.07,24187,15980,-8207,1408,635,-773,40910,31200,31200,31200,2,1,0,1138,6683,2,0
112500,020000,31200,5,250,-0.79,65.89,24251,15980,-8271,1415,635,-780,40974,31200,31200,31200,66,8,0,1205,6744,66,0
112600,020000,31250,5,200,-0.64,65.77,24298,15982,-8316,1421,637,-784,41023,31250,31250,31200,16,4,2,1274,6673,14,2
112600,020000,31200,5,250,-0.79,65.74,24369,16020,-8349,1427,639,-788,41132,31250,31250,31200,125,10,4,1256,6609,85,40
112700,020000,31200,5,250,-0.79,65.69,24407,16034,-8373,1431,641,-790,41184,31250,31250,31200,37,3,1,1244,6587,36,1
112800,020000,31200,5,250,-0.79,65.65,24423,16034,-8389,1436,641,-795,41200,31200,31200,31200,0,0,0,1328,6569,0,0
112800,020000,31200,5,250,-0.79,65.57,24454,16034,-8420,1442,641,-801,41231,31200,31200,31200,31,6,0,1357,6571,31,0
112900,020000,31200,5,250,-0.79,65.4,24517,16034,-8483,1449,641,-808,41294,31200,31200,31200,30,3,0,1371,6525,30,0
112900,020000,31200,5,250,-0.79,65.38,24524,16035,-8489,1453,642,-811,41302,31200,31250,31200,38,7,1,1377,6587,37,1
113000,020000,31200,5,250,-0.79,64.82,24764,16052,-8712,1459,646,-813,41559,31200,31250,31200,30,3,2,1381,6444,27,3
113000,020000,31200,5,250,-0.79,64.48,24894,16052,-8842,1483,646,-837,41689,31200,31250,31200,160,27,2,1340,6330,157,3
113100,020000,31200,5,250,-0.79,64.17,25030,16063,-8967,1490,648,-842,41836,31200,31200,31200,146,6,2,1346,6376,135,11
113200,020000,31200,5,250,-0.79,64.01,25095,16063,-9032,1498,648,-850,41901,31200,31200,31200,1,1,0,1366,6199,1,0
113200,020000,31150,5,300,-0.95,63.77,25194,16065,-9129,1504,650,-854,42002,31200,31250,31150,102,7,2,1364,6656,100,2
113300,020000,31150,5,300,-0.95,63.63,25296,16097,-9199,1511,653,-858,42136,31200,31200,31150,11,1,1,1233,6465,1,10
113300,020000,31150,5,300,-0.95,63.61,25307,16097,-9210,1513,653,-860,42147,31200,31200,31150,22,3,1,1251,6466,12,10
113400,020000,31150,5,300,-0.95,63.57,25324,16098,-9226,1517,654,-863,42165,31150,31150,31150,16,3,0,1252,6465,16,0
113400,020000,31150,5,300,-0.95,63.27,25445,16098,-9347,1526,654,-872,42286,31150,31150,31150,137,12,0,1257,6445,137,0
113500,020000,31150,5,300,-0.95,63.16,25496,16102,-9394,1530,656,-874,42341,31200,31200,31150,53,4,1,1254,6378,51,2
113500,020000,31150,5,300,-0.95,63.12,25530,16115,-9415,1536,657,-879,42388,31200,31200,31150,100,10,2,1271,6391,85,15
113600,020000,31150,5,300,-0.95,63.07,25553,16115,-9438,1538,657,-881,42411,31150,31150,31150,23,2,0,1276,6360,23,0
113700,020000,31150,5,300,-0.95,63.04,25594,16135,-9459,1544,658,-886,42472,31150,31150,31150,1,1,0,1462,6634,1,0
113700,020000,31150,5,300,-0.95,62.92,25646,16137,-9509,1548,660,-888,42526,31150,31200,31150,55,5,2,1464,6593,53,2
113800,020000,31150,5,300,-0.95,62.8,25697,16138,-9559,1553,661,-892,42578,31200,31200,31150,11,1,1,1479,6601,10,1
113800,020000,31200,5,250,-0.79,62.68,25767,16151,-9616,1558,662,-896,42661,31200,31200,31150,94,6,2,1561,6521,80,14
113900,020000,31100,5,350,-1.11,61.59,26272,16181,-10091,1567,665,-902,43196,31100,31100,31100,34,3,0,1409,6642,34,0
113900,020000,31100,5,350,-1.11,61.28,26435,16199,-10236,1574,666,-908,43377,31100,31150,31100,215,10,1,1393,6401,197,18
114000,020000,31100,5,350,-1.11,61.18,26514,16220,-10294,1580,668,-912,43477,31100,31150,31100,75,5,2,1457,6705,54,21
114100,020000,31150,5,300,-0.95,61.12,26542,16223,-10319,1583,670,-913,43508,31150,31150,31150,0,0,0,1443,6625,0,0
114100,020000,31150,5,300,-0.95,61.14,26578,16249,-10329,1587,672,-915,43570,31100,31150,31100,62,4,2,1444,6660,36,26
114200,020000,31100,5,350,-1.11,61.35,26590,16312,-10278,1590,674,-916,43645,31100,31100,31100,0,0,0,1381,6788,0,0
114200,020000,31100,5,350,-1.11,61.27,26657,16333,-10324,1596,675,-921,43733,31100,31150,31100,88,6,1,1356,6807,67,21
114300,020000,31100,5,350,-1.11,61.25,26700,16353,-10347,1599,677,-922,43796,31100,31150,31100,59,2,1,1385,6763,41,18
114300,020000,31100,5,350,-1.11,61.85,26722,16527,-10195,1604,679,-925,43992,31100,31150,31100,255,7,3,1216,6839,63,192
114400,020000,31150,5,300,-0.95,61.83,26764,16548,-10216,1608,682,-926,44055,31100,31150,31100,13,3,1,1223,6774,12,1
114400,020000,31150,5,300,-0.95,61.84,26812,16581,-10231,1611,684,-927,44136,31100,31150,31100,94,6,3,1344,6572,60,34
114500,020000,31150,5,300,-0.95,61.98,26862,16649,-10213,1617,687,-930,44254,31100,31150,31100,118,6,3,1337,6675,50,68
114600,020000,31100,5,350,-1.11,61.91,26891,16649,-10242,1619,687,-932,44283,31100,31100,31100,0,0,0,1318,6636,0,0
114600,020000,31100,5,350,-1.11,61.25,27215,16670,-10545,1628,688,-940,44628,31100,31150,31100,345,9,1,1327,6300,324,21
114700,020000,31100,5,350,-1.11,61.03,27316,16672,-10644,1633,689,-944,44731,31100,31100,31100,99,3,0,1339,6271,99,0
114700,020000,31100,5,350,-1.11,61.02,27386,16711,-10675,1639,692,-947,44840,31100,31150,31050,208,9,3,1322,6531,169,39
114800,020000,31100,5,350,-1.11,61.0,27409,16720,-10689,1643,695,-948,44872,31100,31100,31100,0,0,0,1280,7708,0,0
114800,020000,31050,5,400,-1.27,60.95,27582,16812,-10770,1647,698,-949,45137,31100,31100,31050,265,4,3,1230,7467,173,92
114900,020000,31100,5,350,-1.11,60.85,27660,16831,-10829,1655,699,-956,45234,31050,31100,31050,78,7,1,1259,7414,59,19
115000,020000,31100,5,350,-1.11,60.93,27676,16862,-10814,1657,701,-956,45281,31100,31100,31100,0,0,0,1244,7385,0,0
115000,020000,31100,5,350,-1.11,61.02,27689,16896,-10793,1661,704,-957,45328,31050,31100,31050,47,4,3,2149,7381,13,34
115100,020000,31100,5,350,-1.11,61.02,27717,16914,-10803,1667,705,-962,45374,31050,31100,31050,22,4,1,2185,7375,4,18
115100,020000,31050,5,400,-1.27,60.97,27744,16916,-10828,1671,707,-964,45403,31050,31100,31050,51,8,3,2169,7350,31,20
115200,020000,31100,5,350,-1.11,60.98,27774,16936,-10838,1674,708,-966,45453,31050,31100,31050,40,2,1,2232,7360,20,20
115200,020000,31050,5,400,-1.27,60.95,27788,16937,-10851,1678,709,-969,45468,31050,31100,31050,55,6,2,2237,7355,34,21
115300,020000,31050,5,400,-1.27,60.84,27894,16972,-10922,1685,712,-973,45609,31050,31100,31050,141,7,3,2201,7505,106,35
115300,020000,31050,5,400,-1.27,60.84,27894,16972,-10922,1685,712,-973,45609,31050,31100,31050,141,7,3,2201,7505,106,35
115400,020000,31050,5,400,-1.27,60.77,27961,16993,-10968,1691,713,-978,45697,31050,31100,31050,88,6,1,2424,7442,67,21
115500,020000,31050,5,400,-1.27,61.45,28014,17216,-10798,1696,717,-979,45973,31050,31050,31050,0,0,0,1389,7257,0,0
115500,020000,31050,5,400,-1.27,58.54,29469,17250,-12219,1713,722,-991,47462,31050,31100,31000,1489,17,5,1524,5991,1455,34
115600,020000,31050,5,400,-1.27,58.63,29525,17310,-12215,1716,725,-991,47578,31000,31050,31000,113,2,1,1561,5956,55,58
115600,020000,31050,5,400,-1.27,59.01,29562,17445,-12117,1721,730,-991,47750,31000,31050,31000,285,7,6,1525,5918,92,193
115700,020000,31000,5,450,-1.43,59.02,29573,17455,-12118,1723,731,-992,47771,31000,31000,31000,11,2,0,1657,5913,11,0
115700,020000,31050,5,400,-1.27,59.19,29588,17513,-12075,1727,733,-994,47844,31000,31050,31000,84,6,2,1703,6004,26,58
115800,020000,31050,5,400,-1.27,59.32,29641,17584,-12057,1730,738,-992,47968,31000,31050,31000,90,2,5,1486,5976,19,71
115900,020000,31000,5,450,-1.43,59.52,29735,17699,-12036,1738,743,-995,48177,31000,31000,31000,0,0,0,1433,5886,0,0
115900,020000,31100,5,350,-1.11,59.55,29853,17778,-12075,1746,748,-998,48374,31000,31100,31000,197,8,5,1301,5576,118,79
120000,020000,31000,5,450,-1.43,59.32,29972,17778,-12194,1751,748,-1003,48493,31050,31050,31000,118,4,0,2091,5685,118,0
120000,020000,31100,5,350,-1.11,59.36,29974,17793,-12181,1753,749,-1004,48510,31050,31100,31000,135,6,1,2119,6244,120,15
120100,020000,31050,5,400,-1.27,59.3,30008,17795,-12213,1756,750,-1006,48546,31100,31100,31050,26,2,1,2105,6210,24,2
120100,020000,31000,5,450,-1.43,58.29,30689,17889,-12800,1762,755,-1007,49321,31100,31100,31000,801,8,6,1402,5776,705,96
120200,020000,31000,5,450,-1.43,58.31,30752,17931,-12821,1767,759,-1008,49426,31050,31050,31000,78,4,2,1458,5853,62,16
120300,020000,31000,5,450,-1.43,58.29,30760,17931,-12829,1771,759,-1012,49434,31000,31000,31000,0,0,0,1460,5869,0,0
120300,020000,31000,5,450,-1.43,58.27,30795,17944,-12851,1774,760,-1014,49482,31000,31050,31000,48,3,1,1452,5865,35,13
120400,020000,31050,5,400,-1.27,58.29,30932,18029,-12903,1780,763,-1017,49704,31000,31050,31000,42,1,1,1407,5704,23,19
120400,020000,31000,5,450,-1.43,58.25,30957,18031,-12926,1783,765,-1018,49731,31000,31050,31000,69,4,3,1387,5808,48,21
120500,020000,31000,5,450,-1.43,58.5,30965,18116,-12849,1788,770,-1018,49824,31000,31050,31000,86,4,3,1332,5795,7,79
120500,020000,31050,5,400,-1.27,58.31,31212,18200,-13012,1795,775,-1020,50155,31000,31050,31000,417,11,8,1318,5357,254,163
120600,020000,31050,5,400,-1.27,58.39,31241,18241,-13000,1799,777,-1022,50225,31050,31050,31000,70,4,2,1391,5230,29,41
120600,020000,31000,5,450,-1.43,58.36,31254,18241,-13013,1803,777,-1026,50238,31050,31050,31000,83,8,2,1369,5338,42,41
120700,020000,31050,5,400,-1.27,58.75,31271,18371,-12900,1806,781,-1025,50385,31050,31100,31050,147,3,4,1235,5651,17,130
120800,020000,31050,5,400,-1.27,58.92,31307,18447,-12860,1811,785,-1026,50497,31050,31050,31050,1,1,0,1211,5624,1,0
120800,020000,31050,5,400,-1.27,58.9,31318,18447,-12871,1813,785,-1028,50508,31050,31050,31050,12,3,0,1214,5613,12,0
120900,020000,31050,5,400,-1.27,58.85,31348,18448,-12900,1816,786,-1030,50539,31050,31050,31050,10,1,0,1259,5593,10,0
120900,020000,31050,5,400,-1.27,58.88,31374,18473,-12901,1818,788,-1030,50590,31050,31100,31050,61,3,2,1264,5682,36,25
121000,020000,31100,5,350,-1.11,58.75,31475,18491,-12984,1825,789,-1036,50709,31050,31100,31050,94,4,1,1387,5630,76,18
121000,020000,31100,5,350,-1.11,58.78,31486,18506,-12980,1827,791,-1036,50735,31050,31100,31050,120,6,3,1395,5629,87,33
121100,020000,31050,5,400,-1.27,58.72,31551,18526,-13025,1834,792,-1042,50820,31050,31100,31050,85,7,1,1361,5609,65,20
121200,020000,31050,5,400,-1.27,58.69,31573,18529,-13044,1837,793,-1044,50845,31050,31050,31050,19,1,0,1450,5899,19,0
121200,020000,31050,5,400,-1.27,58.72,31589,18549,-13040,1841,795,-1046,50881,31050,31100,31050,55,5,2,1430,5863,35,20
121300,020000,31100,5,350,-1.11,58.4,31786,18562,-13224,1866,797,-1069,51091,31050,31100,31050,85,17,1,1310,5583,82,3
121300,020000,31000,5,450,-1.43,58.22,31895,18568,-13327,1873,799,-1074,51206,31050,31100,31000,200,24,3,1284,5924,191,9
121400,020000,31000,5,450,-1.43,58.23,31909,18582,-13327,1877,801,-1076,51234,31000,31000,31000,2,2,0,1316,5923,2,0
121400,020000,31000,5,450,-1.43,58.48,31926,18671,-13255,1882,804,-1078,51340,31000,31050,31000,108,7,3,1329,5886,19,89
121500,020000,31000,5,450,-1.43,58.66,31984,18761,-13223,1888,808,-1080,51488,31000,31050,31000,148,6,4,1629,5859,58,90
121600,020000,31050,5,400,-1.27,58.68,32042,18803,-13239,1896,812,-1084,51588,31100,31100,31050,26,3,1,1617,5625,24,2
121600,020000,31100,5,350,-1.11,58.7,32046,18810,-13236,1899,814,-1085,51599,31100,31100,31050,37,6,3,1637,5679,28,9
121700,020000,31050,5,400,-1.27,58.71,32057,18822,-13235,1901,815,-1086,51622,31050,31050,31050,1,1,0,1633,5667,1,0
121700,020000,31050,5,400,-1.27,58.69,32069,18822,-13247,1904,815,-1089,51634,31050,31050,31050,13,4,0,1636,5696,13,0
121800,020000,31050,5,400,-1.27,58.62,32143,18841,-13302,1910,816,-1094,51727,31050,31100,31050,92,5,1,1704,5576,73,19
121800,020000,31100,5,350,-1.11,58.51,32230,18858,-13372,1931,818,-1113,51831,31050,31100,31050,196,26,3,1670,5499,160,36
121900,020000,31100,5,350,-1.11,58.54,32239,18872,-13367,1938,821,-1117,51854,31100,31100,31050,23,7,3,1686,5484,9,14
122000,020000,31000,5,450,-1.43,58.55,32252,18885,-13367,1942,822,-1120,51880,31000,31000,31000,0,0,0,1645,5809,0,0
122000,020000,31000,5,450,-1.43,58.49,32288,18885,-13403,1945,822,-1123,51916,31000,31000,31000,36,3,0,1646,5795,36,0
122100,020000,31000,5,450,-1.43,58.5,32317,18907,-13410,1951,824,-1127,51967,31050,31050,31000,15,2,1,1650,5770,11,4
122100,020000,31000,5,450,-1.43,58.6,32387,18980,-13407,1956,826,-1130,52110,31050,31050,31000,158,7,3,1746,5704,81,77
122200,020000,31050,5,400,-1.27,58.48,32460,18982,-13478,1960,827,-1133,52185,31000,31050,31000,46,2,1,1746,5643,44,2
122200,020000,31000,5,450,-1.43,58.49,32493,19005,-13488,1964,829,-1135,52241,31000,31050,31000,102,6,3,1949,5540,77,25
122300,020000,31050,5,400,-1.27,58.48,32535,19026,-13509,1968,831,-1137,52304,31050,31050,31000,63,4,2,2003,5501,42,21
122400,020000,31000,5,450,-1.43,58.42,32566,19026,-13540,1973,831,-1142,52335,31000,31000,31000,0,0,0,1967,5470,0,0
122400,020000,31000,5,450,-1.43,58.35,32765,19117,-13648,1977,833,-1144,52625,31000,31050,31000,290,4,2,1790,5318,199,91
122500,020000,31050,5,400,-1.27,58.4,32803,19158,-13645,1982,837,-1145,52704,31050,31050,31000,67,3,4,1775,5266,26,41
122500,020000,31000,5,450,-1.43,58.38,32834,19170,-13664,1986,838,-1148,52747,31050,31050,31000,110,7,5,1747,5238,57,53
122600,020000,31050,5,400,-1.27,58.73,32865,19302,-13563,1989,841,-1148,52910,31000,31050,31000,163,3,3,1683,5203,31,132
122600,020000,31050,5,400,-1.27,58.97,32890,19394,-13496,1992,846,-1146,53027,31000,31050,31000,280,6,8,1555,5069,56,224
122700,020000,31000,5,450,-1.43,58.21,33324,19397,-13927,1997,847,-1150,53464,31050,31050,31000,437,5,1,1569,4636,434,3
122800,020000,31050,5,400,-1.27,58.32,33433,19497,-13936,2000,852,-1148,53673,31000,31050,31000,183,3,3,1564,4239,109,74
122800,020000,31100,5,350,-1.11,58.63,33453,19615,-13838,2002,856,-1146,53811,31000,31100,31000,321,5,7,1405,4223,129,192
122900,020000,31050,5,400,-1.27,58.53,33513,19615,-13898,2008,856,-1152,53871,31050,31050,31050,2,1,0,1456,4295,2,0
122900,020000,31000,5,450,-1.43,58.42,33602,19630,-13972,2017,859,-1158,53975,31050,31100,31000,106,10,3,1496,4509,91,15
123000,020000,31000,5,450,-1.43,58.41,33615,19633,-13982,2021,861,-1160,53991,31050,31050,31000,11,1,1,1521,4512,10,1
123000,020000,31000,5,450,-1.43,58.37,33641,19637,-14004,2024,862,-1162,54021,31050,31050,31000,41,4,2,1518,4477,36,5
123100,020000,31050,5,400,-1.27,58.44,33656,19668,-13988,2029,865,-1164,54067,31000,31050,31000,27,4,1,1512,4463,14,13
123200,020000,31000,5,450,-1.43,58.4,33706,19683,-14023,2036,867,-1169,54132,31000,31000,31000,16,2,0,1345,4454,16,0
123200,020000,31000,5,450,-1.43,58.38,33718,19683,-14035,2039,867,-1172,54144,31000,31000,31000,28,5,0,1400,4454,28,0
123300,020000,31050,5,400,-1.27,58.36,33763,19703,-14060,2043,870,-1173,54209,31050,31050,31050,1,0,1,1395,4399,0,1
123300,020000,31050,5,400,-1.27,58.34,33797,19716,-14081,2050,872,-1178,54256,31050,31050,31000,48,7,3,1359,4365,34,14
123400,020000,31000,5,450,-1.43,58.32,33808,19718,-14090,2052,873,-1179,54269,31000,31000,31000,11,2,0,1358,5255,11,0
123400,020000,31000,5,450,-1.43,58.37,33837,19749,-14088,2059,875,-1184,54329,31000,31050,31000,71,9,2,1356,5241,40,31
123500,020000,31000,5,450,-1.43,58.3,33884,19756,-14128,2064,876,-1188,54383,31000,31050,31000,54,5,1,1373,5231,47,7
123500,020000,31000,5,450,-1.43,58.22,33938,19758,-14180,2069,877,-1192,54439,31000,31050,31000,110,10,2,1360,5197,101,9
123600,020000,31000,5,450,-1.43,58.25,33950,19775,-14175,2072,878,-1194,54468,31000,31050,31000,29,3,1,1352,5189,12,17
123700,020000,31000,5,450,-1.43,58.23,33963,19777,-14186,2076,880,-1196,54483,31000,31050,31000,13,3,1,1379,5159,12,1
123700,020000,31000,5,450,-1.43,58.33,34003,19833,-14170,2082,884,-1198,54579,31000,31050,31000,109,9,5,1329,5119,52,57
123800,020000,31050,5,400,-1.27,58.33,34110,19895,-14215,2089,886,-1203,54748,31000,31050,31000,148,4,1,1349,5041,95,53
123800,020000,31000,5,450,-1.43,58.3,34147,19908,-14239,2096,887,-1209,54798,31000,31050,31000,198,11,2,1290,5010,132,66
123900,020000,31000,5,450,-1.43,58.28,34159,19908,-14251,2099,887,-1212,54810,31000,31000,31000,12,3,0,1334,5070,12,0
123900,020000,31000,5,450,-1.43,58.34,34164,19931,-14233,2102,890,-1212,54838,31000,31050,31000,40,6,3,1356,5047,17,23
124000,020000,31050,5,400,-1.27,58.39,34190,19964,-14226,2106,893,-1213,54897,31000,31050,31000,59,4,3,1326,5019,26,33
124100,020000,31100,5,350,-1.11,58.66,34204,20063,-14141,2111,898,-1213,55010,31100,31100,31100,0,0,0,1326,4995,0,0
124100,020000,31050,5,400,-1.27,58.68,34220,20079,-14141,2116,900,-1216,55042,31050,31100,31050,32,5,2,1340,4885,16,16
124200,020000,31050,5,400,-1.27,58.65,34265,20098,-14167,2126,902,-1224,55106,31050,31100,31050,43,7,2,1335,4941,24,19
124200,020000,31050,5,400,-1.27,58.64,34277,20099,-14178,2129,903,-1226,55119,31050,31100,31050,56,10,3,1340,4929,36,20
124300,020000,31100,5,350,-1.11,58.64,34337,20134,-14203,2140,906,-1234,55214,31050,31100,31050,47,5,2,1308,4878,30,17
124300,020000,31000,5,450,-1.43,58.53,34423,20148,-14275,2150,907,-1243,55314,31050,31100,31000,147,15,3,1404,4927,116,31
124400,020000,31000,5,450,-1.43,58.58,34501,20211,-14290,2158,910,-1248,55455,31000,31050,31000,141,8,3,1349,5161,78,63
124500,020000,31000,5,450,-1.43,58.65,34533,20254,-14279,2163,913,-1250,55530,31000,31000,31000,19,1,0,1311,5129,19,0
124500,020000,31050,5,400,-1.27,58.6,34568,20257,-14311,2167,915,-1252,55568,31000,31050,31000,57,5,2,1313,5075,54,3
124600,020000,31050,5,400,-1.27,58.62,34600,20284,-14316,2173,918,-1255,55627,31100,31100,31050,23,1,1,1382,4803,10,13
124600,020000,31050,5,400,-1.27,58.62,34603,20284,-14319,2175,918,-1257,55630,31100,31100,31050,26,3,1,1376,4996,13,13
124700,020000,31050,5,400,-1.27,58.65,34619,20304,-14315,2179,919,-1260,55666,31050,31050,31050,1,1,0,1416,5021,1,0
124700,020000,31050,5,400,-1.27,58.67,34640,20324,-14316,2188,921,-1267,55707,31050,31100,31050,42,10,2,1452,5041,22,20
124800,020000,31050,5,400,-1.27,58.55,34716,20327,-14389,2199,922,-1277,55786,31050,31100,31000,79,11,1,1377,5039,76,3
124900,020000,31100,5,350,-1.11,58.52,34784,20356,-14428,2206,925,-1281,55883,31100,31100,31100,0,0,0,1347,5111,0,0
124900,020000,31050,5,400,-1.27,58.55,34798,20373,-14425,2211,927,-1284,55914,31100,31100,31050,31,5,2,1429,5139,14,17
125000,020000,31050,5,400,-1.27,58.51,34822,20375,-14447,2216,928,-1288,55940,31050,31050,31050,0,0,0,1429,5258,0,0
125000,020000,31050,5,400,-1.27,58.65,34833,20428,-14405,2218,931,-1287,56004,31100,31100,31050,64,2,3,1387,5305,11,53
125100,020000,31050,5,400,-1.27,58.62,34849,20430,-14419,2221,932,-1289,56022,31050,31100,31050,17,2,1,1400,5296,15,2
125100,020000,31050,5,400,-1.27,58.79,34881,20505,-14376,2225,937,-1288,56129,31050,31100,31050,124,6,6,1344,5278,47,77
125200,020000,31100,5,350,-1.11,58.9,34919,20569,-14350,2232,940,-1292,56231,31050,31100,31050,90,7,2,1352,4625,38,52
125300,020000,31050,5,400,-1.27,58.82,34970,20570,-14400,2236,941,-1295,56283,31050,31050,31050,0,0,0,1383,5290,0,0
125300,020000,31100,5,350,-1.11,58.82,34974,20571,-14403,2239,942,-1297,56288,31100,31100,31050,5,3,1,1344,5285,4,1
125400,020000,31050,5,400,-1.27,58.77,35002,20571,-14431,2244,942,-1302,56316,31050,31050,31050,15,1,0,1446,5427,15,0
125400,020000,31100,5,350,-1.11,58.81,35016,20594,-14422,2248,945,-1303,56353,31050,31100,31050,52,5,3,1450,5458,29,23
125500,020000,31050,5,400,-1.27,58.76,35069,20607,-14462,2252,946,-1306,56419,31050,31050,31050,33,2,0,1966,5419,33,0
125600,020000,31050,5,400,-1.27,58.79,35085,20628,-14457,2258,947,-1311,56456,31050,31050,31050,1,1,0,1975,5435,1,0
125600,020000,31050,5,400,-1.27,58.75,35113,20628,-14485,2262,947,-1315,56484,31050,31050,31050,29,5,0,1979,5435,29,0
125700,020000,31050,5,400,-1.27,58.76,35142,20648,-14494,2268,948,-1320,56533,31050,31050,31050,4,3,0,1961,5414,4,0
125700,020000,31050,5,400,-1.27,58.79,35178,20682,-14496,2272,952,-1320,56603,31050,31100,31050,74,7,4,1961,5195,40,34
125800,020000,31100,5,350,-1.11,58.79,35212,20701,-14511,2277,954,-1323,56656,31100,31100,31050,53,5,2,1962,5269,34,19
125900,020000,31050,5,400,-1.27,58.73,35247,20701,-14546,2280,954,-1326,56691,31050,31050,31050,1,1,0,1949,5243,1,0
125900,020000,31100,5,350,-1.11,58.73,35280,20719,-14561,2285,955,-1330,56742,31050,31100,31050,52,6,1,1979,5214,34,18
130000,020000,31050,5,400,-1.27,58.53,35400,20720,-14680,2291,956,-1335,56863,31050,31100,31050,76,5,1,1998,5152,75,1
130100,020000,31050,5,400,-1.27,58.62,35403,20755,-14648,2293,959,-1334,56901,31050,31050,31050,0,0,0,1936,5116,0,0
130100,020000,31100,5,350,-1.11,58.57,35435,20756,-14679,2297,960,-1337,56934,31050,31100,31050,33,4,1,1987,5100,32,1
130200,020000,31050,5,400,-1.27,58.37,35575,20764,-14811,2328,962,-1366,57082,31050,31100,31000,111,26,1,1988,5059,110,1
130300,020000,31050,5,400,-1.27,58.34,35597,20767,-14830,2334,963,-1371,57107,31050,31050,31050,0,0,0,1984,5056,0,0
130300,020000,31100,5,350,-1.11,58.23,35702,20791,-14911,2345,966,-1379,57236,31050,31100,31050,129,11,3,1998,5054,105,24
130400,020000,31050,5,400,-1.27,58.24,35714,20800,-14914,2348,968,-1380,57257,31100,31100,31050,11,1,1,2005,5102,10,1
130400,020000,31050,5,400,-1.27,58.43,35788,20911,-14877,2354,970,-1384,57442,31100,31100,31050,196,7,3,1922,5154,84,112
130500,020000,31050,5,400,-1.27,58.4,35815,20916,-14899,2363,972,-1391,57474,31050,31050,31000,32,9,2,1917,5438,27,5
130600,020000,31050,5,400,-1.27,58.31,35871,20918,-14953,2368,974,-1394,57532,31050,31050,31050,2,0,2,2248,5342,0,2
130600,020000,31050,5,400,-1.27,58.22,35949,20931,-15018,2372,975,-1397,57623,31050,31050,31000,93,4,3,2544,5253,78,15
130700,020000,31050,5,400,-1.27,58.25,35962,20947,-15015,2375,976,-1399,57652,31000,31050,31000,26,1,1,2569,5237,10,16
130800,020000,31000,5,450,-1.43,58.1,36054,20947,-15107,2382,976,-1406,57744,31000,31000,31000,33,1,0,2585,5387,33,0
130800,020000,31000,5,450,-1.43,58.01,36131,20960,-15171,2388,977,-1411,57834,31000,31050,31000,123,7,1,2573,5310,110,13
130900,020000,31050,5,400,-1.27,58.04,36142,20976,-15166,2390,981,-1409,57861,31050,31050,31050,3,0,2,2597,5332,0,3
130900,020000,31050,5,400,-1.27,58.06,36181,21005,-15176,2395,983,-1412,57929,31050,31050,31000,71,5,4,2621,5319,39,32
131000,020000,31000,5,450,-1.43,58.04,36192,21005,-15187,2397,983,-1414,57940,31000,31000,31000,11,2,0,2607,5299,11,0
131100,020000,31050,5,400,-1.27,57.94,36288,21024,-15264,2405,984,-1421,58055,31000,31050,31000,96,3,1,2615,5162,77,19
131100,020000,31000,5,450,-1.43,57.87,36334,21025,-15309,2409,985,-1424,58102,31000,31050,31000,143,7,2,2612,5294,123,20
131200,020000,31000,5,450,-1.43,57.79,36418,21045,-15373,2416,988,-1428,58206,31050,31050,31000,71,2,2,2598,5251,69,2
131300,020000,31050,5,400,-1.27,57.81,36444,21069,-15375,2419,990,-1429,58256,31050,31050,31050,0,0,0,2586,5210,0,0
131300,020000,31000,5,450,-1.43,57.7,36513,21069,-15444,2427,990,-1437,58325,31000,31000,31000,69,8,0,2635,5162,69,0
131400,020000,31000,5,450,-1.43,58.18,36637,21317,-15320,2432,993,-1439,58697,31000,31000,31000,77,3,0,2401,5091,77,0
131400,020000,31000,5,450,-1.43,58.16,36681,21335,-15346,2437,995,-1442,58759,31000,31050,31000,139,8,2,2326,4832,121,18
131500,020000,31000,5,450,-1.43,58.16,36709,21349,-15360,2440,997,-1443,58801,31050,31050,31000,40,2,1,2440,4878,27,13
131600,020000,31000,5,450,-1.43,57.53,37176,21388,-15788,2455,1000,-1455,59307,30950,31000,30950,116,6,2,2177,5565,93,23
131600,020000,31000,5,450,-1.43,59.1,37201,21985,-15216,2458,1004,-1454,59929,30950,31000,30950,738,9,6,1915,4550,118,620
131700,020000,31000,5,450,-1.43,59.05,37254,22000,-15254,2468,1005,-1463,59997,31000,31050,31000,66,8,1,1921,4513,51,15
131700,020000,31000,5,450,-1.43,59.07,37266,22014,-15252,2471,1007,-1464,60023,31000,31050,31000,92,11,3,1917,4817,63,29
131800,020000,31000,5,450,-1.43,58.98,37353,22030,-15323,2482,1009,-1473,60126,31000,31050,31000,103,11,2,1927,4953,87,16
131900,020000,31050,5,400,-1.27,59.18,37427,22149,-15278,2496,1013,-1483,60319,31050,31050,31050,65,4,2,1856,4794,5,60
131900,020000,31050,5,400,-1.27,59.16,37442,22150,-15292,2501,1014,-1487,60335,31050,31100,31050,81,9,3,1760,4837,20,61
132000,020000,31050,5,400,-1.27,59.04,37514,22150,-15364,2512,1014,-1498,60407,31050,31050,31050,70,10,0,1766,4749,70,0
132100,020000,31000,5,450,-1.43,59.05,37533,22162,-15371,2519,1016,-1503,60438,31000,31000,31000,0,0,0,1832,4917,0,0
132100,020000,31000,5,450,-1.43,59.03,37597,22194,-15403,2527,1018,-1509,60534,31050,31050,31000,96,8,2,1745,4855,64,32
132200,020000,31000,5,450,-1.43,59.04,37664,22237,-15427,2533,1023,-1510,60644,31000,31000,31000,1,1,0,1781,4897,1,0
132200,020000,31050,5,400,-1.27,59.02,37678,22238,-15440,2537,1024,-1513,60659,31000,31050,31000,16,5,1,1921,4845,15,1
132300,020000,31000,5,450,-1.43,58.99,37732,22258,-15474,2547,1025,-1522,60733,31000,31050,31000,73,9,1,1821,4804,53,20
132400,020000,31050,5,400,-1.27,59.11,37748,22311,-15437,2554,1029,-1525,60802,31050,31050,31000,34,1,2,1823,4895,1,33
132400,020000,31000,5,450,-1.43,59.02,37845,22336,-15509,2565,1031,-1534,60924,31050,31050,31000,156,12,4,1787,4901,98,58
132500,020000,31000,5,450,-1.43,58.96,37914,22355,-15559,2573,1032,-1541,61012,31000,31050,31000,54,6,1,1784,4820,35,19
132600,020000,31000,5,450,-1.43,58.96,37915,22355,-15560,2574,1032,-1542,61013,31000,31000,31000,0,0,0,1815,4818,0,0
132600,020000,31050,5,400,-1.27,59.11,37993,22459,-15534,2584,1037,-1547,61195,31000,31050,31000,182,10,5,1760,4668,78,104
132700,020000,31000,5,450,-1.43,59.09,38027,22472,-15555,2590,1039,-1551,61242,31000,31050,31000,33,3,1,1745,4659,21,12
132700,020000,31000,5,450,-1.43,59.04,38096,22492,-15604,2597,1041,-1556,61331,31000,31050,31000,122,10,3,1754,4620,90,32
132800,020000,31050,5,400,-1.27,59.08,38107,22513,-15594,2599,1042,-1557,61363,31000,31050,31000,32,2,1,1853,4573,11,21
132900,020000,31000,5,450,-1.43,59.05,38123,22513,-15610,2603,1042,-1561,61379,31000,31000,31000,11,2,0,1882,4571,11,0
132900,020000,31050,5,400,-1.27,59.05,38161,22535,-15626,2607,1045,-1562,61439,31000,31050,31000,71,6,3,1881,4542,49,22
133000,020000,30950,5,500,-1.59,58.97,38264,22566,-15698,2621,1047,-1574,61590,31000,31050,30950,113,12,1,1931,5565,78,18
133100,020000,30950,5,500,-1.59,58.91,38313,22571,-15742,2627,1048,-1579,61644,30950,30950,30950,35,2,0,1878,5554,35,0
133100,020000,30950,5,500,-1.59,58.91,38346,22591,-15755,2633,1049,-1584,61697,30950,31000,30950,88,8,1,1605,5526,68,20
133200,020000,30950,5,500,-1.59,59.08,38386,22680,-15706,2637,1051,-1586,61826,31000,31000,30950,56,2,1,1501,5867,37,19
133200,020000,31000,5,450,-1.43,59.15,38402,22713,-15689,2640,1054,-1586,61875,31000,31000,30950,105,5,4,1524,5855,53,52
133300,020000,31000,5,450,-1.43,59.13,38415,22715,-15700,2643,1055,-1588,61890,30950,31000,30950,5,2,1,1547,5852,3,2
133400,020000,30950,5,500,-1.59,59.21,38484,22786,-15698,2648,1059,-1589,62030,31000,31000,30950,82,3,1,1505,5828,58,24
133400,020000,30950,5,500,-1.59,59.27,38517,22829,-15688,2654,1061,-1593,62106,31000,31000,30950,158,9,3,1499,5812,91,67
133500,020000,30950,5,500,-1.59,59.28,38544,22849,-15695,2659,1064,-1595,62153,31000,31000,30950,47,5,3,1504,5777,27,20
133600,020000,31000,5,450,-1.43,59.24,38660,22901,-15759,2668,1068,-1600,62321,31000,31000,31000,12,3,0,1763,4648,12,0
133600,020000,31000,5,450,-1.43,59.26,38679,22921,-15758,2673,1069,-1604,62360,31000,31050,31000,51,8,1,1756,4645,31,20
133700,020000,31000,5,450,-1.43,59.26,38680,22922,-15758,2674,1070,-1604,62362,31000,31000,31000,1,1,0,1794,4659,1,0
133800,020000,31050,5,400,-1.27,59.22,38735,22940,-15795,2679,1071,-1608,62435,31050,31050,31050,0,0,0,1858,4654,0,0
133800,020000,31000,5,450,-1.43,59.2,38761,22945,-15816,2683,1074,-1609,62466,31000,31050,31000,31,4,3,1846,4692,26,5
133900,020000,31000,5,450,-1.43,59.13,38860,22977,-15883,2692,1076,-1616,62597,31000,31000,31000,26,4,0,1792,4798,26,0
133900,020000,31050,5,400,-1.27,59.12,38896,22997,-15899,2695,1077,-1618,62653,31000,31050,31000,82,7,1,1808,4785,62,20
134000,020000,31050,5,400,-1.27,59.12,38899,22998,-15901,2697,1078,-1619,62657,31000,31050,31000,4,2,1,1839,4577,3,1
134100,020000,31000,5,450,-1.43,59.05,38949,22998,-15951,2701,1078,-1623,62707,31000,31000,31000,0,0,0,1839,4673,0,0
134100,020000,31050,5,400,-1.27,59.08,38980,23030,-15950,2705,1081,-1624,62770,31000,31050,31000,63,4,3,1870,4737,31,32
134200,020000,31000,5,450,-1.43,58.9,39221,23100,-16121,2732,1087,-1645,63081,31000,31000,30950,120,12,3,1720,4781,88,32
134200,020000,31000,5,450,-1.43,58.89,39250,23115,-16135,2738,1088,-1650,63125,31000,31050,30950,164,18,4,1714,4595,117,47
134300,020000,31000,5,450,-1.43,58.83,39332,23138,-16194,2746,1090,-1656,63230,31000,31050,30950,105,8,2,1432,6149,82,23
134400,020000,30950,5,500,-1.59,58.84,39351,23153,-16198,2750,1092,-1658,63264,30950,31000,30950,16,2,1,1422,6094,3,13
134400,020000,31000,5,450,-1.43,58.57,39585,23183,-16402,2756,1095,-1661,63528,30950,31000,30950,280,8,4,1418,5874,237,43
134500,020000,30950,5,500,-1.59,58.54,39600,23183,-16417,2760,1095,-1665,63543,30950,30950,30950,15,4,0,1604,5837,15,0
134600,020000,31000,5,450,-1.43,58.55,39633,23205,-16428,2764,1097,-1667,63598,30950,31000,30950,22,1,1,1701,5818,1,21
134600,020000,31000,5,450,-1.43,58.37,39786,23225,-16561,2773,1098,-1675,63771,30950,31000,30950,195,10,2,1728,5675,154,41
134700,020000,31000,5,450,-1.43,58.34,39813,23226,-16587,2776,1099,-1677,63799,30950,31000,30950,27,2,1,1724,5748,26,1
134700,020000,30950,5,500,-1.59,58.19,39973,23261,-16712,2783,1102,-1681,63994,30950,31000,30950,222,9,4,1695,5701,186,36
134800,020000,30950,5,500,-1.59,57.87,40225,23278,-16947,2792,1103,-1689,64263,30950,31000,30950,236,8,1,1692,5655,219,17
134900,020000,31000,5,450,-1.43,57.9,40238,23297,-16941,2795,1104,-1691,64295,31000,31000,31000,0,0,0,1699,5853,0,0
134900,020000,30950,5,500,-1.59,57.78,40321,23297,-17024,2801,1104,-1697,64378,30950,30950,30950,83,6,0,1841,5931,83,0
135000,020000,30950,5,500,-1.59,57.76,40358,23309,-17049,2806,1106,-1700,64427,30950,31000,30950,24,3,2,1837,5900,12,12
135100,020000,30950,5,500,-1.59,57.73,40434,23344,-17090,2811,1109,-1702,64538,31000,31000,30950,42,2,2,1846,5927,20,22
135100,020000,30950,5,500,-1.59,57.68,40474,23344,-17130,2817,1109,-1708,64578,31000,31000,30950,82,8,2,1853,5893,60,22
135200,020000,31000,5,450,-1.43,57.77,40502,23397,-17105,2822,1112,-1710,64659,30950,31000,30950,38,2,2,1875,5942,3,35
135200,020000,30950,5,500,-1.59,57.77,40629,23471,-17158,2829,1115,-1714,64860,30950,31000,30950,239,9,5,1753,5984,130,109
135300,020000,31000,5,450,-1.43,58.01,40641,23576,-17065,2832,1119,-1713,64977,31000,31000,30950,117,3,4,1759,5942,12,105
135400,020000,30950,5,500,-1.59,58.36,40734,23774,-16960,2838,1128,-1710,65268,30950,31000,30950,107,3,1,1555,5865,90,17
135400,020000,30950,5,500,-1.59,58.28,40797,23776,-17021,2842,1130,-1712,65333,30950,31000,30950,172,7,3,1634,5753,153,19
135500,020000,31000,5,450,-1.43,58.54,40834,23906,-16928,2847,1138,-1709,65500,30950,31000,30950,128,3,5,1564,5753,26,102
135600,020000,30950,5,500,-1.59,58.48,40879,23906,-16973,2850,1138,-1712,65545,30950,30950,30950,0,0,0,1550,5670,0,0
135600,020000,31000,5,450,-1.43,58.5,40925,23941,-16984,2856,1142,-1714,65626,30950,31000,30950,81,6,4,1798,4318,46,35
135700,020000,31000,5,450,-1.43,58.46,40990,23961,-17029,2863,1143,-1720,65711,31000,31000,31000,43,2,0,1840,4237,43,0
135700,020000,31000,5,450,-1.43,58.42,41038,23975,-17063,2870,1145,-1725,65773,31000,31000,30950,105,9,2,1664,5809,91,14
135800,020000,30950,5,500,-1.59,58.31,41119,23976,-17143,2874,1146,-1728,65855,30950,31000,30950,72,3,1,1666,6774,71,1
135900,020000,31000,5,450,-1.43,58.25,41199,23997,-17202,2881,1148,-1733,65956,30950,31000,30950,34,1,1,1721,7199,33,1
135900,020000,30950,5,500,-1.59,58.3,41211,24024,-17187,2884,1150,-1734,65995,30950,31000,30950,73,4,3,1700,7217,45,28
140000,020000,31000,5,450,-1.43,58.26,41273,24045,-17228,2890,1152,-1738,66078,30950,31000,30950,81,5,1,1737,7268,61,20
140100,020000,30950,5,500,-1.59,58.21,41304,24045,-17259,2894,1152,-1742,66109,30950,30950,30950,1,1,0,1790,7268,1,0
140100,020000,30950,5,500,-1.59,58.22,41335,24067,-17268,2899,1154,-1745,66162,30950,31000,30950,54,6,2,1788,7338,32,22
140200,020000,30950,5,500,-1.59,58.1,41443,24080,-17363,2903,1156,-1747,66283,31000,31000,30950,77,2,1,1789,7419,65,12
140200,020000,30950,5,500,-1.59,58.08,41493,24101,-17392,2909,1157,-1752,66354,31000,31000,30950,148,8,2,1769,7663,115,33
140300,020000,30950,5,500,-1.59,57.99,41590,24119,-17471,2914,1158,-1756,66469,30950,31000,30950,115,5,1,1783,7566,97,18
140400,020000,30950,5,500,-1.59,57.97,41605,24119,-17486,2919,1158,-1761,66484,30950,30950,30950,2,2,0,1790,7583,2,0
140400,020000,31000,5,450,-1.43,57.88,41737,24157,-17580,2938,1160,-1778,66654,30950,31000,30950,172,21,2,1703,7726,134,38
140500,020000,30950,5,500,-1.59,57.89,41754,24171,-17583,2945,1162,-1783,66685,30900,31000,30900,29,6,1,1682,7736,16,13
140600,020000,30950,5,500,-1.59,57.86,41783,24174,-17609,2951,1163,-1788,66717,30950,30950,30950,0,0,0,1700,7718,0,0
140600,020000,30950,5,500,-1.59,57.77,41867,24187,-17680,2964,1166,-1798,66814,30950,31000,30950,97,13,3,1700,7600,84,13
140700,020000,30900,5,550,-1.75,57.75,41884,24190,-17694,2972,1167,-1805,66834,30900,30900,30900,2,2,0,1703,7922,2,0
140700,020000,30950,5,500,-1.59,57.78,42006,24272,-17734,2980,1170,-1810,67038,30900,30950,30900,206,10,3,1430,7790,124,82
140800,020000,30950,5,500,-1.59,57.8,42033,24297,-17736,2985,1174,-1811,67090,30950,30950,30900,52,5,4,1390,7727,27,25
140900,020000,30900,5,550,-1.75,57.75,42108,24316,-17792,2992,1176,-1816,67184,30900,30950,30900,91,5,1,1496,7610,73,18
140900,020000,30900,5,550,-1.75,57.7,42145,24316,-17829,2995,1176,-1819,67221,30900,30950,30900,128,8,1,1492,7611,110,18
141000,020000,30950,5,500,-1.59,57.71,42175,24338,-17837,3000,1178,-1822,67273,30900,30950,30900,49,3,2,1444,7683,27,22
141100,020000,30950,5,500,-1.59,58.02,42263,24522,-17741,3005,1183,-1822,67545,30950,30950,30950,0,0,0,1465,7596,0,0
141100,020000,30950,5,500,-1.59,58.56,42290,24767,-17523,3010,1188,-1822,67817,30900,30950,30900,272,5,5,1246,7628,27,245
141200,020000,30900,5,550,-1.75,58.55,42303,24768,-17535,3013,1189,-1824,67831,30900,30950,30900,14,3,1,1251,7655,13,1
141200,020000,30900,5,550,-1.75,58.59,42308,24789,-17519,3017,1191,-1826,67857,30900,30950,30900,40,7,3,1304,7655,18,22
141300,020000,30950,5,500,-1.59,58.62,42322,24809,-17513,3021,1192,-1829,67891,30900,30950,30900,34,4,1,1349,7662,14,20
141400,020000,30950,5,500,-1.59,58.89,42402,24969,-17433,3028,1197,-1831,68131,30950,30950,30950,67,3,0,1555,7549,67,0
141400,020000,30950,5,500,-1.59,58.87,42417,24969,-17448,3033,1197,-1836,68146,30950,30950,30950,82,8,0,1574,6847,82,0
141500,020000,31000,5,450,-1.43,58.94,42596,25108,-17488,3039,1201,-1838,68464,30950,31000,30950,318,6,4,1759,4955,179,139
141600,020000,30950,5,500,-1.59,58.98,42611,25131,-17480,3044,1204,-1840,68502,30950,30950,30950,13,3,0,1629,7052,13,0
141600,020000,30950,5,500,-1.59,58.72,42831,25151,-17680,3053,1207,-1846,68742,30950,30950,30900,253,12,3,1617,7020,233,20
141700,020000,30900,5,550,-1.75,58.66,42893,25162,-17731,3061,1208,-1853,68815,30900,30950,30900,72,7,1,1596,6990,61,11
141800,020000,30950,5,500,-1.59,58.66,42924,25180,-17744,3065,1209,-1856,68864,30900,30950,30900,19,1,1,1628,6961,1,18
141800,020000,30950,5,500,-1.59,58.71,42963,25225,-17738,3070,1214,-1856,68948,30900,30950,30900,103,6,6,1578,6944,40,63
141900,020000,30950,5,500,-1.59,59.33,42977,25499,-17478,3074,1220,-1854,69236,30950,31000,30950,25,2,2,1726,6830,11,14
141900,020000,30950,5,500,-1.59,59.33,43004,25513,-17491,3078,1222,-1856,69277,30950,31000,30950,66,6,4,1740,6779,38,28
142000,020000,30950,5,500,-1.59,59.32,43042,25533,-17509,3083,1223,-1860,69335,30950,31000,30950,58,5,1,1662,6853,38,20
142100,020000,30950,5,500,-1.59,59.43,43075,25600,-17475,3089,1227,-1862,69435,30950,30950,30950,3,3,0,1635,6829,3,0
142100,020000,31000,5,450,-1.43,59.41,43121,25619,-17502,3094,1228,-1866,69500,30950,31000,30950,68,8,1,1684,6839,49,19
142200,020000,30950,5,500,-1.59,59.54,43149,25691,-17458,3099,1229,-1870,69600,30950,30950,30950,28,5,0,1667,6824,28,0
142300,020000,30950,5,500,-1.59,59.57,43186,25726,-17460,3103,1233,-1870,69672,30950,30950,30950,0,0,0,1638,6924,0,0
142300,020000,30950,5,500,-1.59,59.55,43235,25747,-17488,3110,1234,-1876,69742,30950,31000,30950,70,7,1,1654,6927,49,21
142400,020000,30950,5,500,-1.59,59.26,43458,25752,-17706,3131,1235,-1896,69970,30950,31000,30950,140,20,1,1632,6789,135,5
142400,020000,30950,5,500,-1.59,59.25,43587,25826,-17761,3138,1237,-1901,70173,30950,31000,30900,343,27,3,1384,6965,264,79
142500,020000,30950,5,500,-1.59,59.29,43634,25872,-17762,3144,1240,-1904,70266,30900,30950,30900,93,6,3,1347,6981,47,46
142600,020000,30950,5,500,-1.59,59.47,43672,25972,-17700,3149,1249,-1900,70404,30900,30950,30900,3,1,1,1366,6946,1,2
142600,020000,30950,5,500,-1.59,59.6,43683,26036,-17647,3151,1250,-1901,70479,30900,30950,30900,78,3,2,1395,6964,12,66
142700,020000,30950,5,500,-1.59,59.6,43715,26054,-17661,3155,1251,-1904,70529,30900,30950,30900,50,4,1,1387,6943,32,18
142800,020000,30950,5,500,-1.59,59.67,43824,26148,-17676,3162,1254,-1908,70732,30950,30950,30950,0,0,0,1284,6860,0,0
142800,020000,30950,5,500,-1.59,60.08,43847,26344,-17503,3169,1262,-1907,70951,30900,30950,30900,219,7,8,1512,6677,23,196
142900,020000,30950,5,500,-1.59,60.14,43859,26378,-17481,3172,1264,-1908,70997,30900,30950,30900,35,1,2,1153,6858,1,34
142900,020000,30950,5,500,-1.59,60.13,43871,26379,-17492,3175,1265,-1910,71010,30900,30950,30900,48,4,3,1520,6876,13,35
143000,020000,30950,5,500,-1.59,60.39,43898,26511,-17387,3179,1271,-1908,71169,30950,30950,30900,159,4,6,1888,6479,27,132
143100,020000,30900,5,550,-1.75,60.34,43967,26530,-17437,3187,1272,-1915,71257,30900,30900,30900,11,2,0,1911,6698,11,0
143100,020000,31000,5,450,-1.43,60.47,43968,26587,-17381,3188,1276,-1912,71315,30900,31000,30900,69,3,4,1940,6696,12,57
143200,020000,31000,5,450,-1.43,60.59,43981,26650,-17331,3192,1282,-1910,71391,30950,31000,30900,66,3,6,2030,6744,3,63
143300,020000,30950,5,500,-1.59,60.58,43994,26650,-17344,3195,1282,-1913,71404,30950,30950,30950,0,0,0,2108,6785,0,0
143300,020000,30950,5,500,-1.59,60.54,44057,26672,-17385,3209,1285,-1924,71489,31000,31000,30950,85,14,3,2164,6736,63,22
143400,020000,30950,5,500,-1.59,60.42,44206,26708,-17498,3220,1288,-1932,71674,30950,31000,30950,53,4,2,2139,6706,36,17
143400,020000,30900,5,550,-1.75,60.41,44261,26739,-17522,3228,1292,-1936,71760,30950,31000,30900,139,12,6,1814,6910,91,48
143500,020000,30950,5,500,-1.59,60.45,44263,26758,-17505,3230,1294,-1936,71781,30900,30950,30900,21,2,2,1880,6962,2,19
143600,020000,30900,5,550,-1.75,60.42,44322,26779,-17543,3241,1295,-1946,71861,30900,30950,30900,65,5,1,1919,6976,44,21
143600,020000,30950,5,500,-1.59,60.45,44336,26802,-17534,3246,1297,-1949,71898,30900,30950,30900,102,10,3,1942,7061,58,44
143700,020000,30950,5,500,-1.59,60.94,44369,27039,-17330,3251,1304,-1947,72168,30950,30950,30900,269,4,7,1729,7080,32,237
143800,020000,30900,5,550,-1.75,60.98,44382,27063,-17319,3254,1305,-1949,72205,30900,30900,30900,0,0,0,1753,7080,0,0
143800,020000,30950,5,500,-1.59,61.12,44429,27157,-17272,3260,1307,-1953,72346,30900,30950,30900,141,6,2,2116,7034,47,94
143900,020000,30950,5,500,-1.59,61.15,44447,27178,-17269,3264,1308,-1956,72385,30950,31000,30950,23,2,1,2125,7011,2,21
143900,020000,30950,5,500,-1.59,61.09,44491,27179,-17312,3270,1309,-1961,72430,30950,31000,30950,68,8,2,2212,7070,46,22
144000,020000,30950,5,500,-1.59,61.12,44522,27213,-17309,3274,1313,-1961,72495,30950,31000,30950,65,4,4,2270,7105,31,34
144100,020000,30950,5,500,-1.59,61.12,44559,27234,-17325,3279,1314,-1965,72553,30950,30950,30950,1,1,0,2269,7128,1,0
144100,020000,31000,5,450,-1.43,61.04,44654,27258,-17396,3285,1316,-1969,72672,30950,31000,30950,120,7,2,2271,7105,96,24
144200,020000,30950,5,500,-1.59,60.75,44887,27268,-17619,3292,1317,-1975,72915,30950,30950,30950,233,7,0,2274,6947,233,0
144300,020000,30950,5,500,-1.59,60.72,44944,27288,-17656,3298,1318,-1980,72992,30950,30950,30950,1,1,0,2291,6891,1,0
144300,020000,30950,5,500,-1.59,60.74,44983,27323,-17660,3304,1321,-1983,73066,30950,31000,30950,75,7,3,2305,6864,40,35
144400,020000,31000,5,450,-1.43,60.74,45016,27344,-17672,3309,1323,-1986,73120,30950,31000,30950,23,3,1,2309,6947,4,19
144400,020000,30950,5,500,-1.59,60.63,45264,27445,-17819,3327,1326,-2001,73469,30950,31000,30900,372,21,4,1815,7009,252,120
144500,020000,30950,5,500,-1.59,60.63,45302,27466,-17836,3332,1327,-2005,73528,30900,30950,30900,58,4,1,1874,7006,37,21
144600,020000,30950,5,500,-1.59,60.65,45305,27479,-17826,3334,1329,-2005,73544,30950,30950,30900,14,1,2,1882,6980,1,13
144600,020000,30950,5,500,-1.59,60.6,45375,27497,-17878,3339,1330,-2009,73632,30950,30950,30900,102,6,3,1929,6966,71,31
144700,020000,30950,5,500,-1.59,60.67,45464,27582,-17882,3346,1333,-2013,73806,30900,30950,30900,173,6,3,1843,6856,88,85
144800,020000,30950,5,500,-1.59,60.86,45541,27714,-17827,3352,1336,-2016,74015,30950,30950,30950,0,0,0,1730,6883,0,0
144800,020000,30900,5,550,-1.75,60.85,45577,27734,-17843,3359,1337,-2022,74071,30950,30950,30900,56,7,1,1640,6870,36,20
144900,020000,30950,5,500,-1.59,60.93,45578,27770,-17808,3360,1341,-2019,74108,30950,30950,30900,15,1,2,1680,6861,1,14
144900,020000,31050,5,400,-1.27,62.5,45659,28537,-17122,3367,1351,-2016,74956,30950,31050,30900,863,8,12,1585,5231,82,781
145000,020000,31050,5,400,-1.27,62.45,45696,28537,-17159,3373,1351,-2022,74993,31050,31050,31050,36,5,0,1656,5159,36,0
145100,020000,31050,5,400,-1.27,62.06,45985,28539,-17446,3384,1353,-2031,75284,31050,31050,31050,66,3,0,1754,5105,66,0
145100,020000,31100,5,350,-1.11,62.37,45997,28687,-17310,3387,1356,-2031,75444,31050,31100,31050,226,6,3,1677,5083,78,148
145200,020000,31050,5,400,-1.27,62.38,46014,28703,-17311,3393,1359,-2034,75477,31050,31050,31050,15,5,0,1665,5100,15,0
145300,020000,31050,5,400,-1.27,62.1,46224,28703,-17521,3400,1359,-2041,75687,31050,31050,31050,0,0,0,1744,5018,0,0
145300,020000,31050,5,400,-1.27,62.08,46238,28706,-17532,3405,1360,-2045,75704,31000,31050,31000,17,5,1,1683,5196,14,3
145400,020000,31000,5,450,-1.43,61.93,46368,28717,-17651,3414,1363,-2051,75845,30950,31000,30950,48,2,1,1519,7003,46,2
145500,020000,30950,5,500,-1.59,61.98,46386,28752,-17634,3420,1366,-2054,75898,30950,30950,30950,1,1,0,1620,7045,1,0
145500,020000,30950,5,500,-1.59,61.91,46474,28773,-17701,3428,1367,-2061,76007,30950,31000,30950,110,9,1,1646,6960,89,21
145600,020000,31000,5,450,-1.43,61.91,46486,28779,-17707,3431,1369,-2062,76025,30950,31000,30950,12,1,1,1671,7116,10,2
145600,020000,30950,5,500,-1.59,61.94,46498,28802,-17696,3434,1371,-2063,76060,30950,31000,30950,47,4,3,1678,7108,22,25
145700,020000,30950,5,500,-1.59,61.89,46534,28802,-17732,3438,1371,-2067,76096,30950,30950,30950,35,3,0,1733,7055,35,0
145800,020000,30950,5,500,-1.59,62.32,46592,29035,-17557,3447,1379,-2068,76387,30950,31000,30950,234,4,4,1364,6979,36,198
145800,020000,30950,5,500,-1.59,62.26,46636,29035,-17601,3450,1379,-2071,76431,30950,31000,30950,278,7,4,1437,6968,80,198
145900,020000,30950,5,500,-1.59,62.33,46652,29079,-17573,3456,1381,-2075,76491,30950,31000,30950,57,4,2,1415,6943,13,44
150000,020000,30950,5,500,-1.59,62.31,46671,29079,-17592,3460,1381,-2079,76510,30950,30950,30950,1,1,0,1494,6957,1,0
150000,020000,30950,5,500,-1.59,62.26,46746,29102,-17644,3466,1383,-2083,76608,30950,31000,30950,99,7,2,1432,6886,76,23
150100,020000,31000,5,450,-1.43,62.42,46760,29188,-17572,3467,1390,-2077,76708,31000,31000,31000,48,0,2,1392,6944,0,48
150100,020000,31000,5,450,-1.43,62.52,46787,29249,-17538,3473,1394,-2079,76796,31000,31050,31000,136,6,6,1715,5071,27,109
150200,020000,31050,5,400,-1.27,63.01,46820,29502,-17318,3478,1402,-2076,77082,31000,31050,31000,286,5,8,1677,4956,33,253
150300,020000,31050,5,400,-1.27,63.0,46835,29506,-17329,3483,1403,-2080,77101,31050,31050,31050,2,1,0,2109,4993,2,0
150300,020000,31100,5,350,-1.11,62.95,46893,29519,-17374,3487,1405,-2082,77172,31050,31100,31050,73,5,2,2162,5061,60,13
150400,020000,31050,5,400,-1.27,62.94,46899,29519,-17380,3490,1405,-2085,77178,31050,31050,31050,6,3,0,2132,5021,6,0
150400,020000,31100,5,350,-1.11,62.94,46917,29529,-17388,3493,1407,-2086,77206,31050,31100,31050,34,6,2,1847,4918,24,10
150500,020000,31050,5,400,-1.27,62.93,46928,29533,-17395,3495,1408,-2087,77221,31050,31100,31050,15,2,1,1932,5201,11,4
150600,020000,31050,5,400,-1.27,62.88,46970,29533,-17437,3498,1408,-2090,77263,31050,31050,31050,0,0,0,1934,5303,0,0
150600,020000,31050,5,400,-1.27,62.78,47066,29548,-17518,3505,1410,-2095,77374,31050,31100,31050,111,7,2,1932,5183,96,15
150700,020000,31050,5,400,-1.27,62.75,47085,29548,-17537,3511,1410,-2101,77393,31050,31050,31050,1,1,0,1949,5211,1,0
150800,020000,31050,5,400,-1.27,62.7,47133,29552,-17581,3517,1411,-2106,77445,31050,31050,31050,3,2,0,1965,5411,3,0
150800,020000,31100,5,350,-1.11,62.69,47143,29555,-17588,3518,1413,-2105,77458,31050,31100,31050,16,3,2,1991,5402,13,3
150900,020000,31050,5,400,-1.27,62.77,47210,29635,-17575,3523,1414,-2109,77605,31050,31050,31050,57,4,0,1978,5285,57,0
150900,020000,31050,5,400,-1.27,62.79,47222,29649,-17573,3526,1416,-2110,77631,31050,31100,31050,83,7,2,1995,5381,69,14
151000,020000,31050,5,400,-1.27,62.75,47252,29649,-17603,3533,1416,-2117,77661,31050,31050,31050,30,7,0,2026,5489,30,0
151100,020000,31050,5,400,-1.27,62.74,47263,29652,-17611,3535,1417,-2118,77675,31050,31050,31050,10,1,0,1947,5563,10,0
151100,020000,31050,5,400,-1.27,62.73,47272,29652,-17620,3537,1417,-2120,77684,31050,31050,31050,19,3,0,2006,5546,19,0
151200,020000,31100,5,350,-1.11,63.04,47331,29838,-17493,3542,1425,-2117,77929,31050,31100,31050,218,2,7,1964,5429,34,184
151300,020000,31050,5,400,-1.27,63.11,47378,29901,-17477,3545,1426,-2119,78039,31050,31050,31050,35,1,0,1840,5417,35,0
151300,020000,31050,5,400,-1.27,63.09,47398,29902,-17496,3549,1427,-2122,78060,31050,31100,31050,56,5,1,1868,5386,55,1
151400,020000,31050,5,400,-1.27,63.0,47487,29916,-17571,3562,1428,-2134,78163,31050,31100,31050,36,11,1,1823,5573,22,14
151500,020000,31050,5,400,-1.27,62.96,47515,29916,-17599,3567,1428,-2139,78191,31050,31050,31050,0,0,0,1852,5668,0,0
151500,020000,31050,5,400,-1.27,62.92,47578,29934,-17644,3571,1432,-2139,78272,31100,31100,31050,81,4,4,1849,5624,63,18
151600,020000,31100,5,350,-1.11,62.91,47593,29943,-17650,3575,1433,-2142,78296,31050,31100,31050,21,3,1,1858,5570,12,9
151600,020000,31050,5,400,-1.27,63.0,47607,29992,-17615,3579,1434,-2145,78359,31050,31100,31050,84,7,2,1779,5565,26,58
151700,020000,31050,5,400,-1.27,62.95,47703,30027,-17676,3586,1441,-2145,78490,31050,31100,31050,131,7,7,1735,6337,96,35
151800,020000,31150,5,300,-0.95,63.93,47744,30521,-17223,3591,1445,-2146,79025,31150,31150,31150,1,1,0,1354,5706,1,0
151800,020000,31200,5,250,-0.79,63.97,47758,30550,-17208,3594,1450,-2144,79068,31150,31200,31150,44,4,5,1917,5727,15,29
151900,020000,31250,5,200,-0.64,63.91,48220,30819,-17401,3600,1461,-2139,79799,31200,31300,31150,697,6,9,2023,4476,462,235
152000,020000,31150,5,300,-0.95,64.51,48515,31299,-17216,3607,1467,-2140,80574,31150,31150,31150,11,1,0,1620,5399,11,0
152000,020000,31300,5,150,-0.48,64.6,48515,31342,-17173,3607,1471,-2136,80617,31150,31350,31150,54,1,4,2876,5180,11,43
152000,020000,31250,5,200,-0.64,64.58,48534,31342,-17192,3608,1471,-2137,80636,31150,31350,31150,73,2,4,3220,5177,30,43
152000,020000,31250,5,200,-0.64,64.58,48534,31342,-17192,3608,1471,-2137,80636,31150,31350,31150,73,2,4,3220,5177,30,43
152000,020000,31250,5,200,-0.64,64.58,48534,31342,-17192,3608,1471,-2137,80636,31150,31350,31150,73,2,4,3220,5177,30,43
152000,020000,31250,5,200,-0.64,64.58,48534,31342,-17192,3608,1471,-2137,80636,31150,31350,31150,73,2,4,3220,5177,30,43
152000,020000,31250,5,200,-0.64,64.58,48534,31342,-17192,3608,1471,-2137,80636,31150,31350,31150,73,2,4,3220,5177,30,43
152000,020000,31250,5,200,-0.64,64.58,48534,31342,-17192,3608,1471,-2137,80636,31150,31350,31150,73,2,4,3220,5177,30,43
152000,020000,31250,5,200,-0.64,64.58,48534,31342,-17192,3608,1471,-2137,80636,31150,31350,31150,73,2,4,3220,5177,30,43
152000,020000,31250,5,200,-0.64,64.58,48534,31342,-17192,3608,1471,-2137,80636,31150,31350,31150,73,2,4,3220,5177,30,43
152000,020000,31250,5,200,-0.64,64.58,48534,31342,-17192,3608,1471,-2137,80636,31150,31350,31150,73,2,4,3220,5177,30,43
152000,020000,31250,5,200,-0.64,64.58,48534,31342,-17192,3608,1471,-2137,80636,31150,31350,31150,73,2,4,3220,5177,30,43
152000,020000,31250,5,200,-0.64,64.58,48534,31342,-17192,3608,1471,-2137,80636,31150,31350,31150,73,2,4,3220,5177,30,43
152000,020000,31250,5,200,-0.64,64.58,48534,31342,-17192,3608,1471,-2137,80636,31150,31350,31150,73,2,4,3220,5177,30,43
152000,020000,31250,5,200,-0.64,64.58,48534,31342,-17192,3608,1471,-2137,80636,31150,31350,31150,73,2,4,3220,5177,30,43
152000,020000,31250,5,200,-0.64,64.58,48534,31342,-17192,3608,1471,-2137,80636,31150,31350,31150,73,2,4,3220,5177,30,43
152000,020000,31250,5,200,-0.64,64.58,48534,31342,-17192,3608,1471,-2137,80636,31150,31350,31150,73,2,4,3220,5177,30,43
152000,020000,31250,5,200,-0.64,64.58,48534,31342,-17192,3608,1471,-2137,80636,31150,31350,31150,73,2,4,3220,5177,30,43
152000,020000,31250,5,200,-0.64,64.58,48534,31342,-17192,3608,1471,-2137,80636,31150,31350,31150,73,2,4,3220,5177,30,43
153000,020000,31150,5,300,-0.95,64.58,48534,31342,-17192,3608,1471,-2137,84880,31150,31150,31150,4244,0,0,3220,5157,0,0
153000,020000,31150,5,300,-0.95,64.58,48534,31342,-17192,3608,1471,-2137,84880,31150,31150,31150,4244,0,0,3220,5157,0,0
