090200,007700,113000,2,2500,2.26,228.89,893,2044,1151,53,44,-9,5331,113500,114000,112500,156,7,7,4977,3135,102,54
090200,007700,113000,2,2500,2.26,148.61,1689,2510,821,68,51,-17,6593,113500,114000,112000,1418,22,14,4869,3286,898,520
090300,007700,113000,2,2500,2.26,120.37,2155,2594,439,86,55,-31,7143,113000,113500,113000,434,15,3,9599,3595,415,19
090400,007700,113000,2,2500,2.26,128.61,2443,3142,699,95,63,-32,7979,113000,113000,113000,0,0,0,7373,3861,0,0
090400,007700,114000,2,3500,3.17,154.27,2637,4068,1431,101,81,-20,9099,113000,114000,112500,1120,6,18,9718,4620,194,926
090500,007700,114000,2,3500,3.17,138.39,3037,4203,1166,114,88,-26,9634,113500,114000,113500,413,9,2,9606,4772,357,56
090600,007700,113000,2,2500,2.26,100.96,4180,4220,40,132,90,-42,10794,113000,113000,113000,52,1,0,8976,5484,52,0
090600,007700,113000,2,2500,2.26,96.89,4412,4275,-137,141,94,-47,11081,113000,113500,113000,339,10,4,10288,5152,284,55
090700,007700,113000,2,2500,2.26,98.07,4814,4721,-93,149,101,-48,11929,113000,113500,113000,841,7,6,11438,4832,401,440
090800,007700,113000,2,2500,2.26,75.78,6372,4829,-1543,165,104,-61,13595,113000,113000,112500,577,9,1,13177,3990,575,2
090800,007700,112500,2,2000,1.81,74.38,6525,4853,-1672,172,107,-65,13772,113000,113000,112500,754,16,4,13763,3866,728,26
090900,007700,112500,2,2000,1.81,70.93,6876,4877,-1999,179,111,-68,14147,112500,113000,112500,349,5,3,14151,5343,332,17
091000,007700,113000,2,2500,2.26,72.45,7001,5072,-1929,185,114,-71,14467,113000,113000,113000,169,0,1,14357,4926,0,169
091000,007700,112500,2,2000,1.81,72.38,7048,5101,-1947,191,118,-73,14543,113000,113000,112500,245,6,5,14400,5082,47,198
091100,007700,112500,2,2000,1.81,72.05,7164,5162,-2002,197,121,-76,14720,113000,113000,112500,160,4,2,14486,5541,105,55
091100,007700,113000,2,2500,2.26,72.27,7327,5295,-2032,224,128,-96,15016,113000,113000,112500,456,31,9,14450,5472,268,188
091200,007700,113500,2,3000,2.71,75.72,7540,5709,-1831,240,137,-103,15643,112500,113500,112500,615,15,9,14726,4933,201,414
091300,007700,113500,2,3000,2.71,80.73,7619,6151,-1468,246,151,-95,16164,113500,113500,113000,373,1,11,14538,6107,1,372
091300,007700,114000,2,3500,3.17,88.41,7733,6837,-896,255,161,-94,16964,113500,114000,113000,1173,10,21,14826,5454,115,1058
091400,007700,113000,2,2500,2.26,93.29,7941,7408,-533,268,167,-101,17743,114000,114000,113000,732,11,4,14112,5596,188,544
091500,007700,113000,2,2500,2.26,82.85,8960,7423,-1537,295,170,-125,18777,113000,113500,113000,1025,25,2,15553,8548,1011,14
091600,007700,113000,2,2500,2.26,91.6,9587,8782,-805,308,177,-131,20763,113000,114000,113000,1938,9,7,14436,7498,579,1359
091700,007700,113000,2,2500,2.26,90.56,9703,8787,-916,321,178,-143,20884,113000,113000,113000,21,3,0,14550,7460,21,0
091700,007700,113000,2,2500,2.26,88.92,9895,8799,-1096,334,180,-154,21088,113000,113500,113000,225,16,2,14476,7608,213,12
091800,007700,113500,2,3000,2.71,89.57,9980,8939,-1041,346,185,-161,21313,113000,113500,112500,197,10,5,14753,7659,57,140
091900,007700,113000,2,2500,2.26,88.1,10183,8971,-1212,357,192,-165,21548,113000,113500,112500,184,8,6,14776,7680,154,30
092000,007700,113000,2,2500,2.26,88.24,10234,9030,-1204,365,196,-169,21658,113000,113000,113000,0,0,0,15160,7652,0,0
092000,007700,112500,2,2000,1.81,87.11,10372,9035,-1337,373,197,-176,21801,113000,113000,112500,143,8,1,15153,7717,138,5
092100,007700,112500,2,2000,1.81,85.87,10522,9035,-1487,385,197,-188,21951,112500,112500,112500,4,2,0,15168,7722,4,0
092100,007700,112000,2,1500,1.36,76.88,11766,9046,-2720,402,200,-202,23206,112500,113000,112000,1259,19,3,15282,6798,1248,11
092200,007700,111500,2,1000,0.9,73.77,12359,9117,-3242,412,208,-204,23870,111500,112000,111500,641,9,8,16368,6094,570,71
092300,007700,111500,2,1000,0.9,74.14,12562,9313,-3249,426,215,-211,24269,111000,111500,111000,285,5,2,16264,6072,113,172
092300,007700,112000,2,1500,1.36,73.07,12759,9323,-3436,445,218,-227,24476,111000,112000,111000,492,24,5,16293,7118,310,182
092400,007700,111500,2,1000,0.9,71.21,13093,9323,-3770,457,218,-239,24810,111500,111500,111500,334,12,0,17148,7084,334,0
092500,007700,111000,2,500,0.45,66.55,14011,9324,-4687,471,219,-252,25729,111500,111500,111000,816,7,0,16920,4017,816,0
092500,007700,111500,2,1000,0.9,66.53,14157,9418,-4739,478,231,-247,25969,111500,111500,111000,1056,14,12,16276,3614,962,94
092600,007700,110500,3,0,0.0,65.55,14522,9519,-5003,491,234,-257,26435,111000,111500,110500,367,8,2,13239,4241,271,96
092700,007700,110500,3,0,0.0,63.73,14967,9538,-5429,512,238,-274,26899,110500,110500,110500,0,0,0,13345,3962,0,0
092800,007700,110500,3,0,0.0,63.12,15253,9627,-5626,539,244,-295,27274,110500,110500,110500,0,0,0,13458,3875,0,0
092800,007700,110500,3,0,0.0,62.55,15493,9691,-5802,552,257,-295,27578,110000,110500,110000,304,13,13,13534,4058,240,64
092900,007700,110000,5,500,-0.45,61.74,15723,9707,-6016,562,261,-301,27824,110500,110500,110000,156,5,3,11230,4030,144,12
092900,007700,110000,5,500,-0.45,60.44,16094,9727,-6367,582,262,-320,28215,110500,110500,110000,547,25,4,11178,4100,515,32
093000,007700,110500,3,0,0.0,60.1,16207,9740,-6467,590,266,-324,28341,110500,110500,110000,126,8,4,11257,4020,113,13
093100,007700,109500,5,1000,-0.9,59.34,16476,9777,-6699,605,272,-333,28647,110000,110000,109500,113,6,2,8960,6545,98,15
093100,007700,110000,5,500,-0.45,59.43,16592,9861,-6731,613,282,-331,28847,110000,110500,109500,313,14,12,8875,6426,214,99
093200,007700,110000,5,500,-0.45,59.52,16668,9920,-6748,630,289,-341,28982,110000,110500,110000,100,15,3,11348,4422,72,28
093300,007700,110500,3,0,0.0,59.83,16723,10005,-6718,635,292,-343,29122,110000,110500,110000,88,1,1,11338,4400,13,75
093400,007700,110500,3,0,0.0,59.66,16833,10042,-6791,647,298,-349,29269,110500,111000,110500,7,3,1,13586,5441,6,1
093400,007700,110500,3,0,0.0,59.48,16959,10087,-6872,657,309,-348,29440,110500,111500,110500,178,13,12,16609,5487,132,46
093500,007700,110500,3,0,0.0,59.32,17006,10088,-6918,666,310,-356,29488,110500,110500,110500,47,9,0,13676,5531,47,0
093600,007700,111000,2,500,0.45,59.24,17085,10122,-6963,674,317,-357,29601,111000,111000,111000,18,0,2,13691,5521,0,18
093600,007700,111000,2,500,0.45,59.13,17164,10149,-7015,684,323,-361,29707,111000,111500,110500,124,10,8,13688,5412,79,45
093700,007700,111500,2,1000,0.9,59.38,17184,10203,-6981,686,331,-355,29782,111500,111500,111000,26,0,3,16704,5801,0,25
093700,007700,111000,2,500,0.45,59.35,17296,10265,-7031,693,340,-353,29956,111500,111500,110500,200,7,12,13943,6315,112,87
093800,007700,110500,3,0,0.0,58.37,17587,10266,-7321,708,341,-367,30248,110500,111000,110500,55,7,1,13770,6091,54,1
093900,007700,110500,3,0,0.0,57.88,17740,10268,-7472,720,343,-377,30403,110500,111000,110500,62,6,2,13828,5988,60,2
093900,007700,110500,3,0,0.0,57.95,17785,10306,-7479,726,348,-378,30486,110500,111000,110500,145,12,7,13794,5910,105,40
094000,007700,110500,3,0,0.0,57.84,17873,10337,-7536,740,354,-386,30605,110500,111000,110500,82,4,6,13852,5788,51,31
094100,007700,110500,3,0,0.0,57.69,17956,10358,-7598,747,357,-390,30709,110500,110500,110500,0,0,0,13842,5721,0,0
094100,007700,110500,3,0,0.0,57.37,18064,10364,-7700,758,358,-400,30823,111000,111000,110500,114,11,1,13851,5646,108,6
094200,007700,110500,3,0,0.0,54.69,18957,10367,-8590,767,360,-407,31719,110500,110500,110500,874,5,0,13862,5033,874,0
094200,007700,110500,3,0,0.0,54.49,19126,10422,-8704,778,366,-412,31943,110500,111000,110500,1098,16,6,13717,4360,1043,55
094300,007700,111000,2,500,0.45,54.52,19190,10463,-8727,784,374,-410,32048,110500,111000,110500,105,6,8,13772,4599,64,41
094400,007700,110500,3,0,0.0,54.56,19258,10508,-8750,787,378,-409,32161,110500,110500,110500,0,0,0,13763,4567,0,0
094400,007700,110500,3,0,0.0,54.52,19308,10527,-8781,792,382,-410,32230,110500,111000,110500,69,5,4,13774,4726,50,19
094500,007700,111000,2,500,0.45,54.49,19380,10560,-8820,804,386,-418,32335,110500,111000,110500,58,4,3,13761,4650,31,27
094500,007700,111000,2,500,0.45,54.42,19470,10596,-8874,818,389,-429,32461,110500,111500,110500,184,18,6,16980,4387,121,63
094600,007700,111500,2,1000,0.9,54.57,19572,10681,-8891,827,397,-430,32648,110500,111500,110500,169,9,6,17063,4228,102,67
094700,007700,110500,3,0,0.0,54.35,19662,10686,-8976,837,400,-437,32743,110500,110500,110500,0,0,0,14126,4931,0,0
094700,007700,110500,3,0,0.0,54.19,19722,10687,-9035,847,401,-446,32804,110500,111000,110500,61,10,1,14149,4912,60,1
094800,007700,111000,2,500,0.45,54.21,19786,10726,-9060,855,406,-449,32907,111000,111000,110500,49,3,4,14067,4831,21,28
094800,007700,110500,3,0,0.0,53.92,19904,10733,-9171,867,408,-459,33032,111000,111000,110500,174,15,6,14121,4736,139,35
094900,007700,110500,3,0,0.0,53.99,19952,10773,-9179,875,415,-460,33120,111000,111000,110500,65,6,5,14112,5330,39,26
094900,007700,110500,3,0,0.0,53.91,20005,10784,-9221,885,417,-468,33184,111000,111000,110500,129,16,7,14145,5533,92,37
095000,007700,110500,3,0,0.0,53.55,20165,10798,-9367,897,419,-478,33358,110500,111000,110500,160,10,2,14011,5376,146,14
095100,007700,110500,3,0,0.0,53.56,20248,10845,-9403,906,426,-480,33488,110500,110500,110500,23,2,0,13972,5477,23,0
095100,007700,110500,3,0,0.0,53.31,20344,10846,-9498,919,427,-492,33585,110500,111000,110500,120,15,1,13960,5483,119,1
095200,007700,110500,3,0,0.0,53.46,20361,10886,-9475,925,436,-489,33642,110500,111000,110500,23,4,3,13975,5597,6,17
095200,007700,110500,3,0,0.0,53.38,20439,10910,-9529,937,441,-496,33744,110500,111000,110500,125,16,8,14006,5576,84,41
095300,007700,111000,2,500,0.45,53.14,20536,10913,-9623,943,444,-499,33844,110500,111000,110500,64,4,3,14014,5717,61,3
095400,007700,110500,3,0,0.0,53.04,20630,10942,-9688,957,448,-509,33967,110500,110500,110500,5,1,0,13984,5759,5,0
095400,007700,111000,2,500,0.45,52.92,20690,10950,-9740,966,453,-513,34035,110500,111000,110500,73,10,5,13977,5671,65,8
095500,007700,110500,3,0,0.0,52.77,20755,10953,-9802,976,454,-522,34103,110500,110500,110500,13,1,0,14000,5673,13,0
095500,007700,111000,2,500,0.45,52.85,20783,10983,-9800,980,460,-520,34161,110500,111000,110500,71,5,6,14011,5654,41,30
095600,007700,110500,3,0,0.0,52.83,20932,11058,-9874,991,463,-528,34385,110500,111000,110500,79,4,2,13918,5503,68,11
095600,007700,110500,3,0,0.0,52.92,20958,11090,-9868,999,468,-531,34443,110500,111500,110500,137,12,7,13940,5539,94,43
095700,007700,110500,3,0,0.0,52.96,21052,11149,-9903,1011,473,-538,34596,111000,111000,110500,153,12,5,14205,5355,94,59
095800,007700,111000,2,500,0.45,52.73,21193,11175,-10018,1021,480,-541,34763,110500,111000,110000,112,3,6,14191,5675,89,23
095800,007700,110000,5,500,-0.45,52.57,21283,11188,-10095,1031,484,-547,34866,110500,111000,110000,215,13,10,12003,5523,179,36
095900,007700,110000,5,500,-0.45,52.57,21367,11233,-10134,1039,492,-547,34995,110500,110500,110000,129,8,8,12069,5581,84,45
100000,007700,110000,5,500,-0.45,52.64,21407,11268,-10139,1050,497,-553,35070,110500,110500,110000,2,1,1,12084,5570,1,1
100000,007700,110000,5,500,-0.45,52.5,21497,11285,-10212,1057,502,-555,35177,110500,110500,110000,109,8,6,12070,5517,91,18
100100,007700,110000,5,500,-0.45,52.51,21564,11323,-10241,1063,511,-552,35282,110500,110500,110000,47,2,6,12083,5461,17,30
100200,007700,110000,5,500,-0.45,52.45,21611,11335,-10276,1068,517,-551,35341,110000,110000,110000,6,1,0,12078,5562,6,0
100200,007700,110500,3,0,0.0,52.71,21639,11405,-10234,1079,528,-551,35439,110000,110500,110000,104,12,11,12137,5574,34,70
100300,007700,110500,3,0,0.0,52.73,21680,11431,-10249,1084,538,-546,35506,110500,110500,110000,46,4,5,12332,5484,31,15
100300,007700,110500,3,0,0.0,52.72,21708,11444,-10264,1087,545,-542,35547,110500,110500,110000,87,7,12,12438,5552,59,28
100400,007700,110500,3,0,0.0,52.82,21748,11487,-10261,1092,554,-538,35630,110500,111000,110000,83,5,9,14691,5428,40,43
100500,007700,111000,2,500,0.45,52.95,21772,11528,-10244,1101,566,-535,35695,110500,111000,110500,35,5,5,14671,5461,7,28
100500,007700,110000,5,500,-0.45,52.9,21821,11543,-10278,1109,573,-536,35759,110500,111000,110000,99,13,12,12404,5656,56,43
100600,007700,111000,2,500,0.45,53.28,21889,11663,-10226,1113,582,-531,35947,111000,111000,110000,132,3,7,14614,6828,15,117
100700,007700,111000,2,500,0.45,53.29,21966,11705,-10261,1117,594,-523,36066,110500,111000,110500,77,1,3,14576,6854,66,11
100700,007700,111000,2,500,0.45,53.87,21986,11843,-10143,1122,608,-514,36224,110500,111000,110500,235,6,17,14480,6865,86,149
100800,007700,110500,3,0,0.0,53.92,22064,11897,-10167,1136,619,-517,36356,110500,111000,110500,60,5,1,14427,6809,57,3
100800,007700,111000,2,500,0.45,54.01,22071,11921,-10150,1139,627,-512,36387,110500,111000,110500,91,8,9,14562,6773,64,27
100900,007700,111000,2,500,0.45,54.08,22082,11942,-10140,1142,636,-506,36419,111000,111000,110500,28,3,8,14672,6770,11,17
100900,007700,110500,3,0,0.0,54.05,22137,11965,-10172,1155,642,-513,36497,111000,111000,110500,106,16,14,14661,6745,66,40
101000,007700,111000,2,500,0.45,54.29,22171,12036,-10135,1162,659,-503,36602,110500,111500,110500,105,7,17,14615,6732,34,71
101100,007700,111500,2,1000,0.9,54.4,22224,12090,-10134,1170,670,-500,36709,111500,111500,111500,3,0,1,17613,6366,0,3
101100,007700,111500,2,1000,0.9,54.5,22227,12113,-10114,1173,675,-498,36735,111500,111500,111000,29,3,6,17593,6697,3,26
101200,007700,110500,3,0,0.0,54.52,22253,12133,-10120,1181,680,-501,36781,111000,111500,110500,37,7,3,17602,6722,23,14
101200,007700,112000,2,1500,1.36,55.29,22307,12333,-9974,1184,688,-496,37035,111000,112000,110500,291,10,11,18157,5688,77,214
101300,007700,111500,2,1000,0.9,55.28,22368,12364,-10004,1192,696,-496,37127,111500,112000,111000,84,6,8,17420,6487,53,31
101300,007700,111500,2,1000,0.9,55.63,22391,12457,-9934,1201,715,-486,37243,111500,112000,111000,200,15,27,18155,5740,76,124
101400,007700,111500,2,1000,0.9,55.7,22413,12485,-9928,1203,722,-481,37293,111500,112000,111500,50,2,7,18173,6139,22,28
101500,007700,111000,2,500,0.45,55.76,22425,12504,-9921,1210,731,-479,37324,111000,111000,111000,1,1,0,17487,7029,1,0
101500,007700,111500,2,1000,0.9,55.81,22478,12546,-9932,1215,741,-474,37419,111000,112000,111000,96,6,10,18241,6686,54,42
101600,007700,111500,2,1000,0.9,55.91,22496,12578,-9918,1222,753,-469,37469,111500,111500,111000,43,6,10,17472,7945,17,26
101600,007700,112000,2,1500,1.36,56.06,22546,12640,-9906,1238,763,-475,37581,111500,112000,111000,155,22,20,18173,7300,67,88
101700,007700,111500,2,1000,0.9,55.98,22615,12661,-9954,1249,771,-478,37671,111500,112000,111000,74,11,4,17563,7993,69,5
101800,007700,111000,2,500,0.45,56.11,22650,12708,-9942,1255,781,-474,37753,111000,111000,111000,0,0,0,17528,7025,0,0
101800,007700,111500,2,1000,0.9,56.37,22678,12784,-9894,1257,792,-465,37857,111500,111500,111000,104,2,11,17633,6886,28,76
101900,007700,111000,2,500,0.45,56.58,22699,12844,-9855,1264,796,-468,37938,111500,111500,111000,57,2,2,17587,6980,2,55
101900,007700,111500,2,1000,0.9,56.93,22735,12944,-9791,1277,814,-463,38074,111500,112000,111000,193,15,20,18266,6321,38,155
102000,007700,111500,2,1000,0.9,56.96,22743,12954,-9789,1284,820,-464,38092,112000,112000,111500,9,6,2,18278,6683,7,2
102000,007700,112000,2,1500,1.36,56.84,22823,12972,-9851,1299,824,-475,38190,112000,112000,111500,107,21,6,18262,6765,87,20
102100,007700,112000,2,1500,1.36,56.83,22870,12997,-9873,1307,829,-478,38262,111500,112000,111500,51,5,4,18250,6828,27,24
102200,007700,111500,2,1000,0.9,56.86,22880,13010,-9870,1315,834,-481,38285,111500,111500,111500,0,0,0,18240,7228,0,0
102200,007700,111500,2,1000,0.9,58.39,22921,13383,-9538,1328,853,-475,38699,112000,112000,111500,414,13,19,17892,7214,41,373
102300,007700,112000,2,1500,1.36,58.46,22972,13430,-9542,1333,861,-472,38797,112000,112000,112000,37,0,4,17857,7267,0,37
102300,007700,112000,2,1500,1.36,58.61,22980,13469,-9511,1338,869,-469,38844,112000,112000,111500,84,5,12,17834,7301,8,76
102400,007700,112000,2,1500,1.36,58.73,23028,13524,-9504,1344,871,-473,38947,112000,112000,112000,45,5,0,18659,6863,45,0
102400,007700,111500,2,1000,0.9,58.65,23098,13547,-9551,1364,879,-485,39040,112000,112000,111500,138,25,8,17964,7291,115,23
102500,007700,112000,2,1500,1.36,58.85,23163,13632,-9531,1375,896,-479,39190,112500,112500,111500,120,9,13,17987,7201,63,57
102600,007700,111500,2,1000,0.9,58.53,23315,13647,-9668,1386,902,-484,39357,112000,112000,111500,15,2,2,18052,7116,9,6
102600,007700,111500,2,1000,0.9,58.5,23338,13653,-9685,1396,904,-492,39386,112000,112000,111500,44,12,4,18067,7190,32,12
102700,007700,111500,2,1000,0.9,58.52,23382,13683,-9699,1409,909,-500,39460,112000,112000,111500,32,8,1,18078,7315,29,3
102700,007700,111500,2,1000,0.9,58.53,23485,13746,-9739,1427,915,-512,39626,112000,112000,111500,198,26,7,18027,7463,132,66
102800,007700,111500,2,1000,0.9,58.7,23539,13818,-9721,1433,930,-503,39752,112000,112500,111500,59,4,12,18911,7596,19,40
102800,007700,112000,2,1500,1.36,58.72,23568,13839,-9729,1441,935,-506,39802,112000,112500,111500,109,12,17,18205,7670,48,61
102900,007700,111500,2,1000,0.9,58.81,23581,13869,-9712,1449,940,-509,39845,112000,112000,111500,41,7,5,18209,7659,11,30
103000,007700,112000,2,1500,1.36,58.81,23625,13893,-9732,1465,948,-517,39913,112000,112000,112000,6,0,3,18383,7629,0,6
103000,007700,111500,2,1000,0.9,58.9,23695,13956,-9739,1479,956,-523,40046,112000,112000,111500,139,14,11,18376,7614,70,69
103100,007700,112000,2,1500,1.36,58.87,23740,13976,-9764,1483,959,-524,40111,111500,112000,111500,37,1,1,18493,7672,27,10
103100,007700,111500,2,1000,0.9,58.88,23808,14017,-9791,1493,966,-527,40220,111500,112000,111500,146,11,8,18471,7630,95,51
103200,007700,111500,2,1000,0.9,58.07,24180,14041,-10139,1523,971,-552,40616,111500,112000,111500,394,28,5,18468,7294,370,24
103300,007700,111500,2,1000,0.9,57.78,24322,14053,-10269,1537,976,-561,40770,111500,111500,111500,0,0,0,18471,7333,0,0
103300,007700,111500,2,1000,0.9,57.78,24368,14080,-10288,1551,983,-568,40843,111500,112000,111000,73,14,7,18339,7293,46,27
103400,007700,111500,2,1000,0.9,57.83,24389,14103,-10286,1557,989,-568,40887,111000,111500,111000,24,4,4,17065,8105,15,9
103400,007700,111000,2,500,0.45,57.82,24484,14156,-10328,1571,1000,-571,41035,111000,112000,111000,172,18,15,17215,8176,110,62
103500,007700,111500,2,1000,0.9,58.24,24559,14303,-10256,1585,1007,-578,41257,111500,111500,111000,219,12,7,17267,8239,72,147
103500,007700,111000,2,500,0.45,57.27,25089,14368,-10721,1601,1015,-586,41852,111500,112000,111000,814,28,15,17858,8568,602,212
103600,007700,111000,2,500,0.45,57.37,25138,14422,-10716,1611,1021,-590,41955,111000,111500,111000,103,10,6,17853,8464,49,54
103700,007700,111000,2,500,0.45,57.16,25270,14444,-10826,1624,1027,-597,42109,111500,111500,111000,96,3,3,17851,8162,86,10
103700,007700,111000,2,500,0.45,57.08,25408,14503,-10905,1644,1037,-607,42306,111500,111500,111000,293,23,13,17806,8338,224,69
103800,007700,111000,2,500,0.45,56.25,25831,14530,-11301,1653,1045,-608,42756,111000,111500,111000,420,7,2,17912,8063,414,6
103800,007700,111000,2,500,0.45,56.21,25895,14555,-11340,1671,1049,-622,42845,111000,111500,111000,509,25,6,17910,8091,478,31
103900,007700,111500,2,1000,0.9,56.37,25918,14611,-11307,1676,1058,-618,42924,111000,111500,111000,54,3,4,17884,8080,19,35
103900,007700,111000,2,500,0.45,56.22,26027,14632,-11395,1698,1062,-636,43054,111000,111500,111000,184,25,8,17871,8083,128,56
104000,007700,111000,2,500,0.45,56.3,26089,14688,-11401,1707,1073,-634,43172,111000,111500,111000,118,9,11,17925,8025,62,56
104100,007700,111500,2,1000,0.9,56.14,26187,14701,-11486,1722,1077,-645,43283,111000,111500,111000,33,5,2,17893,8006,27,6
104100,007700,110500,3,0,0.0,55.66,26437,14716,-11721,1745,1079,-666,43548,111000,111500,110500,298,28,4,14959,8231,277,21
104200,007700,110500,3,0,0.0,55.76,26489,14771,-11718,1755,1091,-664,43655,111000,111000,110500,95,9,8,14929,8261,51,44
104200,007700,111000,2,500,0.45,55.15,26836,14801,-12035,1769,1098,-671,44032,111000,111000,110500,472,23,15,14613,8089,398,74
104300,007700,110500,3,0,0.0,55.24,26894,14857,-12037,1776,1109,-667,44146,110500,111000,110500,114,7,11,14748,8058,58,56
104400,007700,111000,2,500,0.45,55.12,26981,14872,-12109,1788,1113,-675,44248,110500,111000,110500,39,4,2,14855,7962,33,6
104400,007700,110500,3,0,0.0,55.05,27048,14891,-12157,1817,1116,-701,44334,110500,111000,110500,125,33,5,14832,7960,100,25
104500,007700,111000,2,500,0.45,54.99,27169,14940,-12229,1830,1124,-706,44504,110500,111000,110500,70,9,1,14788,8170,68,2
104600,007700,110500,3,0,0.0,55.08,27192,14976,-12216,1837,1133,-704,44563,110500,110500,110500,0,0,0,14797,8157,0,0
104600,007700,111000,2,500,0.45,55.18,27227,15023,-12204,1844,1144,-700,44645,110500,111000,110500,82,7,11,15259,8091,35,47
104700,007700,110500,3,0,0.0,54.93,27358,15029,-12329,1870,1146,-724,44782,110500,111000,110500,73,21,2,15285,7982,67,6
104700,007700,111000,2,500,0.45,54.82,27496,15072,-12424,1892,1153,-739,44963,110500,111000,110500,254,43,9,15226,7961,205,49
104800,007700,110500,3,0,0.0,54.91,27518,15109,-12409,1902,1160,-742,45022,110500,111000,110500,52,10,5,15198,7926,22,30
104900,007700,110500,3,0,0.0,54.92,27537,15122,-12415,1910,1164,-746,45054,110500,111000,110500,16,5,1,15238,7923,14,2
104900,007700,110500,3,0,0.0,54.83,27634,15152,-12482,1926,1170,-756,45181,110500,111000,110500,143,21,7,15255,8108,111,32
105000,007700,110500,3,0,0.0,54.68,27742,15170,-12572,1947,1176,-771,45307,110500,111000,110500,65,12,4,15290,8161,52,13
105100,007700,111000,2,500,0.45,54.83,27761,15220,-12541,1952,1187,-765,45376,111000,111000,111000,0,0,0,15332,8188,0,0
105100,007700,110500,3,0,0.0,54.74,27802,15220,-12582,1965,1187,-778,45417,110500,110500,110500,41,13,0,15369,8182,41,0
105200,007700,110000,5,500,-0.45,54.68,27870,15240,-12630,1979,1192,-787,45505,110500,111000,110000,69,11,2,13174,8405,60,9
105200,007700,110000,5,500,-0.45,54.42,28075,15279,-12796,1996,1198,-798,45749,110500,111000,110000,313,28,8,13115,8312,265,48
105300,007700,110000,5,500,-0.45,54.49,28106,15316,-12790,2006,1205,-801,45817,110500,110500,110000,66,9,7,13161,8258,29,37
105300,007700,110500,3,0,0.0,54.43,28176,15336,-12840,2018,1210,-808,45907,110500,110500,110000,156,21,12,13516,8224,99,57
105400,007700,110000,5,500,-0.45,54.47,28248,15386,-12862,2028,1215,-813,46029,110000,110500,110000,87,10,3,13502,8386,72,15
105500,007700,110000,5,500,-0.45,54.32,28343,15397,-12946,2042,1219,-823,46135,110000,110500,110000,20,7,1,13590,8284,19,1
105500,007700,110500,3,0,0.0,54.47,28364,15451,-12913,2050,1229,-821,46210,110000,110500,110000,95,15,11,13559,8165,40,55
105600,007700,110000,5,500,-0.45,54.41,28451,15481,-12970,2065,1233,-832,46327,110000,110500,110000,83,7,3,13606,8157,54,29
105600,007700,110500,3,0,0.0,54.49,28471,15515,-12956,2071,1239,-832,46381,110000,110500,110000,137,13,9,13592,8186,74,63
105700,007700,110500,3,0,0.0,54.34,28591,15535,-13056,2092,1243,-849,46521,110000,110500,110000,123,16,4,13588,8086,103,20
105700,007700,110500,3,0,0.0,54.36,28622,15559,-13063,2096,1249,-847,46576,110000,110500,110000,178,20,10,13641,8069,134,44
105800,007700,110500,3,0,0.0,54.4,28651,15586,-13065,2103,1257,-846,46632,110500,110500,110000,47,6,8,13638,8068,20,27
105900,007700,110500,3,0,0.0,54.39,28741,15632,-13109,2115,1265,-850,46768,110000,110500,110000,36,1,3,13704,7973,8,28
105900,007700,110000,5,500,-0.45,54.19,28876,15649,-13227,2133,1270,-863,46920,110000,110500,110000,188,19,8,13905,7862,143,45
110000,007700,110000,5,500,-0.45,53.83,29110,15670,-13440,2145,1275,-870,47175,110000,110500,110000,50,9,4,13694,7593,30,20
110000,007700,110500,3,0,0.0,53.82,29139,15683,-13456,2149,1278,-871,47217,110000,110500,110000,92,13,7,13791,7559,59,33
110100,007700,110500,3,0,0.0,53.82,29235,15735,-13500,2157,1289,-868,47365,110000,110500,110000,113,4,7,13879,7579,75,38
110100,007700,110000,5,500,-0.45,53.93,29284,15793,-13491,2166,1297,-869,47472,110000,110500,110000,220,13,15,13850,7658,124,96
110200,007700,110000,5,500,-0.45,54.09,29401,15902,-13499,2189,1301,-888,47698,110000,110500,110000,193,14,4,13741,7687,84,109
110300,007700,110500,3,0,0.0,54.32,29415,15979,-13436,2193,1311,-882,47789,110000,110500,110000,13,1,1,13754,7882,5,8
110300,007700,110500,3,0,0.0,54.5,29494,16073,-13421,2202,1325,-877,47962,110000,110500,110000,186,10,15,13687,7817,84,102
110400,007700,110500,3,0,0.0,55.34,29517,16334,-13183,2212,1340,-872,48246,110500,111000,110000,145,4,6,15698,7647,14,131
110400,007700,110500,3,0,0.0,55.56,29666,16482,-13184,2230,1359,-871,48543,110500,111000,110000,442,22,25,15618,7753,163,279
110500,007700,111000,2,500,0.45,55.75,29701,16559,-13142,2242,1372,-870,48655,110500,111000,110500,80,10,8,15730,7812,29,51
110500,007700,110500,3,0,0.0,55.78,29759,16601,-13158,2252,1380,-872,48755,110500,111000,110500,180,20,16,15717,7885,87,93
110600,007700,111000,2,500,0.45,56.02,29821,16706,-13115,2259,1391,-868,48922,110500,111000,110500,114,6,10,15805,7859,59,55
110700,007700,110500,3,0,0.0,56.17,29938,16815,-13123,2284,1403,-881,49148,110500,110500,110500,26,4,0,15748,7824,26,0
110700,007700,110500,3,0,0.0,56.48,29948,16915,-13033,2291,1411,-880,49258,110500,111000,110500,136,11,8,15666,7804,36,100
110800,007700,110500,3,0,0.0,56.54,30046,16987,-13059,2304,1423,-881,49428,110500,111000,110500,77,6,1,15731,7802,74,3
110800,007700,110500,3,0,0.0,56.57,30112,17034,-13078,2314,1431,-883,49541,110500,111000,110500,190,16,9,15864,7668,140,50
110900,007700,110000,5,500,-0.45,56.56,30151,17052,-13099,2320,1437,-883,49598,110500,111000,110000,35,3,3,15920,7894,23,12
110900,007700,111000,2,500,0.45,56.47,30289,17104,-13185,2342,1442,-900,49788,110500,111000,110000,225,25,8,15940,8035,161,64
111000,007700,111000,2,500,0.45,56.63,30312,17165,-13147,2349,1450,-899,49872,110500,111000,110500,74,7,7,15905,8013,23,51
111100,007700,111000,2,500,0.45,56.54,30391,17184,-13207,2363,1455,-908,49970,110500,111000,110500,53,4,1,16037,7941,50,3
111100,007700,111000,2,500,0.45,56.44,30503,17217,-13286,2375,1461,-914,50115,110500,111000,110500,198,16,7,15966,7877,162,36
111200,007700,110500,3,0,0.0,56.24,30644,17234,-13410,2394,1465,-929,50273,110500,111000,110500,21,4,2,16027,7759,14,7
111200,007700,110500,3,0,0.0,56.2,30709,17257,-13452,2414,1469,-945,50361,110500,111000,110500,109,24,6,16024,7805,79,30
111300,007700,110500,3,0,0.0,56.35,30769,17337,-13432,2424,1480,-944,50501,110500,111000,110500,128,10,7,15958,7948,60,68
111300,007700,110500,3,0,0.0,56.35,30820,17367,-13453,2431,1486,-945,50582,110500,111000,110500,209,17,13,16023,7943,111,98
111400,007700,110500,3,0,0.0,56.43,30933,17457,-13476,2458,1492,-966,50785,111000,111000,110500,201,26,5,16012,7829,112,89
111500,007700,110500,3,0,0.0,56.51,30949,17489,-13460,2462,1497,-965,50833,110500,110500,110500,10,1,0,16059,8107,10,0
111500,007700,110500,3,0,0.0,56.34,31086,17513,-13573,2479,1501,-978,50994,110500,111000,110500,171,18,4,15992,7969,147,24
111600,007700,110500,3,0,0.0,56.38,31138,17557,-13581,2485,1509,-976,51090,110500,111000,110500,33,2,3,15970,7939,5,28
111600,007700,110500,3,0,0.0,56.41,31176,17585,-13591,2492,1514,-978,51156,110500,111000,110500,99,9,8,16046,7957,43,56
111700,007700,110500,3,0,0.0,56.21,31358,17626,-13732,2517,1520,-997,51379,110500,111000,110000,66,12,2,13810,8030,37,29
111700,007700,110000,5,500,-0.45,56.18,31396,17637,-13759,2527,1523,-1004,51428,110500,111000,110000,115,22,5,13826,8001,75,40
111800,007700,110500,3,0,0.0,56.51,31436,17764,-13672,2538,1529,-1009,51595,111000,111000,110500,31,4,3,15927,8179,11,20
111800,007700,111000,2,500,0.45,56.48,31541,17814,-13727,2552,1538,-1014,51750,111000,111000,110500,186,18,12,15927,8139,116,70
111900,007700,110500,3,0,0.0,56.39,31653,17850,-13803,2568,1546,-1022,51898,111000,111000,110500,148,16,8,16105,8080,112,36
112000,007700,110500,3,0,0.0,56.31,31717,17861,-13856,2577,1549,-1028,51973,110500,110500,110500,11,2,0,16130,8044,11,0
112000,007700,110500,3,0,0.0,56.24,31819,17896,-13923,2602,1555,-1047,52110,110500,111000,110500,148,27,6,16115,7917,113,35
112100,007700,110500,3,0,0.0,56.04,31953,17907,-14046,2615,1558,-1057,52255,110500,111000,110500,55,8,2,16122,7837,50,5
112100,007700,111000,2,500,0.45,55.99,32025,17931,-14094,2626,1565,-1061,52351,110500,111000,110500,151,19,9,16173,7823,122,29
112200,007700,110500,3,0,0.0,55.92,32145,17976,-14169,2644,1572,-1072,52516,110000,110500,110000,118,9,5,13903,7972,91,27
112200,007700,110000,5,500,-0.45,55.83,32228,17993,-14235,2654,1576,-1078,52616,110000,110500,110000,218,19,9,13908,7962,174,44
112300,007700,110000,5,500,-0.45,55.83,32291,18028,-14263,2665,1581,-1084,52714,110000,110500,110000,92,11,4,13890,7971,63,29
112400,007700,110000,5,500,-0.45,55.73,32367,18037,-14330,2676,1585,-1091,52799,110000,110000,110000,50,2,0,14019,7877,50,0
112400,007700,110500,3,0,0.0,55.64,32457,18059,-14398,2693,1591,-1102,52911,110000,110500,110000,162,19,6,14098,7638,140,22
112500,007700,110500,3,0,0.0,55.68,32510,18103,-14407,2704,1599,-1105,53008,110000,110500,110000,21,4,2,14080,7655,15,6
112500,007700,110500,3,0,0.0,55.68,32560,18131,-14429,2716,1604,-1112,53086,110000,110500,110000,99,16,7,14166,7744,65,34
112600,007700,110000,5,500,-0.45,55.61,32641,18151,-14490,2726,1609,-1117,53187,110500,110500,110000,43,8,3,14221,7684,31,12
112600,007700,110000,5,500,-0.45,55.51,32762,18185,-14577,2743,1615,-1128,53342,110500,110500,110000,198,25,9,14199,7706,152,46
112700,007700,110000,5,500,-0.45,55.38,32851,18193,-14658,2763,1618,-1145,53439,110000,110500,110000,73,12,3,14085,7620,65,8
112800,007700,110000,5,500,-0.45,55.19,33038,18233,-14805,2771,1624,-1147,53666,110000,110000,110000,5,1,0,14095,7467,5,0
112800,007700,110000,5,500,-0.45,55.12,33139,18265,-14874,2785,1631,-1154,53799,110000,110500,110000,138,15,7,14075,7393,106,32
112900,007700,110500,3,0,0.0,55.06,33210,18284,-14926,2794,1637,-1157,53889,110000,110500,110000,58,4,1,14102,7367,53,5
112900,007700,110500,3,0,0.0,54.91,33361,18320,-15041,2813,1642,-1171,54076,110000,110500,110000,245,23,6,14065,7218,204,41
113000,007700,110000,5,500,-0.45,54.87,33402,18327,-15075,2822,1644,-1178,54124,110000,110500,110000,28,5,1,14088,7201,22,6
113000,007700,110000,5,500,-0.45,54.89,33495,18385,-15110,2835,1653,-1182,54275,110000,110500,110000,179,18,10,14043,7774,115,64
113100,007700,110000,5,500,-0.45,54.86,33588,18427,-15161,2845,1662,-1183,54410,110000,110500,110000,127,9,9,14029,7656,85,42
113100,007700,110000,5,500,-0.45,54.77,33688,18452,-15236,2862,1668,-1194,54535,110000,110500,110000,252,26,15,14057,7577,185,67
113200,007700,110000,5,500,-0.45,54.74,33731,18466,-15265,2877,1669,-1208,54592,110000,110500,110000,56,14,1,14075,7641,42,14
113300,007700,110000,5,500,-0.45,54.61,33825,18472,-15353,2887,1671,-1216,54692,110000,110000,110000,17,2,0,14065,7564,17,0
113300,007700,110000,5,500,-0.45,54.63,33890,18514,-15376,2893,1679,-1214,54799,110000,110500,110000,124,8,8,14196,7531,82,42
113400,007700,110500,3,0,0.0,54.55,33995,18543,-15452,2915,1687,-1228,54933,110500,110500,110000,27,3,3,14181,7470,11,16
113400,007700,110000,5,500,-0.45,54.46,34095,18567,-15528,2926,1691,-1235,55057,110500,110500,110000,151,14,7,14170,7462,111,40
113500,007700,110500,3,0,0.0,54.55,34145,18627,-15518,2935,1700,-1235,55167,110500,110500,110000,51,4,4,14312,7379,6,45
113500,007700,110000,5,500,-0.45,54.44,34234,18638,-15596,2947,1703,-1244,55267,110500,110500,110000,151,16,7,14188,8327,95,56
113600,007700,110500,3,0,0.0,54.28,34418,18681,-15737,2961,1711,-1250,55494,110000,110500,110000,152,11,7,14165,8231,119,33
113700,007700,110000,5,500,-0.45,54.2,34479,18687,-15792,2975,1712,-1263,55561,110000,110000,110000,9,2,0,14187,8207,9,0
113700,007700,110000,5,500,-0.45,54.25,34537,18735,-15802,2991,1722,-1269,55667,110000,110500,110000,115,18,10,14272,8170,67,48
113800,007700,110000,5,500,-0.45,54.2,34606,18758,-15848,2995,1726,-1269,55759,110500,110500,110000,61,2,1,14287,8271,51,10
113800,007700,110500,3,0,0.0,54.16,34691,18790,-15901,3007,1732,-1275,55876,110500,110500,110000,178,14,7,14278,8079,136,42
113900,007700,110000,5,500,-0.45,54.11,34783,18821,-15962,3024,1737,-1287,55999,110000,110000,110000,37,10,0,14262,8104,37,0
113900,007700,110000,5,500,-0.45,53.83,34987,18834,-16153,3036,1741,-1295,56216,110000,110500,110000,254,22,4,14272,10427,241,13
114000,007700,110000,5,500,-0.45,53.86,35046,18875,-16171,3046,1750,-1296,56316,110000,110500,110000,69,9,9,14294,10237,28,41
114000,007700,110000,5,500,-0.45,53.73,35157,18891,-16266,3059,1753,-1306,56443,110000,110500,110000,196,22,12,14298,10256,139,57
114100,007700,110000,5,500,-0.45,53.69,35254,18929,-16325,3072,1759,-1313,56578,110000,110500,110000,127,13,4,14320,10210,97,30
114200,007700,110000,5,500,-0.45,53.65,35355,18968,-16387,3087,1766,-1321,56718,110000,110000,110000,17,3,0,14303,10145,17,0
114200,007700,110500,3,0,0.0,53.64,35387,18982,-16405,3093,1770,-1323,56764,110000,110500,110000,63,9,4,14296,10111,49,14
114300,007700,110000,5,500,-0.45,53.55,35448,18982,-16466,3101,1770,-1331,56825,110000,110000,110000,53,4,0,14320,10147,53,0
114300,007700,110000,5,500,-0.45,53.51,35571,19035,-16536,3121,1781,-1340,57001,110000,110500,110000,229,24,11,14326,10062,176,53
114400,007700,110500,3,0,0.0,53.52,35623,19067,-16556,3139,1786,-1353,57085,110500,110500,110000,70,15,3,14343,9996,45,25
114400,007700,110500,3,0,0.0,53.6,35671,19120,-16551,3149,1793,-1356,57186,110500,110500,110000,171,25,10,14294,9974,93,78
114500,007700,110000,5,500,-0.45,53.51,35740,19123,-16617,3156,1795,-1361,57258,110000,110500,110000,55,5,2,14305,10065,52,3
114600,007700,110000,5,500,-0.45,53.46,35800,19137,-16663,3162,1798,-1364,57332,110000,110000,110000,1,1,0,14320,9917,1,0
114600,007700,110000,5,500,-0.45,53.48,35871,19184,-16687,3172,1808,-1364,57450,110000,110500,110000,119,11,10,14298,9875,72,47
114700,007700,110000,5,500,-0.45,53.63,36072,19346,-16726,3196,1816,-1380,57813,110000,110000,110000,28,1,4,14124,9800,4,24
114700,007700,110000,5,500,-0.45,53.73,36128,19412,-16716,3209,1822,-1387,57935,110000,110500,110000,150,14,10,14111,9981,60,90
114800,007700,110000,5,500,-0.45,53.63,36210,19421,-16789,3219,1826,-1393,58026,110000,110500,110000,59,5,1,14149,9893,57,2
114800,007700,110000,5,500,-0.45,53.54,36307,19437,-16870,3228,1830,-1398,58139,110000,110500,110000,172,14,5,14243,9836,154,18
114900,007700,110500,3,0,0.0,53.53,36389,19480,-16909,3242,1840,-1402,58264,110000,110500,110000,117,13,10,14239,9753,74,43
115000,007700,110000,5,500,-0.45,53.62,36414,19527,-16887,3250,1844,-1406,58336,110000,110000,110000,1,1,0,14246,9827,1,0
115000,007700,110000,5,500,-0.45,53.62,36519,19583,-16936,3264,1852,-1412,58497,110000,110500,110000,162,15,8,14226,9702,106,56
115100,007700,110000,5,500,-0.45,53.77,36621,19690,-16931,3276,1859,-1417,58706,110000,110000,109500,140,4,3,12188,11846,44,96
115100,007700,109500,5,1000,-0.9,53.75,36658,19705,-16953,3284,1865,-1419,58758,110000,110500,109500,192,12,9,12098,11857,81,111
115200,007700,110000,5,500,-0.45,53.94,36750,19822,-16928,3298,1871,-1427,58967,110000,110500,109500,161,4,5,14103,9694,48,113
115200,007700,110000,5,500,-0.45,54.25,36771,19949,-16822,3302,1877,-1425,59115,110000,110500,109500,309,8,11,14009,9876,69,240
115300,007700,110000,5,500,-0.45,54.19,36903,19996,-16907,3325,1884,-1441,59294,110000,110500,110000,135,20,6,14081,9783,94,41
115300,007700,110500,3,0,0.0,54.18,36982,20038,-16944,3336,1889,-1447,59415,110000,110500,110000,256,31,11,14067,9712,173,83
115400,007700,110500,3,0,0.0,54.14,37026,20047,-16979,3346,1893,-1453,59468,110000,110500,110000,53,10,4,14134,10107,44,9
115500,007700,110000,5,500,-0.45,54.15,37065,20072,-16993,3355,1899,-1456,59532,110500,110500,110000,11,1,1,14107,10148,8,3
115500,007700,110000,5,500,-0.45,54.14,37140,20106,-17034,3365,1907,-1458,59641,110500,110500,110000,120,11,9,14161,10102,83,37
115600,007700,110000,5,500,-0.45,54.12,37252,20161,-17091,3375,1919,-1456,59808,110500,110500,110000,48,5,3,14163,10226,38,10
115600,007700,110000,5,500,-0.45,54.1,37323,20190,-17133,3401,1924,-1477,59908,110500,110500,110000,148,31,8,14166,10159,109,39
115700,007700,110000,5,500,-0.45,54.1,37336,20198,-17138,3407,1927,-1480,59929,110000,110500,110000,5,3,1,14179,10149,3,2
115700,007700,110000,5,500,-0.45,54.0,37439,20217,-17222,3417,1932,-1485,60051,110000,110500,110000,127,13,6,14181,10060,106,21
115800,007700,110500,3,0,0.0,53.99,37515,20255,-17260,3425,1941,-1484,60165,110000,110500,110000,107,6,8,14156,10007,72,35
115900,007700,110000,5,500,-0.45,53.9,37645,20290,-17355,3445,1947,-1498,60330,110000,110000,110000,1,1,0,14315,9904,1,0
115900,007700,110500,3,0,0.0,53.87,37734,20329,-17405,3459,1953,-1506,60458,110000,110500,110000,129,15,6,14330,10223,90,39
120000,007700,110500,3,0,0.0,53.85,37777,20342,-17435,3472,1957,-1515,60514,110000,110500,110000,15,3,2,14256,10908,8,7
120000,007700,110500,3,0,0.0,53.78,37857,20360,-17497,3482,1961,-1521,60612,110000,110500,110000,113,13,6,14271,10847,88,25
120100,007700,110500,3,0,0.0,53.64,38000,20384,-17616,3497,1966,-1531,60779,110000,110500,110000,78,8,3,14270,10746,59,19
120100,007700,110000,5,500,-0.45,53.7,38035,20425,-17610,3507,1973,-1534,60855,110000,110500,110000,154,18,10,14351,10724,94,60
120200,007700,110000,5,500,-0.45,53.67,38104,20449,-17655,3519,1977,-1542,60948,110000,110500,110000,33,9,2,14327,10708,25,8
120200,007700,110000,5,500,-0.45,53.57,38243,20488,-17755,3531,1982,-1549,61126,110000,110500,110000,211,21,7,14286,10630,164,47
120300,007700,110500,3,0,0.0,53.55,38294,20505,-17789,3542,1988,-1554,61194,110000,110500,110000,21,4,4,14279,10587,10,11
120400,007700,110000,5,500,-0.45,53.52,38344,20521,-17823,3551,1992,-1559,61260,110000,110000,110000,25,3,0,14289,10549,25,0
120400,007700,110000,5,500,-0.45,53.56,38430,20583,-17847,3564,2002,-1562,61408,110000,110500,110000,173,16,10,14240,10398,111,62
120500,007700,110000,5,500,-0.45,53.54,38449,20587,-17862,3567,2003,-1564,61431,110000,110000,110000,19,3,0,14276,10508,19,0
120500,007700,110000,5,500,-0.45,53.57,38504,20628,-17876,3577,2009,-1568,61527,110000,110500,110000,115,13,6,14293,10580,74,41
120600,007700,110000,5,500,-0.45,53.56,38562,20653,-17909,3593,2017,-1576,61610,110500,110500,110000,62,11,5,14285,10638,45,17
120600,007700,110500,3,0,0.0,53.45,38672,20672,-18000,3606,2023,-1583,61739,110500,110500,110000,191,24,11,14300,10424,155,36
120700,007700,110000,5,500,-0.45,53.57,38698,20729,-17969,3613,2030,-1583,61822,110000,110500,110000,83,7,7,14316,10447,26,57
120800,007700,110000,5,500,-0.45,53.47,38788,20740,-18048,3623,2033,-1590,61923,110000,110000,110000,0,0,0,14334,10364,0,0
120800,007700,110000,5,500,-0.45,53.44,38881,20777,-18104,3635,2040,-1595,62053,110000,110500,110000,130,12,7,14324,10287,93,37
120900,007700,110000,5,500,-0.45,53.48,38896,20800,-18096,3641,2045,-1596,62091,110500,110500,110000,21,2,3,14301,10279,9,12
120900,007700,110000,5,500,-0.45,53.45,38981,20834,-18147,3659,2051,-1608,62210,110500,110500,110000,140,20,9,14297,10278,94,46
121000,007700,110500,3,0,0.0,53.47,39059,20885,-18174,3665,2059,-1606,62339,110500,110500,110000,51,3,6,14265,10192,7,44
121000,007700,110500,3,0,0.0,53.53,39113,20939,-18174,3671,2068,-1603,62447,110500,110500,110000,159,9,15,14238,10149,61,98
121100,007700,110500,3,0,0.0,53.61,39141,20983,-18158,3684,2074,-1610,62519,110000,110500,110000,66,11,6,14262,10047,22,44
121200,007700,110000,5,500,-0.45,53.48,39239,20986,-18253,3696,2076,-1620,62620,110000,110000,110000,0,0,0,14265,9969,0,0
121200,007700,110500,3,0,0.0,53.47,39281,21002,-18279,3709,2081,-1628,62678,110500,110500,110000,58,13,5,14277,9928,42,16
121300,007700,110000,5,500,-0.45,53.49,39340,21044,-18296,3715,2088,-1627,62779,110000,110000,110000,9,2,0,14253,9770,9,0
121300,007700,110000,5,500,-0.45,53.52,39375,21074,-18301,3720,2094,-1626,62844,110000,110500,110000,74,7,6,14347,9763,44,30
121400,007700,110500,3,0,0.0,53.45,39463,21093,-18370,3739,2097,-1642,62951,110000,110500,110000,44,13,1,14375,9708,35,9
121400,007700,110000,5,500,-0.45,53.5,39485,21123,-18362,3746,2102,-1644,63003,110000,110500,110000,96,20,6,14379,9728,57,39
121500,007700,110000,5,500,-0.45,53.37,39603,21136,-18467,3759,2106,-1653,63134,110000,110500,110000,114,12,2,14385,9621,108,6
121600,007700,110000,5,500,-0.45,53.45,39636,21187,-18449,3767,2115,-1652,63218,110000,110000,110000,8,1,0,14374,9606,8,0
121600,007700,110500,3,0,0.0,53.51,39656,21220,-18436,3773,2121,-1652,63271,110000,110500,110000,61,7,6,14351,9548,28,33
121700,007700,110000,5,500,-0.45,53.58,39849,21351,-18498,3791,2123,-1668,63595,110000,110000,110000,147,4,1,14208,9283,18,129
121700,007700,110000,5,500,-0.45,53.55,39958,21397,-18561,3802,2131,-1671,63750,110000,110500,109500,302,15,9,13764,11483,127,175
121800,007700,109000,5,1500,-1.36,50.84,42553,21636,-20917,3819,2140,-1679,66584,110000,110000,108500,2789,14,8,8263,9342,2552,237
121800,007700,109500,5,1000,-0.9,49.44,43905,21707,-22198,3830,2146,-1684,68007,110000,110000,108000,4212,25,14,11224,8311,3904,308
121900,007700,109000,5,1500,-1.36,50.08,43934,22003,-21931,3841,2151,-1690,68332,108500,109500,108500,321,9,5,11065,9249,25,296
122000,007700,109000,5,1500,-1.36,50.06,43980,22018,-21962,3851,2156,-1695,68393,109000,109000,109000,0,0,0,11068,8698,0,0
122000,007700,109500,5,1000,-0.9,50.16,44100,22122,-21978,3869,2165,-1704,68617,109000,109500,109000,224,18,9,11092,9224,120,104
122100,007700,109500,5,1000,-0.9,50.16,44134,22137,-21997,3877,2170,-1707,68666,109000,109500,109000,21,3,3,11086,9576,9,12
122100,007700,109000,5,1500,-1.36,50.21,44179,22182,-21997,3891,2178,-1713,68756,109000,109500,109000,111,17,11,11072,9330,54,57
122200,007700,109500,5,1000,-0.9,50.19,44263,22214,-22049,3901,2185,-1716,68872,109000,109500,109000,102,7,5,11062,9397,77,25
122200,007700,109000,5,1500,-1.36,50.09,44357,22220,-22137,3910,2187,-1723,68972,109000,109500,109000,202,16,7,11554,9425,171,31
122300,007700,109500,5,1000,-0.9,50.22,44404,22298,-22106,3922,2195,-1727,69097,109000,109500,108500,124,11,8,11477,10085,46,78
122400,007700,109000,5,1500,-1.36,50.2,44507,22341,-22166,3930,2197,-1733,69243,109000,109000,109000,0,0,0,11728,10075,0,0
122400,007700,109500,5,1000,-0.9,50.21,44579,22383,-22196,3947,2205,-1742,69357,109000,109500,109000,114,17,8,12654,9391,72,42
122500,007700,108500,5,2000,-1.81,50.27,44605,22421,-22184,3954,2212,-1742,69421,109000,109000,108500,17,1,2,12582,10517,1,16
122500,007700,109000,5,1500,-1.36,50.51,44671,22565,-22106,3964,2224,-1740,69631,109000,109500,108500,227,11,14,13091,10527,67,160
122600,007700,109000,5,1500,-1.36,50.44,44740,22565,-22175,3977,2224,-1753,69700,109000,109000,109000,27,10,0,13175,9724,27,0
122600,007700,109000,5,1500,-1.36,50.48,44789,22611,-22178,3988,2232,-1756,69795,109000,109500,109000,122,21,8,13151,9783,76,46
122700,007700,109000,5,1500,-1.36,50.55,44814,22654,-22160,3995,2240,-1755,69863,109000,109500,109000,62,7,7,13140,9781,25,37
122800,007700,109000,5,1500,-1.36,50.43,44939,22661,-22278,4007,2242,-1765,69995,109000,109000,109000,6,1,0,13149,9904,6,0
122800,007700,109500,5,1000,-0.9,50.49,44967,22705,-22262,4013,2250,-1763,70067,109000,109500,109000,78,7,8,13148,9888,34,44
122900,007700,109000,5,1500,-1.36,50.88,45045,22918,-22127,4028,2261,-1767,70358,108500,109000,108500,37,7,2,9875,11096,25,12
122900,007700,109500,5,1000,-0.9,50.97,45069,22970,-22099,4037,2269,-1768,70434,108500,109500,108500,113,16,10,13131,10882,49,64
123000,007700,109500,5,1000,-0.9,50.99,45125,23008,-22117,4041,2276,-1765,70528,109500,109500,109000,76,2,5,13129,9980,49,27
123000,007700,109000,5,1500,-1.36,50.98,45162,23022,-22140,4050,2279,-1771,70579,109500,109500,109000,127,11,8,13170,10197,86,41
123100,007700,109500,5,1000,-0.9,51.02,45203,23062,-22141,4058,2285,-1773,70660,109000,109500,109000,60,6,3,13196,10301,39,21
123100,007700,109000,5,1500,-1.36,50.9,45324,23071,-22253,4078,2288,-1790,70790,109000,109500,109000,190,26,6,13151,10262,160,30
123200,007700,110000,5,500,-0.45,51.42,45352,23321,-22031,4089,2298,-1791,71068,109000,110000,109000,272,11,9,15817,11099,28,244
123300,007700,110000,5,500,-0.45,51.43,45450,23374,-22076,4098,2307,-1791,71219,110000,110000,109500,14,1,3,15777,11161,6,8
123300,007700,109500,5,1000,-0.9,51.4,45491,23381,-22110,4109,2310,-1799,71267,110000,110000,109500,62,12,6,15787,10170,47,15
123400,007700,109500,5,1000,-0.9,51.41,45513,23396,-22117,4116,2314,-1802,71304,110000,110000,109500,27,2,4,12916,10271,12,15
123400,007700,109500,5,1000,-0.9,51.35,45665,23451,-22214,4126,2322,-1804,71511,110000,110000,109000,234,12,12,13046,10580,164,70
123500,007700,109000,5,1500,-1.36,51.3,45729,23460,-22269,4138,2325,-1813,71584,109000,109000,109000,64,12,0,13179,10628,64,0
123500,007700,109500,5,1000,-0.9,51.47,45761,23551,-22210,4145,2340,-1805,71707,109000,109500,109000,187,19,15,13685,8175,96,91
123600,007700,109000,5,1500,-1.36,51.46,45784,23560,-22224,4151,2343,-1808,71739,109500,109500,109000,32,6,3,13873,8211,23,9
123700,007700,109000,5,1500,-1.36,50.89,46319,23571,-22748,4170,2346,-1824,72285,109000,109000,109000,486,5,2,10180,8104,479,7
123700,007700,109000,5,1500,-1.36,51.13,46368,23710,-22658,4174,2351,-1823,72473,109000,109500,109000,674,9,7,13309,8151,528,146
123800,007700,109500,5,1000,-0.9,51.08,46461,23731,-22730,4185,2357,-1828,72587,109000,109500,109000,44,2,1,13340,7882,41,3
123800,007700,109000,5,1500,-1.36,51.14,46504,23782,-22722,4197,2364,-1833,72681,109000,109500,109000,138,14,8,13304,7863,84,54
123900,007700,109000,5,1500,-1.36,51.4,46572,23937,-22635,4212,2372,-1840,72904,109000,109000,109000,202,12,6,10023,8165,59,143
123900,007700,109500,5,1000,-0.9,51.28,46710,23954,-22756,4224,2377,-1847,73059,109000,109500,109000,357,24,11,13258,8449,197,160
124000,007700,109500,5,1000,-0.9,51.37,46759,24021,-22738,4230,2386,-1844,73175,109000,109500,108500,104,3,9,13318,7888,37,67
124100,007700,108500,5,2000,-1.81,51.46,46788,24076,-22712,4238,2394,-1844,73259,109000,109000,108500,40,1,3,10084,8524,1,39
124100,007700,109000,5,1500,-1.36,51.53,46851,24140,-22711,4255,2404,-1851,73386,109000,109500,108500,167,18,13,13282,8264,64,103
124200,007700,108500,5,2000,-1.81,51.64,46884,24209,-22675,4262,2407,-1855,73488,109000,109000,108500,10,3,0,10131,8525,10,0
124200,007700,109000,5,1500,-1.36,51.3,47232,24232,-23000,4280,2415,-1865,73859,109000,109500,108500,381,21,8,13619,7982,358,23
124300,007700,109000,5,1500,-1.36,51.37,47254,24274,-22980,4284,2423,-1861,73923,109000,109500,109000,56,4,6,13577,8067,22,34
124300,007700,109500,5,1000,-0.9,51.33,47314,24284,-23030,4292,2426,-1866,73993,109000,109500,109000,126,12,9,13610,8052,82,44
124400,007700,109500,5,1000,-0.9,51.31,47395,24317,-23078,4309,2431,-1878,74107,109000,109500,109000,80,14,5,13585,8042,47,33
124500,007700,109000,5,1500,-1.36,51.32,47461,24359,-23102,4318,2438,-1880,74215,109000,109000,109000,8,2,0,13450,8036,8,0
124500,007700,109500,5,1000,-0.9,51.71,47531,24577,-22954,4329,2445,-1884,74503,109000,110000,108500,296,13,7,16175,8891,78,218
124600,007700,110000,5,500,-0.45,51.73,47552,24597,-22955,4338,2451,-1887,74544,110000,110000,110000,8,0,3,16221,8400,0,8
124600,007700,110000,5,500,-0.45,51.72,47628,24635,-22993,4354,2457,-1897,74658,110000,110000,109500,122,16,9,16170,8436,76,46
124700,007700,109500,5,1000,-0.9,51.8,47635,24675,-22960,4359,2463,-1896,74705,110000,110000,109500,33,4,3,16253,8534,6,27
124700,007700,110000,5,500,-0.45,51.79,47715,24713,-23002,4372,2471,-1901,74823,110000,110000,109500,151,17,11,16225,8452,86,65
124800,007700,110000,5,500,-0.45,51.79,47739,24724,-23015,4378,2475,-1903,74858,109500,110000,109500,33,4,4,16254,8737,22,11
124900,007700,109500,5,1000,-0.9,51.67,47862,24731,-23131,4399,2477,-1922,74988,109500,109500,109500,0,0,0,16267,8954,0,0
124900,007700,109500,5,1000,-0.9,51.72,47884,24765,-23119,4404,2484,-1920,75044,109500,110000,109500,56,5,7,16248,9036,22,34
125000,007700,110000,5,500,-0.45,51.7,47977,24803,-23174,4409,2490,-1919,75175,109500,110000,109500,34,1,1,16229,8951,32,2
125000,007700,110000,5,500,-0.45,51.62,48144,24854,-23290,4426,2499,-1927,75393,109500,110000,109500,252,18,10,16146,8637,199,53
125100,007700,109500,5,1000,-0.9,51.62,48159,24858,-23301,4433,2501,-1932,75412,109500,110000,109500,13,4,2,15964,8550,9,4
125100,007700,109500,5,1000,-0.9,51.58,48218,24873,-23345,4448,2504,-1944,75486,109500,110000,109500,87,19,5,15958,8516,68,19
125200,007700,109500,5,1000,-0.9,51.64,48250,24917,-23333,4458,2513,-1945,75562,109500,110000,109500,67,9,9,15955,8501,23,44
125200,007700,110000,5,500,-0.45,51.64,48319,24953,-23366,4466,2520,-1946,75667,109500,110000,109500,172,17,16,15964,8467,92,80
125300,007700,110000,5,500,-0.45,51.59,48370,24955,-23415,4472,2521,-1951,75720,109500,110000,109500,40,5,1,15977,8412,38,2
125400,007700,109500,5,1000,-0.9,51.57,48478,25000,-23478,4487,2528,-1959,75873,109500,109500,109500,0,0,0,15949,8469,0,0
125400,007700,109500,5,1000,-0.9,51.55,48516,25009,-23507,4497,2531,-1966,75920,109500,110000,109500,47,10,3,15970,8527,38,9
125500,007700,109500,5,1000,-0.9,51.95,48603,25247,-23356,4507,2543,-1964,76245,109000,109500,109000,171,2,7,12917,8652,13,158
125500,007700,110000,5,500,-0.45,52.12,48639,25353,-23286,4514,2555,-1959,76388,109000,110000,109000,314,9,19,15717,8825,49,264
125600,007700,109500,5,1000,-0.9,52.2,48719,25430,-23289,4538,2559,-1979,76545,109500,110000,109500,157,24,4,15666,8550,80,77
125700,007700,109000,5,1500,-1.36,52.19,48743,25438,-23305,4544,2561,-1983,76577,109000,109000,109000,15,3,0,12858,8863,15,0
125700,007700,109000,5,1500,-1.36,52.18,48817,25471,-23346,4554,2570,-1984,76684,109000,109500,109000,122,13,9,12945,8958,89,33
125800,007700,109000,5,1500,-1.36,52.27,48861,25539,-23322,4564,2582,-1982,76796,109000,109500,109000,92,6,11,12984,9114,28,64
125900,007700,109500,5,1000,-0.9,52.21,48927,25546,-23381,4584,2585,-1999,76869,109000,109500,109000,34,5,3,13072,9274,27,7
125900,007700,109000,5,1500,-1.36,52.26,48971,25594,-23377,4597,2596,-2001,76961,109000,109500,109000,126,18,14,13165,9062,71,55
130000,007700,109000,5,1500,-1.36,52.32,49033,25654,-23379,4604,2605,-1999,77083,109000,109500,109000,38,5,4,13184,8991,14,24
130100,007700,109500,5,1000,-0.9,52.35,49132,25723,-23409,4622,2616,-2006,77251,109500,109500,109000,69,2,2,13128,8889,56,13
130100,007700,109000,5,1500,-1.36,52.41,49183,25778,-23405,4635,2624,-2011,77357,109500,109500,109000,175,15,10,13286,8901,107,68
130200,007700,109000,5,1500,-1.36,52.31,49299,25786,-23513,4653,2627,-2026,77481,109000,109500,109000,96,12,3,13295,8794,88,8
130300,007700,109000,5,1500,-1.36,52.35,49328,25822,-23506,4659,2634,-2025,77546,109000,109000,109000,0,0,0,13414,8785,0,0
130300,007700,109000,5,1500,-1.36,52.36,49356,25844,-23512,4667,2639,-2028,77596,109000,109500,109000,50,8,5,13422,8732,28,22
130400,007700,109500,5,1000,-0.9,52.46,49401,25916,-23485,4677,2649,-2028,77713,109000,109500,109000,60,2,6,13380,8645,9,51
130400,007700,109000,5,1500,-1.36,52.37,49536,25940,-23596,4688,2654,-2034,77872,109000,109500,109000,219,13,11,13204,8538,144,75
130500,007700,109500,5,1000,-0.9,52.35,49581,25957,-23624,4698,2661,-2037,77934,109000,109500,109000,62,10,7,13205,8491,45,17
130600,007700,109500,5,1000,-0.9,52.42,49604,26004,-23600,4706,2666,-2040,78004,109500,109500,109500,0,0,0,13747,8482,0,0
130600,007700,109000,5,1500,-1.36,52.55,49704,26118,-23586,4720,2674,-2046,78218,109000,109500,108500,214,14,8,13637,8380,100,114
130700,007700,109500,5,1000,-0.9,52.66,49785,26219,-23566,4731,2686,-2045,78400,109000,109500,108500,124,8,8,13568,8463,62,62
130700,007700,109000,5,1500,-1.36,52.67,49795,26227,-23568,4732,2689,-2043,78418,109000,109500,108500,142,9,11,13558,8430,72,70
130800,007700,109000,5,1500,-1.36,52.7,49898,26298,-23600,4747,2697,-2050,78592,109000,109500,109000,174,15,8,13541,8427,103,71
130900,007700,109000,5,1500,-1.36,52.71,49940,26321,-23619,4760,2701,-2059,78657,109000,109000,109000,9,1,0,13535,8457,9,0
130900,007700,109000,5,1500,-1.36,52.69,50003,26349,-23654,4767,2706,-2061,78748,109000,109500,109000,100,8,5,13515,8544,72,28
131000,007700,109500,5,1000,-0.9,52.75,50076,26413,-23663,4778,2717,-2061,78885,109000,109500,109000,76,9,7,13058,8624,39,37
131100,007700,109000,5,1500,-1.36,52.72,50105,26415,-23690,4784,2718,-2066,78916,109000,109000,109000,16,1,0,13072,8678,16,0
131100,007700,109500,5,1000,-0.9,52.75,50150,26453,-23697,4796,2724,-2072,78999,109000,109500,109000,99,13,6,13090,8645,61,38
131200,007700,109000,5,1500,-1.36,52.72,50228,26479,-23749,4808,2729,-2079,79103,109000,109500,109000,60,6,1,13127,8598,55,5
131200,007700,109500,5,1000,-0.9,52.79,50241,26524,-23717,4812,2736,-2076,79161,109000,109500,109000,118,10,8,13169,8619,68,50
131300,007700,109500,5,1000,-0.9,52.82,50312,26573,-23739,4824,2745,-2079,79281,109000,109500,109000,118,11,8,13188,8565,70,48
131400,007700,109500,5,1000,-0.9,52.97,50408,26703,-23705,4838,2752,-2086,79507,109500,109500,109000,17,1,4,13170,8586,6,11
131400,007700,109000,5,1500,-1.36,53.05,50488,26782,-23706,4848,2758,-2090,79666,109500,109500,109000,176,11,10,10448,8846,86,90
131500,007700,109000,5,1500,-1.36,53.04,50539,26806,-23733,4854,2763,-2091,79741,109500,109500,109000,62,6,2,13175,9033,51,11
131600,007700,109500,5,1000,-0.9,53.13,50550,26855,-23695,4858,2771,-2087,79801,109500,109500,109500,8,0,1,13251,8907,0,8
131600,007700,109000,5,1500,-1.36,53.11,50617,26883,-23734,4872,2776,-2096,79896,109500,109500,109000,103,14,6,13232,8792,67,36
131700,007700,109500,5,1000,-0.9,53.15,50666,26929,-23737,4877,2784,-2093,79991,109000,109500,109000,71,4,5,13316,8873,42,29
131700,007700,109500,5,1000,-0.9,53.2,50700,26970,-23730,4888,2788,-2100,80066,109000,109500,109000,146,15,9,13361,9072,76,70
131800,007700,109500,5,1000,-0.9,53.28,50714,27021,-23693,4893,2795,-2098,80131,109000,109500,109000,57,5,5,13371,9081,14,43
131900,007700,109000,5,1500,-1.36,53.23,50819,27049,-23770,4908,2800,-2108,80264,109000,109000,109000,21,4,0,13700,9072,21,0
131900,007700,109000,5,1500,-1.36,53.24,50892,27094,-23798,4916,2808,-2108,80382,109000,109500,109000,139,12,8,13724,9117,94,45
132000,007700,109000,5,1500,-1.36,53.28,50928,27136,-23792,4924,2817,-2107,80460,109000,109500,109000,60,7,5,13736,9152,29,31
132100,007700,109000,5,1500,-1.36,53.26,51055,27192,-23863,4935,2825,-2110,80643,109000,109000,109000,8,2,0,13711,8926,8,0
132100,007700,109000,5,1500,-1.36,53.31,51098,27239,-23859,4945,2830,-2115,80733,109000,109500,109000,98,12,5,13705,8929,51,47
132200,007700,109000,5,1500,-1.36,53.53,51235,27424,-23811,4954,2837,-2117,81055,109000,109000,109000,290,6,4,10935,8947,122,168
132200,007700,109000,5,1500,-1.36,53.64,51270,27500,-23770,4968,2852,-2116,81166,109000,109500,109000,401,20,19,13515,9435,157,244
132300,007700,109500,5,1000,-0.9,53.64,51326,27533,-23793,4976,2858,-2118,81255,109000,109500,109000,86,8,5,13514,9291,56,30
132400,007700,109000,5,1500,-1.36,54.02,51363,27747,-23616,4986,2873,-2113,81506,109000,109500,109000,65,2,6,15772,9402,3,62
132400,007700,109000,5,1500,-1.36,53.99,51430,27766,-23664,4992,2877,-2115,81592,109000,110000,109000,151,8,10,15924,9581,70,81
132500,007700,109000,5,1500,-1.36,54.06,51456,27816,-23640,5000,2886,-2114,81682,109500,110000,109000,83,7,7,15909,9661,25,44
132600,007700,109000,5,1500,-1.36,54.08,51488,27845,-23643,5007,2896,-2111,81743,109000,109000,109000,0,0,0,13200,9599,0,0
132600,007700,109500,5,1000,-0.9,54.03,51630,27895,-23735,5019,2908,-2111,81935,109000,109500,109000,192,12,12,13335,9446,142,50
132700,007700,109500,5,1000,-0.9,54.09,51675,27953,-23722,5023,2920,-2103,82038,109000,109500,109000,54,3,4,15380,9522,42,12
132700,007700,109000,5,1500,-1.36,54.05,51777,27988,-23789,5036,2926,-2110,82175,109000,109500,109000,191,16,10,15483,9368,144,47
132800,007700,109000,5,1500,-1.36,54.08,51839,28032,-23807,5046,2934,-2112,82281,109000,109500,109000,106,10,8,15468,9330,62,44
132900,007700,109000,5,1500,-1.36,53.97,51972,28051,-23921,5063,2937,-2126,82433,109000,109000,109000,43,4,0,15488,9234,43,0
132900,007700,109500,5,1000,-0.9,53.98,52107,28125,-23982,5078,2949,-2129,82642,109000,109500,109000,252,19,12,15420,9087,178,74
133000,007700,109000,5,1500,-1.36,53.99,52141,28150,-23991,5085,2954,-2131,82701,109000,109500,109000,45,3,5,15458,9176,20,25
133100,007700,109500,5,1000,-0.9,54.01,52158,28169,-23989,5090,2958,-2132,82737,109500,109500,109500,0,0,0,15466,9195,0,0
133100,007700,109500,5,1000,-0.9,54.03,52209,28211,-23998,5103,2965,-2138,82830,109000,109500,109000,93,13,7,15540,9182,51,42
133200,007700,109500,5,1000,-0.9,54.08,52281,28275,-24006,5112,2975,-2137,82966,109000,109500,109000,62,3,7,15581,9139,14,48
133200,007700,108500,5,2000,-1.81,54.11,52388,28347,-24041,5126,2987,-2139,83145,109000,109500,108500,241,17,19,12805,9153,121,120
133300,007700,109500,5,1000,-0.9,54.34,52394,28473,-23921,5129,2998,-2131,83277,109000,109500,109000,110,2,10,15424,9152,4,106
133400,007700,109000,5,1500,-1.36,54.36,52448,28512,-23936,5141,3005,-2136,83370,108500,109000,108500,28,4,2,15424,9088,17,11
133400,007700,109500,5,1000,-0.9,54.36,52572,28580,-23992,5150,3015,-2135,83562,108500,109500,108500,220,13,12,15374,9179,141,79
133500,007700,109500,5,1000,-0.9,54.49,52595,28659,-23936,5162,3029,-2133,83664,109500,109500,109000,95,6,14,15367,9212,16,79
133600,007700,109000,5,1500,-1.36,54.55,52626,28709,-23917,5171,3036,-2135,83745,109000,109500,109000,25,3,1,15440,9314,22,3
133600,007700,109000,5,1500,-1.36,54.44,52754,28717,-24037,5189,3038,-2151,83881,109000,109500,109000,161,21,3,15554,9159,150,11
133700,007700,109500,5,1000,-0.9,54.48,52814,28771,-24043,5194,3048,-2146,83995,109500,109500,109000,41,4,3,15560,9155,21,20
133800,007700,109500,5,1000,-0.9,54.56,52829,28823,-24006,5200,3061,-2139,84062,109500,109500,109500,0,0,0,15641,9140,0,0
133800,007700,109000,5,1500,-1.36,54.71,52929,28960,-23969,5215,3077,-2138,84299,109500,109500,108500,237,15,16,15605,9179,100,137
133900,007700,109500,5,1000,-0.9,54.77,52947,28998,-23949,5219,3082,-2137,84355,109000,109500,109000,9,1,2,15614,9243,1,8
133900,007700,109000,5,1500,-1.36,54.82,52977,29041,-23936,5228,3087,-2141,84428,109000,109500,108500,82,10,7,12881,9292,31,51
134000,007700,108500,5,2000,-1.81,54.89,53040,29113,-23927,5235,3100,-2135,84563,109000,109000,108500,107,6,7,12872,9294,62,45
134100,007700,109500,5,1000,-0.9,54.98,53079,29183,-23896,5242,3118,-2124,84672,109500,109500,109500,6,0,1,15616,9381,0,6
134100,007700,109000,5,1500,-1.36,54.96,53186,29232,-23954,5257,3132,-2125,84828,109500,109500,108500,162,15,15,12962,9307,107,55
134200,007700,109000,5,1500,-1.36,55.05,53238,29308,-23930,5262,3145,-2117,84956,108500,109000,108500,32,2,6,12942,9477,2,30
134200,007700,109000,5,1500,-1.36,55.13,53258,29362,-23896,5267,3154,-2113,85030,108500,109000,108500,106,7,15,12905,9595,22,84
134300,007700,109000,5,1500,-1.36,55.2,53289,29414,-23875,5275,3167,-2108,85113,108500,109500,108500,64,7,9,12999,9809,30,34
134400,007700,109000,5,1500,-1.36,55.32,53367,29525,-23842,5288,3184,-2104,85302,109000,109000,109000,40,4,0,15742,10041,40,0
134400,007700,109000,5,1500,-1.36,55.4,53418,29593,-23825,5297,3196,-2101,85435,109000,109500,108500,173,13,12,12943,10233,91,68
134500,007700,109000,5,1500,-1.36,55.43,53443,29625,-23818,5303,3202,-2101,85492,109000,109000,108500,46,4,4,12934,10033,22,24
134600,007700,109500,5,1000,-0.9,55.56,53501,29723,-23778,5317,3213,-2104,85648,109500,109500,109500,2,0,1,15751,10188,0,2
134600,007700,109500,5,1000,-0.9,55.6,53523,29760,-23763,5324,3220,-2104,85707,109500,109500,108500,61,7,8,15794,10211,22,39
134700,007700,109000,5,1500,-1.36,55.79,53595,29903,-23692,5334,3239,-2095,85922,109000,109500,109000,21,0,3,12996,10298,0,21
134700,007700,109500,5,1000,-0.9,55.89,53631,29977,-23654,5346,3255,-2091,86032,109000,109500,108500,131,12,19,15948,10218,36,95
134800,007700,109500,5,1000,-0.9,55.92,53649,30001,-23648,5351,3261,-2090,86074,109000,109500,108500,40,3,6,15942,9933,16,24
134900,007700,109000,5,1500,-1.36,55.92,53718,30037,-23681,5363,3272,-2091,86179,109000,109500,109000,13,2,3,16015,9975,6,7
134900,007700,109000,5,1500,-1.36,56.02,53757,30113,-23644,5366,3285,-2081,86294,109000,109500,108500,128,5,16,13571,10019,45,83
135000,007700,109000,5,1500,-1.36,56.08,53775,30157,-23618,5371,3293,-2078,86356,109000,109000,109000,9,2,1,13658,10030,7,2
135100,007700,108500,5,2000,-1.81,56.19,53800,30231,-23569,5382,3306,-2076,86455,108500,108500,108500,0,0,0,14414,9987,0,0
135100,007700,108500,5,2000,-1.81,56.2,53864,30270,-23594,5399,3313,-2086,86558,108500,109000,108500,103,17,7,14395,9733,64,39
135200,007700,109000,5,1500,-1.36,56.15,53986,30315,-23671,5406,3325,-2081,86725,109000,109000,108500,86,5,5,14398,9464,73,13
135200,007700,108500,5,2000,-1.81,56.32,54010,30418,-23592,5411,3344,-2067,86852,109000,109000,108500,213,10,24,14331,9785,97,116
135300,007700,108500,5,2000,-1.81,56.31,54076,30452,-23624,5421,3352,-2069,86952,109000,109000,108500,82,7,6,14317,9969,56,26
135400,007700,108500,5,2000,-1.81,56.94,54206,30867,-23339,5437,3372,-2065,87497,108500,109000,108500,32,5,1,11913,9918,31,1
135400,007700,109500,5,1000,-0.9,56.95,54287,30915,-23372,5449,3380,-2069,87626,108500,109500,108500,161,17,9,14756,9870,112,49
135500,007700,109000,5,1500,-1.36,57.06,54358,31019,-23339,5454,3394,-2060,87801,108500,109000,108500,70,3,10,12563,10170,8,62
135500,007700,109000,5,1500,-1.36,57.28,54439,31180,-23259,5465,3409,-2056,88043,108500,109500,108500,312,14,25,15190,9973,89,223
135600,007700,109500,5,1000,-0.9,57.22,54566,31221,-23345,5488,3416,-2072,88211,108500,109500,108500,168,23,7,15103,10076,127,41
135700,007700,109000,5,1500,-1.36,57.34,54610,31313,-23297,5496,3430,-2066,88347,109500,109500,109000,2,1,1,15052,9931,1,1
135700,007700,109000,5,1500,-1.36,57.32,54718,31366,-23352,5511,3443,-2068,88508,109500,109500,108500,163,16,14,15045,9998,109,54
135800,007700,109500,5,1000,-0.9,57.5,54768,31494,-23274,5519,3458,-2061,88686,109500,109500,108500,125,2,14,14965,10300,2,123
135900,007700,109000,5,1500,-1.36,57.58,54800,31553,-23247,5526,3470,-2056,88777,109000,109000,109000,2,0,2,12181,10114,0,2
135900,007700,109000,5,1500,-1.36,57.65,54874,31636,-23238,5539,3482,-2057,88934,109000,109000,108500,159,13,14,12291,10261,74,85
140000,007700,109000,5,1500,-1.36,57.82,54894,31738,-23156,5544,3492,-2052,89056,108500,109000,108500,38,1,2,13340,10247,8,30
140100,007700,108500,5,2000,-1.81,57.95,54963,31852,-23111,5557,3508,-2049,89239,108500,108500,108500,21,2,0,16014,10248,21,0
140100,007700,108500,5,2000,-1.81,58.04,55042,31949,-23093,5571,3523,-2048,89415,108500,109000,108500,197,16,15,13288,10121,100,97
140200,007700,109500,5,1000,-0.9,58.11,55091,32013,-23078,5575,3533,-2042,89528,109000,109500,109000,29,3,2,16099,10902,10,19
140200,007700,109500,5,1000,-0.9,58.17,55158,32086,-23072,5589,3543,-2046,89668,109000,109500,109000,169,17,12,16100,10769,77,92
140300,007700,109500,5,1000,-0.9,58.33,55166,32178,-22988,5594,3555,-2039,89768,109500,109500,109000,72,5,9,16033,10551,8,64
140400,007700,109000,5,1500,-1.36,58.3,55260,32219,-23041,5606,3560,-2046,89903,109500,109500,109000,63,1,1,15902,10532,40,23
140400,007700,109000,5,1500,-1.36,58.46,55266,32308,-22958,5610,3576,-2034,89998,109500,109500,109000,158,5,17,15851,10520,46,112
140500,007700,109500,5,1000,-0.9,58.46,55361,32362,-22999,5625,3582,-2043,90147,109500,109500,108500,134,14,4,15848,11131,87,47
140600,007700,109500,5,1000,-0.9,59.47,55362,32926,-22436,5626,3595,-2031,90712,109500,109500,109500,0,0,0,15646,11376,0,0
140600,007700,109500,5,1000,-0.9,59.54,55451,33016,-22435,5640,3612,-2028,90891,110000,110000,109000,179,14,17,18238,10706,89,90
140700,007700,110000,5,500,-0.45,59.7,55456,33107,-22349,5643,3624,-2019,90987,110000,110000,110000,64,0,9,18190,10709,0,64
140700,007700,109500,5,1000,-0.9,59.75,55510,33168,-22342,5652,3631,-2021,91102,110000,110000,109500,179,9,16,18160,10682,54,125
140800,007700,109500,5,1000,-0.9,59.81,55571,33236,-22335,5666,3642,-2024,91231,109500,110000,109500,120,13,9,18276,11058,59,61
140900,007700,110000,5,500,-0.45,59.88,55638,33314,-22324,5675,3653,-2022,91376,109500,110000,109500,64,2,5,17028,11194,41,23
140900,007700,109500,5,1000,-0.9,59.95,55672,33376,-22296,5681,3662,-2019,91472,109500,110000,109500,160,8,14,17719,11354,75,85
141000,007700,110000,5,500,-0.45,60.4,55706,33646,-22060,5688,3679,-2009,91776,109500,110000,109500,186,5,14,17487,11253,19,167
141100,007700,110000,5,500,-0.45,60.61,55742,33787,-21955,5695,3685,-2010,91953,110000,110000,110000,0,0,0,17494,11367,0,0
141100,007700,110500,3,0,0.0,60.65,55856,33876,-21980,5714,3699,-2015,92156,110000,110500,109500,203,19,14,19670,8609,114,89
141200,007700,110000,5,500,-0.45,60.73,55880,33936,-21944,5718,3707,-2011,92240,110000,110000,109500,56,3,5,19649,8659,21,35
141200,007700,110000,5,500,-0.45,60.81,55893,33991,-21902,5721,3717,-2004,92313,110000,110500,109500,129,6,15,19564,8674,34,90
141300,007700,110000,5,500,-0.45,60.95,55941,34097,-21844,5734,3732,-2002,92467,110500,110500,110000,151,12,15,19515,8727,45,106
141400,007700,110000,5,500,-0.45,60.99,55993,34148,-21845,5740,3739,-2001,92570,110000,110500,110000,59,4,4,19476,8504,48,11
141400,007700,109500,5,1000,-0.9,61.07,56046,34228,-21818,5752,3750,-2002,92703,110000,110500,109500,192,16,15,19766,10728,101,91
141500,007700,110500,3,0,0.0,61.19,56052,34300,-21752,5756,3761,-1995,92781,110500,110500,110000,75,2,11,19762,8323,3,72
141600,007700,110500,3,0,0.0,61.18,56130,34339,-21791,5771,3765,-2006,92898,110000,110500,110000,39,8,2,19735,8125,33,6
141600,007700,109500,5,1000,-0.9,61.27,56202,34433,-21769,5779,3782,-1997,93064,110000,110500,109500,205,16,19,17499,10646,105,100
141700,007700,109500,5,1000,-0.9,61.3,56271,34494,-21777,5793,3792,-2001,93194,110000,110000,109500,129,13,10,17456,10484,68,61
141800,007700,110000,5,500,-0.45,61.35,56328,34557,-21771,5804,3799,-2005,93314,110000,110000,110000,7,0,1,17498,10609,0,7
141800,007700,110500,3,0,0.0,61.44,56367,34633,-21734,5813,3812,-2001,93429,110000,110500,109500,122,9,14,19699,10586,39,83
141900,007700,110000,5,500,-0.45,61.4,56477,34677,-21800,5826,3818,-2008,93583,110000,110500,110000,77,6,4,18936,8251,48,29
141900,007700,110500,3,0,0.0,61.52,56506,34760,-21746,5830,3830,-2000,93695,110000,110500,110000,189,10,16,18891,8245,77,112
142000,007700,109500,5,1000,-0.9,61.54,56580,34819,-21761,5844,3839,-2005,93828,110500,110500,109500,125,14,8,16726,10810,74,51
142100,007700,109500,5,1000,-0.9,61.57,56631,34869,-21762,5858,3844,-2014,93929,110000,110000,109500,35,10,1,16667,10695,29,6
142100,007700,110000,5,500,-0.45,61.14,57194,34967,-22227,5875,3860,-2015,94590,110000,110000,109500,696,27,17,16955,10127,592,104
142200,007700,109500,5,1000,-0.9,61.17,57237,35014,-22223,5885,3867,-2018,94680,109500,110000,109500,64,8,5,17132,10122,40,24
142200,007700,109500,5,1000,-0.9,61.2,57294,35063,-22231,5894,3874,-2020,94786,109500,110000,109500,170,17,12,17117,10065,97,73
142300,007700,109500,5,1000,-0.9,61.12,57466,35125,-22341,5922,3884,-2038,95020,109500,110000,109500,232,27,10,17159,10153,170,62
142400,007700,110000,5,500,-0.45,61.14,57570,35196,-22374,5933,3896,-2037,95195,109500,110000,109500,37,1,5,17136,9999,14,23
142400,007700,109500,5,1000,-0.9,61.16,57604,35232,-22372,5939,3905,-2034,95265,109500,110000,109500,107,7,14,17121,10093,48,59
142500,007700,109000,5,1500,-1.36,60.79,58065,35300,-22765,5954,3919,-2035,95794,109000,109500,109000,500,11,10,14190,9325,445,55
142600,007700,109000,5,1500,-1.36,60.67,58193,35307,-22886,5976,3921,-2055,95929,108500,109000,108500,34,8,2,11742,9544,27,7
142600,007700,109000,5,1500,-1.36,60.75,58346,35447,-22899,5996,3929,-2067,96222,108500,109500,108500,327,28,10,11604,9775,180,147
142700,007700,108500,5,2000,-1.81,60.81,58380,35498,-22882,6002,3938,-2064,96307,108500,109000,108500,55,5,4,11676,9771,33,22
142700,007700,109000,5,1500,-1.36,60.8,58447,35536,-22911,6010,3949,-2061,96412,108500,109000,108500,160,13,15,11667,9732,100,60
142800,007700,108500,5,2000,-1.81,60.81,58536,35598,-22938,6025,3964,-2061,96563,109000,109000,108500,151,15,15,11744,9900,89,62
142900,007700,108500,5,2000,-1.81,60.78,58646,35643,-23003,6035,3975,-2060,96718,109000,109000,108500,58,4,8,11843,9939,25,33
142900,007700,109000,5,1500,-1.36,60.77,58719,35686,-23033,6049,3980,-2069,96834,109000,109000,108500,174,18,13,11810,10010,98,76
143000,007700,108500,5,2000,-1.81,60.79,58779,35733,-23046,6062,3992,-2070,96941,108500,109000,108500,82,8,10,11881,10063,41,41
143100,007700,108500,5,2000,-1.81,60.83,58862,35806,-23056,6077,4012,-2065,97097,108500,109000,108500,37,3,5,12213,9968,14,23
143100,007700,108500,5,2000,-1.81,60.73,59025,35844,-23181,6087,4023,-2064,97298,108500,109000,108500,238,13,16,12324,9903,177,61
143200,007700,108500,5,2000,-1.81,60.77,59086,35906,-23180,6100,4037,-2063,97421,108500,109000,108500,109,11,12,12130,9992,54,55
143300,007700,108500,5,2000,-1.81,60.76,59185,35960,-23225,6117,4048,-2069,97574,109000,109000,108500,26,1,5,12098,9625,1,25
143300,007700,109000,5,1500,-1.36,60.42,59614,36018,-23596,6137,4060,-2077,98061,109000,109000,108500,513,21,17,12282,9105,430,83
143400,007700,108500,5,2000,-1.81,60.42,59737,36096,-23641,6151,4075,-2076,98262,109000,109000,108500,125,8,10,12278,9238,63,62
143400,007700,109000,5,1500,-1.36,60.39,59781,36104,-23677,6157,4078,-2079,98314,109000,109000,108500,177,14,13,12270,9190,107,70
143500,007700,108500,5,2000,-1.81,60.39,59858,36148,-23710,6166,4087,-2079,98435,109000,109000,108500,114,9,8,12138,9200,77,37
143600,007700,108500,5,2000,-1.81,60.4,59973,36221,-23752,6188,4098,-2090,98623,108500,108500,108500,38,4,0,12189,9179,38,0
143600,007700,109000,5,1500,-1.36,60.48,60215,36419,-23796,6197,4109,-2088,99063,108500,109000,108000,478,13,11,12087,9020,280,198
143700,007700,108500,5,2000,-1.81,60.59,60260,36514,-23746,6207,4120,-2087,99203,108500,109000,108500,38,7,4,12042,9716,22,16
143800,007700,109000,5,1500,-1.36,60.56,60355,36550,-23805,6221,4128,-2093,99334,108500,109000,108500,15,2,1,12033,9618,14,1
143800,007700,108500,5,2000,-1.81,60.52,60413,36564,-23849,6233,4133,-2100,99406,108500,109000,108500,87,14,6,12075,9648,72,15
143900,007700,108500,5,2000,-1.81,60.53,60523,36632,-23891,6248,4144,-2104,99584,109000,109000,108500,54,7,3,11981,9720,42,12
143900,007700,109000,5,1500,-1.36,60.61,60558,36703,-23855,6253,4160,-2093,99690,109000,109000,108500,160,12,19,11977,9753,77,83
144000,007700,109000,5,1500,-1.36,60.26,60952,36728,-24224,6267,4166,-2101,100109,109000,109000,108500,416,13,6,11980,9379,391,25
144100,007700,108500,5,2000,-1.81,60.35,61090,36868,-24222,6285,4174,-2111,100387,108500,108500,108500,186,2,2,13886,9603,71,115
144100,007700,108500,5,2000,-1.81,60.23,61237,36886,-24351,6308,4180,-2128,100552,108500,109000,108500,351,25,8,14216,10162,218,133
144200,007700,109000,5,1500,-1.36,60.29,61265,36936,-24329,6314,4190,-2124,100630,108500,109000,108500,31,5,5,14809,10125,22,9
144200,007700,108500,5,2000,-1.81,60.31,61350,37003,-24347,6327,4205,-2122,100782,108500,109000,108500,183,18,20,14839,10256,107,76
144300,007700,109000,5,1500,-1.36,60.28,61415,37022,-24393,6340,4212,-2128,100866,109000,109000,108500,84,13,7,14902,10218,65,19
144400,007700,108500,5,2000,-1.81,58.32,63533,37054,-26479,6354,4220,-2134,103016,109000,109000,108500,2021,5,3,14883,9702,2015,6
144400,007700,109000,5,1500,-1.36,58.62,63586,37273,-26313,6368,4236,-2132,103288,109000,109000,108500,2293,19,19,15000,9881,2068,225
144500,007700,109000,5,1500,-1.36,58.7,63668,37371,-26297,6378,4246,-2132,103468,108500,109000,108500,94,9,6,14916,9591,70,24
144600,007700,109000,5,1500,-1.36,59.35,63702,37809,-25893,6384,4267,-2117,103940,108500,109000,108500,18,1,2,14541,9538,11,7
144600,007700,109000,5,1500,-1.36,59.36,63857,37906,-25951,6404,4280,-2124,104192,108500,109000,108500,270,21,15,14459,11482,166,104
144700,007700,109500,5,1000,-0.9,60.06,63916,38390,-25526,6411,4294,-2117,104735,109000,109500,109000,59,5,2,13174,12115,57,2
144700,007700,109500,5,1000,-0.9,60.39,63974,38636,-25338,6426,4309,-2117,105039,109000,109500,109000,363,20,17,13011,12046,115,248
144800,007700,109500,5,1000,-0.9,60.72,64058,38893,-25165,6445,4321,-2124,105380,109000,109500,109000,299,19,10,12891,12432,84,215
144900,007700,110000,5,500,-0.45,61.08,64121,39164,-24957,6450,4344,-2106,105714,109500,110000,109500,71,1,6,15781,12544,7,64
144900,007700,110000,5,500,-0.45,61.36,64191,39390,-24801,6460,4361,-2099,106010,109500,110000,109500,367,11,23,15659,12354,77,290
145000,007700,109500,5,1000,-0.9,61.49,64225,39490,-24735,6470,4375,-2095,106144,110000,110000,109500,110,7,12,15529,12453,22,88
145100,007700,109500,5,1000,-0.9,61.76,64310,39720,-24590,6487,4385,-2102,106459,109500,109500,109500,1,1,0,15418,12311,1,0
145100,007700,110000,5,500,-0.45,61.8,64398,39795,-24603,6497,4396,-2101,106622,109500,110000,109500,164,11,11,15362,12414,89,75
145200,007700,109500,5,1000,-0.9,62.1,64478,40041,-24437,6508,4417,-2091,106948,110000,110000,109500,124,5,9,15110,12475,46,78
145200,007700,110500,3,0,0.0,62.32,64518,40210,-24308,6512,4432,-2080,107157,110000,110500,109500,333,9,24,17239,10042,86,247
145300,007700,110000,5,500,-0.45,62.34,64651,40301,-24350,6532,4447,-2085,107381,110500,110500,109500,223,20,14,15129,12337,133,90
145400,007700,110000,5,500,-0.45,62.92,64692,40704,-23988,6542,4470,-2072,107825,110500,110500,109500,76,5,8,15101,12464,22,54
145400,007700,110000,5,500,-0.45,63.23,64762,40946,-23816,6552,4489,-2063,108137,110500,110500,109500,388,15,27,14924,12466,92,296
145500,007700,110500,3,0,0.0,63.43,64782,41089,-23693,6558,4505,-2053,108300,110000,110500,110000,162,5,16,17055,10157,19,143
145600,007700,110000,5,500,-0.45,63.71,64924,41363,-23561,6577,4523,-2054,108716,110500,110500,110000,100,6,5,16831,10059,60,40
145600,007700,110000,5,500,-0.45,63.84,65075,41541,-23534,6593,4541,-2052,109045,110500,110500,109500,429,22,23,14734,12386,211,218
145700,007700,110500,3,0,0.0,64.05,65143,41727,-23416,6604,4557,-2047,109299,110000,110500,110000,162,8,12,16672,10162,58,104
145800,007700,110500,3,0,0.0,64.41,65196,41993,-23203,6616,4576,-2040,109618,110000,110500,110000,116,5,5,16488,10149,34,82
145800,007700,110500,3,0,0.0,64.58,65304,42174,-23130,6634,4598,-2036,109907,110000,110500,110000,405,23,27,16387,10181,142,263
145900,007700,110000,5,500,-0.45,64.77,65657,42524,-23133,6650,4609,-2041,110610,110000,110500,109500,677,13,10,16036,10068,337,340
150000,007700,110000,5,500,-0.45,64.88,65765,42668,-23097,6668,4626,-2042,110862,109500,110000,109500,43,5,2,13773,12339,32,11
150000,007700,109500,5,1000,-0.9,64.93,65823,42740,-23083,6678,4633,-2045,110992,109500,110000,109500,173,15,9,13850,12427,90,83
150100,007700,110000,5,500,-0.45,65.13,65916,42929,-22987,6697,4651,-2046,111274,110000,110000,109500,200,6,9,13578,12528,52,148
150100,007700,110000,5,500,-0.45,65.15,65958,42970,-22988,6703,4659,-2044,111357,110000,110000,109500,283,12,17,13618,12626,94,189
150200,007700,109500,5,1000,-0.9,65.25,65998,43064,-22934,6709,4666,-2043,111491,109500,110000,109500,54,6,5,13548,12530,40,14
150300,007700,110000,5,500,-0.45,65.49,66044,43254,-22790,6717,4678,-2039,111727,110000,110000,109500,26,3,3,13438,12474,11,15
150300,007700,110000,5,500,-0.45,65.76,66051,43438,-22613,6719,4684,-2035,111918,110000,110000,109500,217,5,9,13301,12715,18,199
150400,007700,110500,3,0,0.0,65.83,66110,43517,-22593,6728,4689,-2039,112056,110500,110500,110500,1,0,1,14693,10214,0,1
150400,007700,110500,3,0,0.0,66.08,66123,43692,-22431,6730,4698,-2032,112244,110500,110500,110000,189,2,10,14435,10262,13,176
150500,007700,110000,5,500,-0.45,66.12,66199,43768,-22431,6742,4704,-2038,112396,110000,110500,110000,150,12,5,14418,10177,76,74
150600,007700,110000,5,500,-0.45,66.27,66213,43877,-22336,6747,4711,-2036,112519,110000,110500,110000,69,3,3,14461,10126,11,58
150600,007700,110500,3,0,0.0,66.32,66251,43935,-22316,6753,4719,-2034,112615,110000,110500,110000,165,9,11,14516,10125,49,116
150700,007700,110000,5,500,-0.45,66.38,66312,44020,-22292,6759,4724,-2035,112761,110500,110500,110000,73,2,2,14474,10078,2,71
150700,007700,110000,5,500,-0.45,66.26,66469,44043,-22426,6769,4728,-2041,112941,110500,110500,110000,253,12,6,14708,10179,159,94
150800,007700,110000,5,500,-0.45,66.21,66526,44044,-22482,6778,4729,-2049,112999,110500,110500,110000,58,9,1,14784,10284,57,1
150900,007700,110000,5,500,-0.45,66.13,66662,44085,-22577,6790,4735,-2055,113176,110000,110500,110000,25,5,1,14803,10845,23,2
150900,007700,110000,5,500,-0.45,66.15,66700,44119,-22581,6797,4740,-2057,113248,110000,110500,110000,97,12,6,14817,10369,61,36
151000,007700,110000,5,500,-0.45,65.99,66901,44149,-22752,6799,4744,-2055,113479,110500,110500,110000,231,2,4,15099,10428,201,30
151100,007700,109500,5,1000,-0.9,65.78,67146,44166,-22980,6808,4748,-2060,113741,109500,110000,109500,6,2,1,13446,12631,5,1
151100,007700,109500,5,1000,-0.9,65.79,67197,44210,-22987,6816,4751,-2065,113836,109500,110000,109500,101,10,4,13444,12330,56,45
151200,007700,110000,5,500,-0.45,65.82,67211,44240,-22971,6821,4755,-2066,113880,110000,110000,109500,22,4,3,13451,12295,13,9
151300,007700,110000,5,500,-0.45,66.13,67213,44447,-22766,6823,4762,-2061,114089,109500,110000,109500,182,1,3,13358,12469,1,181
151300,007700,110000,5,500,-0.45,66.61,67223,44778,-22445,6827,4766,-2061,114430,109500,110500,109500,523,5,7,14857,10285,11,512
151400,007700,110000,5,500,-0.45,66.75,67232,44874,-22358,6829,4770,-2059,114535,110500,110500,110000,18,1,1,14980,10093,6,12
151500,007700,110500,3,0,0.0,66.79,67276,44935,-22341,6837,4776,-2061,114640,110500,110500,110500,0,0,0,15069,10139,0,0
151500,007700,110500,3,0,0.0,66.93,67301,45042,-22259,6842,4781,-2061,114772,110500,110500,110000,132,5,5,15111,10089,25,107
151600,007700,110500,3,0,0.0,66.98,67315,45087,-22228,6843,4786,-2057,114831,110500,110500,110500,39,0,3,15107,9963,0,39
151600,007700,110500,3,0,0.0,67.11,67322,45182,-22140,6846,4789,-2057,114933,110500,110500,110000,141,3,6,15258,9829,7,134
151700,007700,110000,5,500,-0.45,67.2,67371,45271,-22100,6855,4795,-2060,115071,110500,110500,110000,137,9,5,15189,9662,49,88
151800,007700,110500,3,0,0.0,67.55,67384,45519,-21865,6859,4804,-2055,115332,110000,110500,110000,28,4,2,14980,9702,13,15
151800,007700,110000,5,500,-0.45,67.58,67563,45657,-21906,6878,4807,-2071,115649,110000,110500,110000,345,23,5,14926,9599,192,153
151900,007700,110000,5,500,-0.45,67.53,67640,45674,-21966,6884,4809,-2075,115743,110000,110500,110000,24,3,2,14883,9571,7,17
152000,007700,109500,5,1000,-0.9,67.29,67876,45674,-22202,6891,4809,-2082,115979,109500,109500,109500,1,1,0,13685,12370,1,0
152000,007700,110000,5,500,-0.45,67.31,67876,45689,-22187,6891,4812,-2079,115994,109500,110000,109500,16,1,3,13673,12329,1,15
152000,007700,110000,5,500,-0.45,67.36,67876,45719,-22157,6891,4815,-2076,116024,109500,110000,109500,46,1,6,13659,12184,1,45
152000,007700,110000,5,500,-0.45,67.36,67876,45719,-22157,6891,4815,-2076,116024,109500,110000,109500,46,1,6,13659,12184,1,45
152000,007700,110000,5,500,-0.45,67.36,67876,45719,-22157,6891,4815,-2076,116024,109500,110000,109500,46,1,6,13659,12184,1,45
152000,007700,110000,5,500,-0.45,67.36,67876,45719,-22157,6891,4815,-2076,116024,109500,110000,109500,46,1,6,13659,12184,1,45
152000,007700,110000,5,500,-0.45,67.36,67876,45719,-22157,6891,4815,-2076,116024,109500,110000,109500,46,1,6,13659,12184,1,45
152000,007700,110000,5,500,-0.45,67.36,67876,45719,-22157,6891,4815,-2076,116024,109500,110000,109500,46,1,6,13659,12184,1,45
152000,007700,110000,5,500,-0.45,67.36,67876,45719,-22157,6891,4815,-2076,116024,109500,110000,109500,46,1,6,13659,12184,1,45
152000,007700,110000,5,500,-0.45,67.36,67876,45719,-22157,6891,4815,-2076,116024,109500,110000,109500,46,1,6,13659,12184,1,45
152000,007700,110000,5,500,-0.45,67.36,67876,45719,-22157,6891,4815,-2076,116024,109500,110000,109500,46,1,6,13659,12184,1,45
152000,007700,110000,5,500,-0.45,67.36,67876,45719,-22157,6891,4815,-2076,116024,109500,110000,109500,46,1,6,13659,12184,1,45
152000,007700,110000,5,500,-0.45,67.36,67876,45719,-22157,6891,4815,-2076,116024,109500,110000,109500,46,1,6,13659,12184,1,45
152000,007700,110000,5,500,-0.45,67.36,67876,45719,-22157,6891,4815,-2076,116024,109500,110000,109500,46,1,6,13659,12184,1,45
152000,007700,110000,5,500,-0.45,67.36,67876,45719,-22157,6891,4815,-2076,116024,109500,110000,109500,46,1,6,13659,12184,1,45
152000,007700,110000,5,500,-0.45,67.36,67876,45719,-22157,6891,4815,-2076,116024,109500,110000,109500,46,1,6,13659,12184,1,45
152000,007700,110000,5,500,-0.45,67.36,67876,45719,-22157,6891,4815,-2076,116024,109500,110000,109500,46,1,6,13659,12184,1,45
152000,007700,110000,5,500,-0.45,67.36,67876,45719,-22157,6891,4815,-2076,116024,109500,110000,109500,46,1,6,13659,12184,1,45
152000,007700,110000,5,500,-0.45,67.36,67876,45719,-22157,6891,4815,-2076,116024,109500,110000,109500,46,1,6,13659,12184,1,45
153000,007700,110000,5,500,-0.45,67.36,67876,45719,-22157,6891,4815,-2076,116024,110000,110000,110000,0,0,0,13549,12183,0,0
153000,007700,110000,5,500,-0.45,67.36,67876,45719,-22157,6891,4815,-2076,116614,110000,110000,110000,590,0,0,13549,12183,0,0
