091800,205100,2855,2,50,1.78,59.89,172081,103055,-69026,326,224,-102,318370,2870,2870,2850,13302,24,19,10844,44550,9082,4220
091800,205100,2865,2,60,2.14,59.86,172584,103308,-69276,327,228,-99,319126,2870,2870,2850,14058,25,23,12864,41649,9585,4473
091800,205100,2865,2,60,2.14,60.18,172584,103855,-68729,327,229,-98,319673,2870,2870,2850,14605,25,24,16343,38497,9585,5020
092100,205100,2865,2,60,2.14,60.17,172594,103855,-68739,328,229,-99,319683,2865,2865,2865,0,0,0,21999,34210,0,0
092100,205100,2865,2,60,2.14,60.13,172716,103855,-68861,330,229,-101,319805,2865,2865,2865,122,2,0,22319,34133,122,0
092100,205100,2865,2,60,2.14,60.18,172716,103945,-68771,330,230,-100,319895,2865,2865,2865,212,2,1,11955,45470,122,90
092100,205100,2865,2,60,2.14,59.15,177323,104893,-72430,336,232,-104,325450,2865,2865,2850,5767,8,3,11214,45617,4729,1038
092100,205100,2865,2,60,2.14,58.74,178824,105043,-73781,339,233,-106,327101,2865,2865,2850,7418,11,4,10213,44116,6230,1188
092100,205100,2865,2,60,2.14,58.74,178824,105043,-73781,339,233,-106,327101,2865,2865,2850,7418,11,4,10213,44116,6230,1188
092400,205100,2865,2,60,2.14,58.74,178824,105043,-73781,339,233,-106,327101,2865,2865,2865,0,0,0,10084,40687,0,0
092400,205100,2850,2,45,1.6,58.15,180645,105043,-75602,341,233,-108,328922,2855,2855,2850,1821,2,0,11797,45141,1821,0
092400,205100,2850,2,45,1.6,53.78,195953,105393,-90560,359,235,-124,344580,2855,2855,2845,17479,20,2,10365,34607,17129,350
092400,205100,2850,2,45,1.6,53.61,197573,105913,-91660,362,237,-125,346720,2855,2855,2845,19619,23,4,7908,37706,18749,870
092400,205100,2845,2,40,1.43,53.34,198751,106016,-92735,365,239,-126,348001,2855,2855,2845,20900,26,6,12995,35767,19927,973
092400,205100,2835,2,30,1.07,52.12,203422,106016,-97406,371,239,-132,352672,2855,2855,2835,25571,32,6,12665,39749,24598,973
092700,205100,2835,2,30,1.07,52.49,203873,107016,-96857,375,240,-135,354123,2835,2840,2835,1451,4,1,11144,33637,451,1000
092700,205100,2835,2,30,1.07,52.81,204173,107823,-96350,376,245,-131,355230,2835,2840,2835,2558,5,6,9310,34813,751,1807
092700,205100,2835,2,30,1.07,51.95,207537,107823,-99714,381,245,-136,358594,2835,2840,2835,5922,10,6,7497,33088,4115,1807
092700,205100,2835,2,30,1.07,51.98,209347,108823,-100524,382,246,-136,361404,2835,2840,2830,8732,11,7,8619,31959,5925,2807
092700,205100,2835,2,30,1.07,52.03,209347,108923,-100424,382,248,-134,361504,2835,2840,2830,8832,11,9,8502,33404,5925,2907
092700,205100,2835,2,30,1.07,52.56,209347,110023,-99324,382,250,-132,362604,2835,2840,2830,9932,11,11,6837,32909,5925,4007
093000,205100,2835,2,30,1.07,52.92,209347,110794,-98553,382,256,-126,363375,2835,2835,2835,0,0,0,6183,33909,0,0
093000,205100,2835,2,30,1.07,52.92,209347,110794,-98553,382,256,-126,363375,2835,2835,2835,0,0,0,6183,33909,0,0
093000,205100,2835,2,30,1.07,52.89,209468,110794,-98674,384,256,-128,363496,2830,2835,2830,121,2,0,7395,32017,121,0
093000,205100,2830,2,25,0.89,52.2,212259,110794,-101465,388,256,-132,366287,2830,2835,2830,2912,6,0,7395,30274,2912,0
093000,205100,2840,2,35,1.25,52.2,212259,110804,-101455,388,257,-131,366297,2830,2840,2830,2922,6,1,8895,29601,2912,10
093000,205100,2840,2,35,1.25,52.21,212259,110814,-101445,388,258,-130,366307,2830,2840,2830,2932,6,2,8885,30177,2912,20
093300,205100,2835,2,30,1.07,51.42,216030,111075,-104955,392,259,-133,370339,2835,2835,2830,3885,3,1,8517,29181,3624,261
093300,205100,2840,2,35,1.25,50.26,221030,111085,-109945,395,260,-135,375349,2835,2840,2820,8895,6,2,9617,21495,8624,271
093300,205100,2825,2,20,0.71,50.25,221076,111085,-109991,397,260,-137,375395,2835,2840,2820,8941,8,2,15146,24157,8670,271
093300,205100,2825,2,20,0.71,49.63,224212,111275,-112937,401,264,-137,378721,2835,2840,2820,12267,12,6,9322,22149,11806,461
093300,205100,2815,2,10,0.36,48.95,227319,111276,-116043,406,265,-141,381829,2835,2840,2815,15375,17,7,7199,20879,14913,462
093300,205100,2810,2,5,0.18,47.32,235156,111276,-123880,409,265,-144,389666,2835,2840,2810,23212,20,7,10170,20441,22750,462
093600,205100,2805,3,0,0.0,47.09,236967,111576,-125391,413,267,-146,391777,2805,2810,2805,2011,4,1,19679,14491,1811,200
093600,205100,2785,5,20,-0.71,45.07,248264,111889,-136375,429,272,-157,403387,2805,2810,2780,13621,20,6,9690,4317,13108,513
093600,205100,2795,5,10,-0.36,45.11,248264,111987,-136277,429,273,-156,403485,2805,2810,2780,13719,20,7,9789,5012,13108,611
093600,205100,2800,5,5,-0.18,45.05,248564,111989,-136575,430,274,-156,403787,2805,2810,2780,14021,21,8,11019,8615,13408,613
093600,205100,2810,2,5,0.18,45.09,248564,112089,-136475,430,275,-155,403887,2805,2810,2780,14121,21,9,9219,7482,13408,713
093600,205100,2800,5,5,-0.18,44.86,250064,112190,-137874,431,277,-154,405488,2805,2810,2780,15722,22,11,9518,9025,14908,814
093900,205100,2795,5,10,-0.36,44.67,251130,112190,-138940,434,277,-157,406554,2800,2800,2795,1066,3,0,7252,9161,1066,0
093900,205100,2790,5,15,-0.53,44.49,252150,112190,-139960,438,277,-161,407574,2800,2800,2790,2086,7,0,9146,7940,2086,0
093900,205100,2790,5,15,-0.53,44.46,252350,112190,-140160,439,277,-162,407774,2800,2800,2790,2286,8,0,9146,8490,2286,0
093900,205100,2790,5,15,-0.53,44.17,254005,112190,-141815,442,277,-165,409429,2800,2800,2790,3941,11,0,9317,15985,3941,0
093900,205100,2790,5,15,-0.53,44.1,254420,112190,-142230,445,277,-168,409844,2800,2800,2790,4356,14,0,8817,18813,4356,0
094200,205100,2790,5,15,-0.53,44.07,254599,112190,-142409,446,277,-169,410023,2790,2790,2790,0,0,0,9673,19271,0,0
094200,205100,2790,5,15,-0.53,43.25,259402,112190,-147212,449,277,-172,414826,2790,2790,2790,4803,3,0,9494,18423,4803,0
094200,205100,2800,5,5,-0.18,43.09,260402,112198,-148204,450,278,-172,415834,2790,2800,2790,5811,4,1,7121,50265,5803,8
094200,205100,2800,5,5,-0.18,43.09,260402,112198,-148204,450,278,-172,415834,2790,2800,2790,5811,4,1,7121,50265,5803,8
094200,205100,2800,5,5,-0.18,43.09,260402,112198,-148204,450,278,-172,415834,2790,2800,2790,5811,4,1,7121,50265,5803,8
094200,205100,2800,5,5,-0.18,43.09,260402,112198,-148204,450,278,-172,415834,2790,2800,2790,5811,4,1,7121,50265,5803,8
094500,205100,2800,5,5,-0.18,43.01,260882,112198,-148684,452,278,-174,416314,2800,2800,2800,0,0,0,8554,40057,0,0
094500,205100,2790,5,15,-0.53,42.85,261812,112198,-149614,455,278,-177,417244,2800,2800,2790,930,3,0,7354,40207,930,0
094500,205100,2790,5,15,-0.53,42.85,261812,112198,-149614,455,278,-177,417244,2800,2800,2790,930,3,0,7354,40207,930,0
094500,205100,2800,5,5,-0.18,43.0,262390,112820,-149570,457,279,-178,418444,2800,2800,2790,2130,5,1,9389,41044,1508,622
094500,205100,2805,3,0,0.0,43.45,262390,114018,-148372,457,284,-173,419642,2800,2805,2790,3328,5,6,7267,40666,1508,1820
094500,205100,2785,5,20,-0.71,42.34,269278,114018,-155260,461,284,-177,426530,2800,2805,2785,10216,9,6,7290,40539,8396,1820
094800,205100,2790,5,15,-0.53,42.34,269283,114018,-155265,462,284,-178,426535,2790,2790,2790,5,1,0,7290,46001,5,0
094800,205100,2805,3,0,0.0,42.35,269283,114028,-155255,462,285,-177,426545,2790,2805,2790,15,1,1,7639,45714,5,10
094800,205100,2805,3,0,0.0,42.35,269283,114028,-155255,462,285,-177,426545,2790,2805,2790,15,1,1,7639,45714,5,10
094800,205100,2805,3,0,0.0,42.35,269283,114028,-155255,462,285,-177,426545,2790,2805,2790,15,1,1,7639,45714,5,10
094800,205100,2795,5,10,-0.36,42.18,270343,114028,-156315,464,285,-179,427605,2790,2805,2790,1075,3,1,8093,47854,1065,10
094800,205100,2800,5,5,-0.18,42.28,270343,114288,-156055,464,288,-176,427865,2790,2805,2790,1335,3,4,7933,49766,1065,270
095100,205100,2800,5,5,-0.18,42.28,270343,114288,-156055,464,288,-176,427865,2800,2800,2800,0,0,0,7933,49766,0,0
095100,205100,2795,5,10,-0.36,42.27,272102,115029,-157073,467,289,-178,430365,2800,2800,2795,2500,3,1,9855,50364,1759,741
095100,205100,2790,5,15,-0.53,41.87,274765,115031,-159734,469,290,-179,433030,2800,2800,2790,5165,5,2,11000,47764,4422,743
095100,205100,2790,5,15,-0.53,42.01,274765,115435,-159330,469,292,-177,433434,2800,2800,2790,5569,5,4,11517,47764,4422,1147
095100,205100,2785,5,20,-0.71,42.13,275215,115949,-159266,470,296,-174,434398,2800,2800,2785,6533,6,8,10236,48165,4872,1661
095100,205100,2785,5,20,-0.71,41.16,281703,115949,-165754,472,296,-176,440886,2800,2800,2785,13021,8,8,10322,47501,11360,1661
095400,205100,2775,5,30,-1.07,40.7,284905,115951,-168954,479,298,-181,444090,2780,2780,2775,274,2,1,8591,39600,273,1
095400,205100,2785,5,20,-0.71,40.7,284905,115961,-168944,479,299,-180,444100,2780,2785,2775,284,2,2,8408,40266,273,11
095400,205100,2780,5,25,-0.89,40.67,285106,115961,-169145,480,299,-181,444301,2780,2785,2775,485,3,2,8698,40466,474,11
095400,205100,2775,5,30,-1.07,40.64,285306,115961,-169345,481,299,-182,444501,2780,2785,2775,685,4,2,7633,41097,674,11
095400,205100,2775,5,30,-1.07,40.59,285676,115961,-169715,483,299,-184,444871,2780,2785,2775,1055,6,2,7633,41517,1044,11
095400,205100,2770,5,35,-1.25,39.52,293667,116063,-177604,488,301,-187,452964,2780,2785,2770,9148,11,4,7531,37989,9035,113
095700,205100,2775,5,30,-1.07,39.45,295072,116395,-178677,491,304,-187,454701,2775,2775,2775,450,1,2,6223,34721,128,322
095700,205100,2770,5,35,-1.25,39.08,297857,116405,-181452,493,305,-188,457496,2775,2780,2770,3245,3,3,7511,31111,2913,332
095700,205100,2770,5,35,-1.25,39.08,297857,116405,-181452,493,305,-188,457496,2775,2780,2770,3245,3,3,7511,31111,2913,332
095700,205100,2780,5,25,-0.89,39.18,298296,116873,-181423,494,307,-187,458403,2775,2780,2770,4152,4,5,7501,29298,3352,800
095700,205100,2780,5,25,-0.89,39.29,298296,117208,-181088,494,308,-186,458738,2775,2780,2770,4487,4,6,6295,35097,3352,1135
095700,205100,2780,5,25,-0.89,39.29,298352,117208,-181144,496,308,-188,458794,2775,2780,2770,4543,6,6,8208,34626,3408,1135
100000,205100,2785,5,20,-0.71,39.34,298933,117588,-181345,498,310,-188,459755,2785,2785,2785,10,0,1,8018,34808,0,10
100000,205100,2785,5,20,-0.71,39.67,298933,118588,-180345,498,311,-187,460755,2785,2785,2785,1010,0,2,8008,34906,0,1010
100000,205100,2785,5,20,-0.71,39.67,298933,118588,-180345,498,311,-187,460755,2785,2785,2785,1010,0,2,8008,34906,0,1010
100000,205100,2785,5,20,-0.71,39.44,300933,118688,-182245,503,312,-191,462855,2785,2785,2780,3110,5,3,7008,41608,2000,1110
100000,205100,2785,5,20,-0.71,39.47,300934,118768,-182166,504,313,-191,462936,2785,2785,2780,3191,6,4,8028,41244,2001,1190
100000,205100,2790,5,15,-0.53,39.47,300934,118793,-182141,504,315,-189,462961,2785,2790,2780,3216,6,6,8018,45483,2001,1215
100300,205100,2795,5,10,-0.36,39.5,302362,119432,-182930,505,317,-188,465028,2795,2795,2795,10,0,1,7224,46714,0,10
100300,205100,2790,5,15,-0.53,39.3,303898,119432,-184466,507,317,-190,466564,2795,2795,2790,1546,2,1,9014,46607,1536,10
100300,205100,2790,5,15,-0.53,39.3,303898,119432,-184466,507,317,-190,466564,2795,2795,2790,1546,2,1,9014,46607,1536,10
100300,205100,2790,5,15,-0.53,39.47,303898,119961,-183937,507,318,-189,467093,2795,2795,2790,2075,2,2,9613,47367,1536,539
100300,205100,2790,5,15,-0.53,39.45,304077,119961,-184116,508,318,-190,467272,2795,2795,2790,2254,3,2,11633,48877,1715,539
100300,205100,2800,5,5,-0.18,39.85,304077,121161,-182916,508,322,-186,468472,2795,2800,2790,3454,3,6,11004,48878,1715,1739
100600,205100,2800,5,5,-0.18,39.85,304077,121163,-182914,508,323,-185,468474,2800,2800,2800,2,0,1,12125,48838,0,2
100600,205100,2790,5,15,-0.53,39.94,306029,122243,-183786,510,326,-184,471506,2800,2800,2790,3034,2,4,12687,49486,1952,1082
100600,205100,2800,5,5,-0.18,39.95,306029,122253,-183776,510,327,-183,471516,2800,2800,2790,3044,2,5,11926,50386,1952,1092
100600,205100,2800,5,5,-0.18,39.95,306029,122266,-183763,510,328,-182,471529,2800,2800,2790,3057,2,6,8111,57054,1952,1105
100600,205100,2800,5,5,-0.18,39.99,306029,122366,-183663,510,329,-181,471629,2800,2800,2790,3157,2,7,8138,57354,1952,1205
100600,205100,2800,5,5,-0.18,40.34,306029,123437,-182592,510,330,-180,472700,2800,2800,2790,4228,2,8,8438,57364,1952,2276
100900,205100,2805,3,0,0.0,40.91,306029,125184,-180845,510,333,-177,474447,2800,2805,2800,1647,0,2,9328,46604,0,1647
100900,205100,2810,2,5,0.18,40.91,306029,125194,-180835,510,334,-176,474457,2800,2810,2800,1657,0,3,10710,44788,0,1657
100900,205100,2815,2,10,0.36,41.46,306029,126869,-179160,510,337,-173,476132,2800,2815,2800,3332,0,6,11850,44788,0,3332
100900,205100,2810,2,5,0.18,41.52,306229,127134,-179095,511,341,-170,476597,2800,2815,2800,3797,1,10,10686,38541,200,3597
100900,205100,2810,2,5,0.18,41.52,306229,127134,-179095,511,341,-170,476597,2800,2815,2800,3797,1,10,10686,38541,200,3597
100900,205100,2810,2,5,0.18,41.52,306229,127136,-179093,511,343,-168,476599,2800,2815,2800,3799,1,12,9561,44650,200,3599
101200,205100,2810,2,5,0.18,41.52,306229,127136,-179093,511,343,-168,476599,2810,2810,2810,0,0,0,9561,44650,0,0
101200,205100,2800,5,5,-0.18,41.5,306360,127136,-179224,514,343,-171,476730,2805,2805,2800,131,3,0,8653,47556,131,0
101200,205100,2805,3,0,0.0,41.5,306360,127146,-179214,514,344,-170,476740,2805,2805,2800,141,3,1,8653,47653,131,10
101200,205100,2810,2,5,0.18,41.76,306532,128007,-178525,515,347,-168,477773,2805,2810,2800,1174,4,4,8853,45257,303,871
101200,205100,2810,2,5,0.18,41.76,306532,128007,-178525,515,347,-168,477773,2805,2810,2800,1174,4,4,8853,45257,303,871
101200,205100,2810,2,5,0.18,41.81,307032,128382,-178650,516,350,-166,478648,2805,2810,2800,2049,5,7,10118,45700,803,1246
101500,205100,2805,3,0,0.0,41.71,307772,128382,-179390,517,350,-167,479388,2805,2805,2805,740,1,0,9758,45700,740,0
101500,205100,2805,3,0,0.0,41.71,307772,128382,-179390,517,350,-167,479388,2805,2805,2805,740,1,0,9758,45700,740,0
101500,205100,2805,3,0,0.0,41.8,307772,128642,-179130,517,351,-166,479648,2805,2805,2805,1000,1,1,8288,46624,740,260
101500,205100,2810,2,5,0.18,41.8,307772,128645,-179127,517,353,-164,479651,2805,2810,2805,1003,1,3,8558,47000,740,263
101500,205100,2810,2,5,0.18,41.8,307772,128645,-179127,517,353,-164,479651,2805,2810,2805,1003,1,3,8558,47000,740,263
101800,205100,2810,2,5,0.18,42.07,307772,129469,-178303,517,356,-161,480475,2810,2810,2810,0,0,0,8519,47241,0,0
101800,205100,2805,3,0,0.0,41.9,308972,129469,-179503,518,356,-162,481675,2805,2805,2805,1200,1,0,10093,47241,1200,0
101800,205100,2810,2,5,0.18,42.06,308972,129969,-179003,518,358,-160,482175,2805,2810,2805,1700,1,2,8595,46146,1200,500
101800,205100,2810,2,5,0.18,42.01,309373,129970,-179403,519,359,-160,482577,2805,2815,2805,2102,2,3,11561,40138,1601,501
101800,205100,2805,3,0,0.0,41.9,310213,129970,-180243,520,359,-161,483417,2805,2815,2805,2942,3,3,9213,46151,2441,501
101800,205100,2810,2,5,0.18,41.87,310441,129972,-180469,521,360,-161,483647,2805,2815,2800,3172,4,4,8935,46767,2669,503
102100,205100,2810,2,5,0.18,41.87,310441,129972,-180469,521,360,-161,483647,2810,2810,2810,0,0,0,8935,46767,0,0
102100,205100,2800,5,5,-0.18,41.82,311441,130232,-181209,522,361,-161,484907,2810,2810,2800,1260,1,1,10393,51867,1000,260
102100,205100,2800,5,5,-0.18,41.82,311441,130232,-181209,522,361,-161,484907,2810,2810,2800,1260,1,1,10393,51867,1000,260
102100,205100,2800,5,5,-0.18,41.82,311441,130232,-181209,522,361,-161,484907,2810,2810,2800,1260,1,1,10393,51867,1000,260
102100,205100,2805,3,0,0.0,41.94,311441,130624,-180817,522,364,-158,485299,2810,2810,2800,1652,1,4,8913,55365,1000,652
102100,205100,2805,3,0,0.0,41.97,311441,130722,-180719,522,365,-157,485397,2810,2810,2800,1750,1,5,8893,55365,1000,750
102400,205100,2805,3,0,0.0,41.97,311441,130722,-180719,522,365,-157,485397,2805,2805,2805,0,0,0,8893,55365,0,0
102400,205100,2800,5,5,-0.18,41.74,313161,130722,-182439,524,365,-159,487117,2805,2805,2800,1720,2,0,9925,53803,1720,0
102400,205100,2800,5,5,-0.18,41.34,316248,130722,-185526,526,365,-161,490204,2805,2805,2800,4807,4,0,9241,52600,4807,0
102400,205100,2805,3,0,0.0,41.34,316248,130723,-185525,526,366,-160,490205,2805,2805,2800,4808,4,1,9341,50661,4807,1
102400,205100,2800,5,5,-0.18,41.25,316928,130723,-186205,527,366,-161,490885,2805,2805,2800,5488,5,1,9340,51272,5487,1
102400,205100,2800,5,5,-0.18,41.25,316928,130723,-186205,527,366,-161,490885,2805,2805,2800,5488,5,1,9340,51272,5487,1
102700,205100,2800,5,5,-0.18,41.25,316928,130723,-186205,527,366,-161,490885,2800,2800,2800,0,0,0,9340,50602,0,0
102700,205100,2800,5,5,-0.18,41.25,316928,130723,-186205,527,366,-161,490885,2800,2800,2800,0,0,0,9340,50602,0,0
102700,205100,2800,5,5,-0.18,41.2,317298,130723,-186575,528,366,-162,491255,2800,2800,2800,370,1,0,9340,51146,370,0
102700,205100,2800,5,5,-0.18,41.2,317298,130723,-186575,528,366,-162,491255,2800,2800,2800,370,1,0,9340,51146,370,0
102700,205100,2805,3,0,0.0,40.99,319905,131134,-188771,533,368,-165,494273,2800,2805,2800,3388,6,2,9695,53356,2977,411
102700,205100,2800,5,5,-0.18,40.83,321205,131134,-190071,534,368,-166,495573,2800,2805,2800,4688,7,2,9735,52077,4277,411
103000,205100,2800,5,5,-0.18,40.83,321205,131134,-190071,534,368,-166,495573,2800,2800,2800,0,0,0,9735,52077,0,0
103000,205100,2800,5,5,-0.18,40.83,321205,131134,-190071,534,368,-166,495573,2800,2800,2800,0,0,0,9735,52077,0,0
103000,205100,2800,5,5,-0.18,40.83,321205,131134,-190071,534,368,-166,495573,2800,2800,2800,0,0,0,10273,62472,0,0
103000,205100,2800,5,5,-0.18,40.83,321205,131134,-190071,534,368,-166,495573,2800,2800,2800,0,0,0,10273,63672,0,0
103000,205100,2790,5,15,-0.53,39.76,329776,131134,-198642,537,368,-169,504144,2800,2800,2790,8571,3,0,10273,51987,8571,0
103000,205100,2790,5,15,-0.53,39.79,329776,131234,-198542,537,369,-168,504244,2800,2800,2790,8671,3,1,8512,55567,8571,100
103300,205100,2785,5,20,-0.71,39.79,329876,131254,-198622,538,370,-168,504364,2785,2785,2785,0,0,0,8892,55567,0,0
103300,205100,2790,5,15,-0.53,39.65,331013,131256,-199757,539,371,-168,505503,2785,2790,2785,1139,1,1,8901,55332,1137,2
103300,205100,2790,5,15,-0.53,40.09,331013,132687,-198326,539,374,-165,506934,2785,2790,2785,2570,1,4,8877,55432,1137,1433
103300,205100,2790,5,15,-0.53,40.09,331013,132687,-198326,539,374,-165,506934,2785,2790,2785,2570,1,4,8877,55432,1137,1433
103300,205100,2790,5,15,-0.53,40.09,331013,132687,-198326,539,374,-165,506934,2785,2790,2785,2570,1,4,8877,55432,1137,1433
103300,205100,2790,5,15,-0.53,40.09,331013,132687,-198326,539,374,-165,506934,2785,2790,2785,2570,1,4,8877,55432,1137,1433
103600,205100,2790,5,15,-0.53,40.09,331013,132687,-198326,539,374,-165,506934,2790,2790,2790,0,0,0,8102,53157,0,0
103600,205100,2785,5,20,-0.71,40.0,331743,132687,-199056,541,374,-167,507664,2790,2790,2785,730,2,0,8102,53257,730,0
103600,205100,2795,5,10,-0.36,40.0,331743,132688,-199055,541,375,-166,507665,2790,2795,2785,731,2,1,8102,53679,730,1
103600,205100,2790,5,15,-0.53,39.89,332650,132688,-199962,543,375,-168,508572,2790,2795,2785,1638,4,1,8101,53196,1637,1
103600,205100,2790,5,15,-0.53,39.89,332650,132688,-199962,543,375,-168,508572,2790,2795,2785,1638,4,1,8101,53196,1637,1
103600,205100,2790,5,15,-0.53,39.89,332650,132688,-199962,543,375,-168,508572,2790,2795,2785,1638,4,1,8101,53196,1637,1
103900,205100,2785,5,20,-0.71,39.59,335150,132688,-202462,545,375,-170,511072,2790,2790,2785,2500,2,0,8101,52504,2500,0
103900,205100,2790,5,15,-0.53,39.25,338040,132691,-205349,546,377,-169,513965,2790,2790,2785,5393,3,2,8186,49146,5390,3
103900,205100,2790,5,15,-0.53,39.26,338040,132715,-205325,546,389,-157,513989,2790,2790,2785,5417,3,14,8162,49139,5390,27
103900,205100,2790,5,15,-0.53,38.5,344796,132731,-212065,549,397,-152,520761,2790,2790,2775,12189,6,22,8146,42691,12146,43
103900,205100,2790,5,15,-0.53,38.9,345094,134253,-210841,551,399,-152,522581,2790,2790,2775,14009,8,24,8092,42688,12444,1565
103900,205100,2780,5,25,-0.89,38.72,346694,134253,-212441,552,399,-153,524181,2790,2790,2775,15609,9,24,8424,44538,14044,1565
104200,205100,2780,5,25,-0.89,38.72,346694,134253,-212441,552,399,-153,524181,2780,2780,2780,0,0,0,8424,44538,0,0
104200,205100,2780,5,25,-0.89,38.72,346694,134253,-212441,552,399,-153,524181,2780,2780,2780,0,0,0,8424,44538,0,0
104200,205100,2775,5,30,-1.07,38.29,350652,134253,-216399,554,399,-155,528139,2780,2780,2775,3958,2,0,10614,43812,3958,0
104200,205100,2775,5,30,-1.07,38.12,352153,134253,-217900,556,399,-157,529640,2780,2780,2775,5459,4,0,10641,40904,5459,0
104200,205100,2780,5,25,-0.89,38.12,352153,134254,-217899,556,400,-156,529641,2780,2780,2775,5460,4,1,10741,42242,5459,1
104500,205100,2775,5,30,-1.07,38.0,354524,134704,-219820,557,402,-155,532462,2775,2775,2775,0,0,0,8335,39871,0,0
104500,205100,2785,5,20,-0.71,38.0,354524,134706,-219818,557,404,-153,532464,2785,2785,2785,2,0,2,8334,39371,0,2
104500,205100,2785,5,20,-0.71,38.0,354524,134706,-219818,557,404,-153,532464,2785,2785,2785,2,0,2,8334,39371,0,2
104500,205100,2785,5,20,-0.71,38.0,354524,134706,-219818,557,404,-153,532464,2785,2785,2785,2,0,2,8334,39371,0,2
104500,205100,2770,5,35,-1.25,36.79,366133,134706,-231427,560,404,-156,544073,2785,2785,2770,11611,3,2,8333,28182,11609,2
104500,205100,2770,5,35,-1.25,36.79,366133,134706,-231427,560,404,-156,544073,2785,2785,2770,11611,3,2,8333,28182,11609,2
104800,205100,2770,5,35,-1.25,36.79,366133,134706,-231427,560,404,-156,544073,2770,2770,2770,0,0,0,8333,28112,0,0
104800,205100,2785,5,20,-0.71,36.79,366133,134708,-231425,560,405,-155,544075,2785,2785,2785,2,0,1,8433,28086,0,2
104800,205100,2785,5,20,-0.71,36.79,366133,134708,-231425,560,405,-155,544075,2785,2785,2785,2,0,1,8433,28086,0,2
104800,205100,2785,5,20,-0.71,36.79,366133,134708,-231425,560,405,-155,544075,2785,2785,2785,2,0,1,8433,28086,0,2
104800,205100,2785,5,20,-0.71,36.79,366133,134708,-231425,560,405,-155,544075,2785,2785,2785,2,0,1,8433,28086,0,2
104800,205100,2780,5,25,-0.89,36.79,366134,134708,-231426,561,405,-156,544076,2785,2785,2780,3,1,1,8431,28158,1,2
105100,205100,2780,5,25,-0.89,36.79,366134,134708,-231426,561,405,-156,544076,2780,2780,2780,0,0,0,8431,28158,0,0
105100,205100,2775,5,30,-1.07,36.8,366344,134808,-231536,563,406,-157,544386,2785,2785,2775,310,2,1,8331,28398,210,100
105100,205100,2775,5,30,-1.07,36.8,366344,134808,-231536,563,406,-157,544386,2785,2785,2775,310,2,1,8331,28398,210,100
105100,205100,2775,5,30,-1.07,36.8,366344,134808,-231536,563,406,-157,544386,2785,2785,2775,310,2,1,8331,28398,210,100
105100,205100,2775,5,30,-1.07,36.8,366344,134808,-231536,563,406,-157,544386,2785,2785,2775,310,2,1,8331,28398,210,100
105100,205100,2775,5,30,-1.07,36.8,366344,134808,-231536,563,406,-157,544386,2785,2785,2775,310,2,1,8331,28398,210,100
105400,205100,2775,5,30,-1.07,36.8,366344,134808,-231536,563,406,-157,544386,2775,2775,2775,0,0,0,8331,28669,0,0
105400,205100,2775,5,30,-1.07,36.8,366344,134808,-231536,563,406,-157,544386,2775,2775,2775,0,0,0,8331,29169,0,0
105400,205100,2775,5,30,-1.07,36.78,366574,134808,-231766,564,406,-158,544616,2775,2775,2775,230,1,0,8331,29009,230,0
105400,205100,2775,5,30,-1.07,36.77,366646,134808,-231838,565,406,-159,544688,2775,2775,2775,302,2,0,8430,28834,302,0
105400,205100,2775,5,30,-1.07,36.77,366646,134808,-231838,565,406,-159,544688,2775,2775,2775,302,2,0,8430,28834,302,0
105400,205100,2770,5,35,-1.25,36.57,368646,134808,-233838,567,406,-161,546688,2775,2775,2770,2302,4,0,8430,29032,2302,0
105700,205100,2770,5,35,-1.25,36.51,369284,134808,-234476,569,406,-163,547326,2770,2770,2770,638,2,0,8430,27755,638,0
105700,205100,2770,5,35,-1.25,36.51,369284,134808,-234476,569,406,-163,547326,2770,2770,2770,638,2,0,8430,27755,638,0
105700,205100,2770,5,35,-1.25,36.51,369284,134808,-234476,569,406,-163,547326,2770,2770,2770,638,2,0,8430,27755,638,0
105700,205100,2770,5,35,-1.25,36.51,369284,134808,-234476,569,406,-163,547326,2770,2770,2770,638,2,0,8430,27755,638,0
105700,205100,2770,5,35,-1.25,36.51,369284,134808,-234476,569,406,-163,547326,2770,2770,2770,638,2,0,8430,27755,638,0
105700,205100,2770,5,35,-1.25,36.51,369284,134808,-234476,569,406,-163,547326,2770,2770,2770,638,2,0,8430,27755,638,0
110000,205100,2770,5,35,-1.25,36.51,369284,134808,-234476,569,406,-163,547326,2770,2770,2770,0,0,0,5630,27285,0,0
110000,205100,2770,5,35,-1.25,36.51,369284,134808,-234476,569,406,-163,547326,2770,2770,2770,0,0,0,5630,27315,0,0
110000,205100,2770,5,35,-1.25,36.46,369785,134808,-234977,571,406,-165,547827,2775,2775,2770,501,2,0,5630,27628,501,0
110000,205100,2770,5,35,-1.25,36.46,369785,134808,-234977,571,406,-165,547827,2775,2775,2770,501,2,0,5630,27628,501,0
110000,205100,2770,5,35,-1.25,36.46,369785,134808,-234977,571,406,-165,547827,2775,2775,2770,501,2,0,5630,27628,501,0
110000,205100,2770,5,35,-1.25,36.46,369785,134808,-234977,571,406,-165,547827,2775,2775,2770,501,2,0,5630,27628,501,0
110300,205100,2775,5,30,-1.07,36.46,369790,134808,-234982,572,406,-166,547832,2775,2775,2775,0,0,0,5630,24911,0,0
110300,205100,2775,5,30,-1.07,36.46,369790,134808,-234982,572,406,-166,547832,2775,2775,2775,0,0,0,5630,24911,0,0
110300,205100,2775,5,30,-1.07,36.47,369805,134860,-234945,573,408,-165,547899,2775,2775,2775,67,1,2,5775,25840,15,52
110300,205100,2775,5,30,-1.07,36.47,369805,134860,-234945,573,408,-165,547899,2775,2775,2775,67,1,2,5775,25840,15,52
110300,205100,2770,5,35,-1.25,36.4,370510,134860,-235650,575,408,-167,548604,2775,2775,2770,772,3,2,8835,25823,720,52
110300,205100,2765,5,40,-1.43,36.4,370512,134860,-235652,576,408,-168,548606,2775,2775,2765,774,4,2,8835,26573,722,52
110600,205100,2765,5,40,-1.43,36.4,370512,134860,-235652,576,408,-168,548606,2765,2765,2765,0,0,0,8835,26573,0,0
110600,205100,2765,5,40,-1.43,36.4,370512,134860,-235652,576,408,-168,548606,2765,2765,2765,0,0,0,8835,26573,0,0
110600,205100,2765,5,40,-1.43,36.4,370512,134860,-235652,576,408,-168,548606,2765,2765,2765,0,0,0,8734,30199,0,0
110600,205100,2770,5,35,-1.25,36.4,370516,134860,-235656,577,408,-169,548610,2770,2770,2770,4,1,0,8734,30716,4,0
110600,205100,2770,5,35,-1.25,36.4,370516,134860,-235656,577,408,-169,548610,2770,2770,2770,4,1,0,8734,30716,4,0
110600,205100,2770,5,35,-1.25,36.4,370516,134860,-235656,577,408,-169,548610,2770,2770,2770,4,1,0,8734,30716,4,0
110900,205100,2770,5,35,-1.25,36.4,370516,134860,-235656,577,408,-169,548610,2770,2770,2770,0,0,0,8734,30811,0,0
110900,205100,2770,5,35,-1.25,36.4,370516,134860,-235656,577,408,-169,548610,2770,2770,2770,0,0,0,8734,30981,0,0
110900,205100,2770,5,35,-1.25,36.19,372671,134860,-237811,580,408,-172,550765,2770,2770,2770,2155,3,0,10719,30194,2155,0
110900,205100,2770,5,35,-1.25,36.19,372671,134860,-237811,580,408,-172,550765,2770,2770,2770,2155,3,0,10719,30194,2155,0
110900,205100,2770,5,35,-1.25,36.19,372671,134860,-237811,580,408,-172,550765,2770,2770,2770,2155,3,0,10719,30194,2155,0
111200,205100,2770,5,35,-1.25,36.19,372671,134860,-237811,580,408,-172,550765,2770,2770,2770,0,0,0,8784,30946,0,0
111200,205100,2770,5,35,-1.25,36.19,372671,134860,-237811,580,408,-172,550765,2770,2770,2770,0,0,0,8784,30946,0,0
111200,205100,2770,5,35,-1.25,36.13,373291,134860,-238431,581,408,-173,551385,2770,2770,2770,620,1,0,8784,30986,620,0
111200,205100,2770,5,35,-1.25,36.13,373292,134860,-238432,582,408,-174,551386,2770,2770,2770,621,2,0,8784,30366,621,0
111200,205100,2770,5,35,-1.25,36.13,373293,134866,-238427,583,410,-173,551393,2770,2785,2770,628,3,2,8778,30336,622,6
111200,205100,2770,5,35,-1.25,36.12,373364,134869,-238495,585,411,-174,551467,2770,2785,2770,702,5,3,9245,30309,693,9
111500,205100,2770,5,35,-1.25,36.1,373595,134869,-238726,586,411,-175,551698,2770,2770,2770,0,0,0,9245,30273,0,0
111500,205100,2770,5,35,-1.25,36.1,373595,134869,-238726,586,411,-175,551698,2770,2770,2770,0,0,0,9245,30273,0,0
111500,205100,2765,5,40,-1.43,36.0,374595,134869,-239726,588,411,-177,552698,2770,2770,2765,1000,2,0,9434,30044,1000,0
111500,205100,2765,5,40,-1.43,35.95,375158,134869,-240289,589,411,-178,553261,2770,2770,2765,1563,3,0,9464,30278,1563,0
111500,205100,2770,5,35,-1.25,35.95,375158,134870,-240288,589,412,-177,553262,2770,2770,2765,1564,3,1,9254,29715,1563,1
111500,205100,2770,5,35,-1.25,35.97,375182,134970,-240212,590,413,-177,553386,2770,2770,2765,1688,4,2,9770,28935,1587,101
111800,205100,2770,5,35,-1.25,36.16,375682,135853,-239829,591,415,-176,554769,2770,2770,2770,1383,1,2,8994,29928,500,883
111800,205100,2770,5,35,-1.25,36.08,376499,135853,-240646,592,415,-177,555586,2770,2770,2770,2200,2,2,8994,29428,1317,883
111800,205100,2770,5,35,-1.25,36.06,376999,135954,-241045,593,417,-176,556187,2770,2770,2765,2801,3,4,9412,28535,1817,984
111800,205100,2770,5,35,-1.25,36.2,376999,136472,-240527,593,418,-175,556705,2770,2770,2765,3319,3,5,9312,28535,1817,1502
111800,205100,2770,5,35,-1.25,36.2,376999,136472,-240527,593,418,-175,556705,2770,2770,2765,3319,3,5,9312,28535,1817,1502
111800,205100,2765,5,40,-1.43,36.03,378814,136472,-242342,594,418,-176,558520,2770,2770,2765,5134,4,5,9934,28635,3632,1502
112100,205100,2770,5,35,-1.25,36.05,378814,136572,-242242,594,419,-175,558620,2770,2770,2770,100,0,1,9748,26820,0,100
112100,205100,2770,5,35,-1.25,36.05,378814,136572,-242242,594,419,-175,558620,2770,2770,2770,100,0,1,9748,26820,0,100
112100,205100,2770,5,35,-1.25,36.13,378814,136872,-241942,594,420,-174,558920,2770,2770,2770,400,0,2,9648,27020,0,400
112100,205100,2770,5,35,-1.25,36.13,378814,136872,-241942,594,420,-174,558920,2770,2770,2770,400,0,2,9648,27020,0,400
112100,205100,2770,5,35,-1.25,36.12,378914,136872,-242042,596,420,-176,559020,2770,2770,2770,500,2,2,9940,26638,100,400
112100,205100,2770,5,35,-1.25,36.12,378914,136872,-242042,596,420,-176,559020,2770,2770,2770,500,2,2,9940,26638,100,400
112400,205100,2770,5,35,-1.25,36.12,378914,136872,-242042,596,420,-176,559020,2770,2770,2770,0,0,0,10048,27915,0,0
112400,205100,2770,5,35,-1.25,36.12,378914,136872,-242042,596,420,-176,559020,2770,2770,2770,0,0,0,10048,27652,0,0
112400,205100,2770,5,35,-1.25,36.12,378914,136872,-242042,596,420,-176,559020,2770,2770,2770,0,0,0,10048,27762,0,0
112400,205100,2770,5,35,-1.25,36.12,378914,136872,-242042,596,420,-176,559020,2770,2770,2770,0,0,0,9594,27767,0,0
112400,205100,2770,5,35,-1.25,36.12,378914,136872,-242042,596,420,-176,559020,2770,2770,2770,0,0,0,9594,27867,0,0
112400,205100,2770,5,35,-1.25,36.12,378914,136872,-242042,596,420,-176,559020,2770,2770,2770,0,0,0,9594,27967,0,0
112700,205100,2770,5,35,-1.25,36.12,378914,136872,-242042,596,420,-176,559020,2770,2770,2770,0,0,0,9594,27992,0,0
112700,205100,2775,5,30,-1.07,36.48,378914,138243,-240671,596,421,-175,560391,2775,2775,2775,1371,0,1,10470,28192,0,1371
112700,205100,2775,5,30,-1.07,36.48,378914,138243,-240671,596,421,-175,560391,2775,2775,2775,1371,0,1,10470,28192,0,1371
112700,205100,2790,5,15,-0.53,36.85,378915,139616,-239299,597,424,-173,561765,2775,2790,2770,2745,1,4,9099,28241,1,2744
112700,205100,2790,5,15,-0.53,36.85,378915,139616,-239299,597,424,-173,561765,2775,2790,2770,2745,1,4,9099,28241,1,2744
112700,205100,2790,5,15,-0.53,36.85,378915,139616,-239299,597,424,-173,561765,2775,2790,2770,2745,1,4,9099,28241,1,2744
113000,205100,2790,5,15,-0.53,36.85,378915,139626,-239289,597,425,-172,561775,2790,2790,2790,10,0,1,9136,28452,0,10
113000,205100,2790,5,15,-0.53,36.85,378915,139626,-239289,597,425,-172,561775,2790,2790,2790,10,0,1,9136,28452,0,10
113000,205100,2790,5,15,-0.53,36.85,378915,139626,-239289,597,425,-172,561775,2790,2790,2790,10,0,1,9136,28452,0,10
113000,205100,2780,5,25,-0.89,36.83,379137,139626,-239511,598,425,-173,561997,2790,2790,2780,232,1,1,9327,27661,222,10
113000,205100,2790,5,15,-0.53,36.91,379146,139926,-239220,599,426,-173,562306,2790,2790,2780,541,2,2,9273,26842,231,310
113000,205100,2795,5,10,-0.36,36.93,379146,140027,-239119,599,427,-172,562407,2790,2795,2780,642,2,3,9273,27439,231,411
113300,205100,2785,5,20,-0.71,36.92,379246,140027,-239219,600,427,-173,562507,2785,2785,2785,100,1,0,9172,26824,100,0
113300,205100,2785,5,20,-0.71,36.92,379246,140027,-239219,600,427,-173,562507,2785,2785,2785,100,1,0,9172,26824,100,0
113300,205100,2780,5,25,-0.89,36.91,379420,140027,-239393,601,427,-174,562681,2785,2785,2780,274,2,0,9273,27731,274,0
113300,205100,2780,5,25,-0.89,36.91,379420,140027,-239393,601,427,-174,562681,2785,2785,2780,274,2,0,9273,27731,274,0
113300,205100,2780,5,25,-0.89,36.91,379420,140027,-239393,601,427,-174,562681,2785,2785,2780,274,2,0,9273,27731,274,0
113300,205100,2775,5,30,-1.07,36.87,379831,140027,-239804,602,427,-175,563092,2785,2785,2775,685,3,0,9857,27676,685,0
113600,205100,2775,5,30,-1.07,36.87,379831,140027,-239804,602,427,-175,563092,2775,2775,2775,0,0,0,9857,27676,0,0
113600,205100,2770,5,35,-1.25,36.72,381286,140027,-241259,604,427,-177,564547,2770,2770,2770,1455,2,0,11831,27271,1455,0
113600,205100,2770,5,35,-1.25,36.73,381286,140028,-241258,604,428,-176,564548,2770,2770,2770,1456,2,1,12091,29007,1455,1
113600,205100,2770,5,35,-1.25,36.75,381286,140128,-241158,604,429,-175,564648,2770,2770,2770,1556,2,2,12090,29007,1455,101
113600,205100,2770,5,35,-1.25,36.75,381286,140128,-241158,604,429,-175,564648,2770,2770,2770,1556,2,2,12090,29007,1455,101
113900,205100,2760,5,45,-1.6,36.5,383937,140128,-243809,606,429,-177,567299,2760,2760,2760,57,1,0,13460,27769,57,0
113900,205100,2760,5,45,-1.6,36.4,384937,140128,-244809,607,429,-178,568299,2760,2760,2760,1057,2,0,13240,27712,1057,0
113900,205100,2765,5,40,-1.43,36.44,384937,140283,-244654,607,430,-177,568454,2760,2765,2760,1212,2,1,12240,26921,1057,155
113900,205100,2760,5,45,-1.6,36.35,385937,140283,-245654,608,430,-178,569454,2760,2765,2760,2212,3,1,12085,27031,2057,155
113900,205100,2765,5,40,-1.43,36.37,385937,140383,-245554,608,431,-177,569554,2760,2765,2760,2312,3,2,11085,26131,2057,255
113900,205100,2765,5,40,-1.43,36.42,385942,140578,-245364,609,432,-177,569754,2760,2765,2760,2512,4,3,11467,25207,2062,450
114200,205100,2765,5,40,-1.43,36.27,390361,141579,-248782,610,434,-176,575174,2765,2765,2765,1,0,1,10462,23098,0,1
114200,205100,2765,5,40,-1.43,36.27,390361,141579,-248782,610,434,-176,575174,2765,2765,2765,1,0,1,10462,23098,0,1
114200,205100,2765,5,40,-1.43,36.28,390361,141629,-248732,610,435,-175,575224,2765,2765,2765,51,0,2,10821,23100,0,51
114200,205100,2765,5,40,-1.43,36.6,390361,142868,-247493,610,437,-173,576463,2765,2765,2765,1290,0,4,8123,23100,0,1290
114200,205100,2765,5,40,-1.43,36.61,390361,142908,-247453,610,438,-172,576503,2765,2765,2765,1330,0,5,8884,23100,0,1330
114200,205100,2755,5,50,-1.78,36.17,395133,142908,-252225,613,438,-175,581275,2765,2765,2755,6102,3,5,8872,19262,4772,1330
114500,205100,2755,5,50,-1.78,36.17,395133,142908,-252225,613,438,-175,581275,2755,2755,2755,0,0,0,8872,19262,0,0
114500,205100,2755,5,50,-1.78,36.17,395133,142908,-252225,613,438,-175,581275,2755,2755,2755,0,0,0,8623,18310,0,0
114500,205100,2755,5,50,-1.78,36.17,395133,142908,-252225,613,438,-175,581275,2755,2755,2755,0,0,0,8623,18915,0,0
114500,205100,2755,5,50,-1.78,36.17,395133,142908,-252225,613,438,-175,581275,2755,2755,2755,0,0,0,8623,18965,0,0
114500,205100,2755,5,50,-1.78,36.17,395133,142908,-252225,613,438,-175,581275,2755,2755,2755,0,0,0,8623,8965,0,0
114500,205100,2760,5,45,-1.6,36.36,395133,143677,-251456,613,439,-174,582044,2760,2760,2760,769,0,1,8623,9135,0,769
114800,205100,2745,5,60,-2.14,36.18,398043,143993,-254050,617,441,-176,585270,2745,2745,2745,0,0,0,7928,7338,0,0
114800,205100,2745,5,60,-2.14,36.17,398143,143993,-254150,618,441,-177,585370,2745,2745,2745,100,1,0,7818,17473,100,0
114800,205100,2745,5,60,-2.14,36.17,398143,143993,-254150,618,441,-177,585370,2745,2745,2745,100,1,0,7818,17473,100,0
114800,205100,2745,5,60,-2.14,36.15,398285,143993,-254292,619,441,-178,585512,2745,2745,2745,242,2,0,7078,18050,242,0
114800,205100,2745,5,60,-2.14,36.15,398285,143993,-254292,619,441,-178,585512,2745,2745,2745,242,2,0,7078,18050,242,0
114800,205100,2745,5,60,-2.14,36.12,398681,143993,-254688,621,441,-180,585908,2745,2750,2745,638,4,0,6936,13399,638,0
115100,205100,2745,5,60,-2.14,36.12,398681,143993,-254688,621,441,-180,585908,2745,2745,2745,0,0,0,6936,13399,0,0
115100,205100,2745,5,60,-2.14,36.12,398681,143993,-254688,621,441,-180,585908,2745,2745,2745,0,0,0,6540,13026,0,0
115100,205100,2745,5,60,-2.14,36.04,399580,143993,-255587,623,441,-182,586807,2750,2750,2745,899,2,0,6540,13862,899,0
115100,205100,2745,5,60,-2.14,36.04,399580,143993,-255587,623,441,-182,586807,2750,2750,2745,899,2,0,6540,13862,899,0
115100,205100,2745,5,60,-2.14,36.04,399580,143993,-255587,623,441,-182,586807,2750,2750,2745,899,2,0,6540,13862,899,0
115100,205100,2745,5,60,-2.14,36.04,399580,143993,-255587,623,441,-182,586807,2750,2750,2745,899,2,0,6540,13862,899,0
115400,205100,2745,5,60,-2.14,36.0,399932,143993,-255939,624,441,-183,587159,2745,2745,2745,352,1,0,6251,25835,352,0
115400,205100,2745,5,60,-2.14,36.0,399932,143993,-255939,624,441,-183,587159,2745,2745,2745,352,1,0,6251,25835,352,0
115400,205100,2745,5,60,-2.14,35.97,400302,143993,-256309,625,441,-184,587529,2745,2745,2745,722,2,0,11718,25483,722,0
115400,205100,2745,5,60,-2.14,35.97,400302,143993,-256309,625,441,-184,587529,2745,2745,2745,722,2,0,11718,25483,722,0
115400,205100,2745,5,60,-2.14,35.97,400302,143993,-256309,625,441,-184,587529,2745,2745,2745,722,2,0,11718,25483,722,0
115400,205100,2745,5,60,-2.14,36.24,400302,145051,-255251,625,445,-180,588587,2745,2745,2745,1780,2,4,6916,27122,722,1058
115700,205100,2745,5,60,-2.14,36.24,400302,145051,-255251,625,445,-180,588587,2745,2745,2745,0,0,0,6916,27122,0,0
115700,205100,2745,5,60,-2.14,36.24,400302,145051,-255251,625,445,-180,588587,2745,2745,2745,0,0,0,6916,27122,0,0
115700,205100,2740,5,65,-2.32,36.16,401092,145051,-256041,626,445,-181,589377,2740,2740,2740,790,1,0,6739,27424,790,0
115700,205100,2735,5,70,-2.5,36.16,401103,145051,-256052,629,445,-184,589388,2740,2745,2735,801,4,0,6537,26687,801,0
115700,205100,2735,5,70,-2.5,36.11,401841,145104,-256737,630,446,-184,590179,2740,2745,2735,1592,5,1,8102,27608,1539,53
120000,205100,2755,5,50,-1.78,36.11,401841,145105,-256736,630,447,-183,590180,2755,2755,2755,0,0,0,13528,27848,0,0
120000,205100,2755,5,50,-1.78,36.11,401841,145105,-256736,630,447,-183,590180,2755,2755,2755,0,0,0,13528,27848,0,0
120000,205100,2755,5,50,-1.78,36.11,401841,145105,-256736,630,447,-183,590180,2755,2755,2755,0,0,0,9110,28712,0,0
120000,205100,2755,5,50,-1.78,36.11,401841,145105,-256736,630,447,-183,590180,2755,2755,2755,0,0,0,9110,28712,0,0
120000,205100,2750,5,55,-1.96,36.17,401841,145355,-256486,630,449,-181,590430,2750,2750,2750,250,0,2,9109,27891,0,250
120000,205100,2750,5,55,-1.96,36.17,401841,145355,-256486,630,449,-181,590430,2750,2750,2750,250,0,2,9109,27891,0,250
120300,205100,2760,5,45,-1.6,36.17,401841,145356,-256485,630,450,-180,590431,2760,2760,2760,0,0,0,14287,28091,0,0
120300,205100,2760,5,45,-1.6,36.17,401841,145356,-256485,630,450,-180,590431,2760,2760,2760,0,0,0,14287,28091,0,0
120300,205100,2760,5,45,-1.6,36.17,401841,145356,-256485,630,450,-180,590431,2760,2760,2760,0,0,0,14286,27081,0,0
120300,205100,2750,5,55,-1.96,36.16,401932,145356,-256576,631,450,-181,590522,2750,2750,2750,91,1,0,14386,15942,91,0
120300,205100,2745,5,60,-2.14,35.99,403932,145356,-258576,632,450,-182,592522,2750,2750,2745,2091,2,0,14876,27081,2091,0
120300,205100,2745,5,60,-2.14,35.99,403932,145356,-258576,632,450,-182,592522,2750,2750,2745,2091,2,0,14876,27081,2091,0
120600,205100,2745,5,60,-2.14,35.99,403932,145356,-258576,632,450,-182,592522,2745,2745,2745,0,0,0,9057,28091,0,0
120600,205100,2740,5,65,-2.32,35.98,403982,145356,-258626,634,450,-184,592572,2745,2745,2740,50,2,0,9332,25127,50,0
120600,205100,2735,5,70,-2.5,35.94,404482,145356,-259126,636,450,-186,593072,2745,2745,2735,550,4,0,9332,29107,550,0
120600,205100,2730,5,75,-2.67,35.69,407296,145356,-261940,639,450,-189,595886,2745,2745,2730,3364,7,0,9522,28609,3364,0
120600,205100,2730,5,75,-2.67,35.69,407298,145356,-261942,640,450,-190,595888,2745,2745,2730,3366,8,0,9302,27366,3366,0
120600,205100,2730,5,75,-2.67,35.64,407833,145356,-262477,641,450,-191,596423,2745,2745,2730,3901,9,0,8842,23460,3901,0
120900,205100,2730,5,75,-2.67,35.64,407833,145356,-262477,641,450,-191,596423,2730,2730,2730,0,0,0,8842,23460,0,0
120900,205100,2730,5,75,-2.67,35.64,407833,145356,-262477,641,450,-191,596423,2730,2730,2730,0,0,0,8517,23156,0,0
120900,205100,2730,5,75,-2.67,35.64,407833,145356,-262477,641,450,-191,596423,2730,2730,2730,0,0,0,8917,24122,0,0
120900,205100,2740,5,65,-2.32,35.64,407833,145357,-262476,641,451,-190,596424,2740,2740,2740,1,0,1,8917,25529,0,1
120900,205100,2740,5,65,-2.32,35.64,407833,145359,-262474,641,452,-189,596426,2740,2740,2740,3,0,2,8807,26533,0,3
120900,205100,2740,5,65,-2.32,35.73,407833,145705,-262128,641,454,-187,596772,2740,2740,2740,349,0,4,8803,26273,0,349
121200,205100,2760,5,45,-1.6,35.73,407833,145706,-262127,641,455,-186,596773,2760,2760,2760,1,0,1,9121,25388,0,1
121200,205100,2760,5,45,-1.6,35.73,407833,145706,-262127,641,455,-186,596773,2760,2760,2760,1,0,1,9121,25388,0,1
121200,205100,2760,5,45,-1.6,35.73,407833,145708,-262125,641,456,-185,596775,2760,2760,2760,3,0,2,9126,25669,0,3
121200,205100,2760,5,45,-1.6,35.73,407833,145708,-262125,641,456,-185,596775,2760,2760,2760,3,0,2,9126,25669,0,3
121200,205100,2760,5,45,-1.6,35.73,407833,145708,-262125,641,456,-185,596775,2760,2760,2760,3,0,2,9126,25669,0,3
121200,205100,2755,5,50,-1.78,35.73,407833,145710,-262123,641,457,-184,596777,2760,2760,2755,5,0,3,8617,23638,0,5
121500,205100,2755,5,50,-1.78,35.73,407833,145710,-262123,641,457,-184,596777,2755,2755,2755,0,0,0,8617,23638,0,0
121500,205100,2755,5,50,-1.78,35.73,407833,145710,-262123,641,457,-184,596777,2755,2755,2755,0,0,0,8615,23738,0,0
121500,205100,2755,5,50,-1.78,35.73,407833,145710,-262123,641,457,-184,596777,2755,2755,2755,0,0,0,8615,23738,0,0
121500,205100,2755,5,50,-1.78,35.73,407833,145710,-262123,641,457,-184,596777,2755,2755,2755,0,0,0,8615,23738,0,0
121500,205100,2755,5,50,-1.78,35.73,407833,145710,-262123,641,457,-184,596777,2755,2755,2755,0,0,0,8615,21328,0,0
121500,205100,2750,5,55,-1.96,35.7,408133,145710,-262423,642,457,-185,597077,2750,2750,2750,300,1,0,8615,10613,300,0
121800,205100,2750,5,55,-1.96,35.64,408835,145710,-263125,643,457,-186,597779,2750,2750,2750,702,1,0,9084,10619,702,0
121800,205100,2750,5,55,-1.96,35.64,408835,145713,-263122,643,458,-185,597782,2750,2750,2750,705,1,1,8113,21452,702,3
121800,205100,2750,5,55,-1.96,35.64,408835,145713,-263122,643,458,-185,597782,2750,2750,2750,705,1,1,8113,21452,702,3
121800,205100,2745,5,60,-2.14,35.54,409942,145713,-264229,644,458,-186,598889,2750,2750,2745,1812,2,1,9105,21452,1809,3
121800,205100,2745,5,60,-2.14,35.54,409942,145713,-264229,644,458,-186,598889,2750,2750,2745,1812,2,1,9105,21452,1809,3
121800,205100,2745,5,60,-2.14,35.57,409942,145815,-264127,644,460,-184,598991,2750,2750,2745,1914,2,3,8515,23755,1809,105
122100,205100,2745,5,60,-2.14,35.59,409942,145911,-264031,644,461,-183,599087,2745,2745,2745,96,0,1,8513,23753,0,96
122100,205100,2740,5,65,-2.32,35.59,409952,145911,-264041,646,461,-185,599097,2745,2745,2740,106,2,1,8853,20347,10,96
122100,205100,2740,5,65,-2.32,35.59,409952,145911,-264041,646,461,-185,599097,2745,2745,2740,106,2,1,8853,20347,10,96
122100,205100,2740,5,65,-2.32,35.59,410113,145950,-264163,647,463,-184,599297,2745,2745,2740,306,3,3,8451,24818,171,135
122100,205100,2740,5,65,-2.32,35.59,410113,145950,-264163,647,463,-184,599297,2745,2745,2740,306,3,3,8451,24818,171,135
122400,205100,2740,5,65,-2.32,35.59,410113,145950,-264163,647,463,-184,599297,2740,2740,2740,0,0,0,8451,24818,0,0
122400,205100,2740,5,65,-2.32,35.59,410113,145950,-264163,647,463,-184,599297,2740,2740,2740,0,0,0,8913,23591,0,0
122400,205100,2740,5,65,-2.32,35.59,410113,145955,-264158,647,464,-183,599302,2740,2740,2740,5,0,1,9308,24818,0,5
122400,205100,2740,5,65,-2.32,35.61,410113,146055,-264058,647,465,-182,599402,2740,2740,2740,105,0,2,9412,24818,0,105
122400,205100,2735,5,70,-2.5,35.84,410438,147095,-263343,649,468,-181,600767,2740,2740,2735,1470,2,5,8412,24953,325,1145
122400,205100,2735,5,70,-2.5,35.84,410438,147095,-263343,649,468,-181,600767,2740,2740,2735,1470,2,5,8412,24953,325,1145
122700,205100,2735,5,70,-2.5,35.89,410438,147295,-263143,649,469,-180,600967,2735,2735,2735,0,0,0,8467,25153,0,0
122700,205100,2735,5,70,-2.5,35.89,410438,147295,-263143,649,469,-180,600967,2735,2735,2735,0,0,0,8467,25153,0,0
122700,205100,2735,5,70,-2.5,35.89,410438,147295,-263143,649,469,-180,600967,2735,2735,2735,0,0,0,8707,25253,0,0
122700,205100,2730,5,75,-2.67,35.8,411428,147295,-264133,651,469,-182,601957,2735,2735,2730,990,2,0,8707,25353,990,0
122700,205100,2730,5,75,-2.67,35.8,411428,147295,-264133,651,469,-182,601957,2735,2735,2730,990,2,0,8707,25353,990,0
122700,205100,2725,5,80,-2.85,35.7,412634,147295,-265339,653,469,-184,603239,2735,2735,2725,2272,4,0,9222,25990,2196,0
123000,205100,2725,5,80,-2.85,35.7,412634,147295,-265339,653,469,-184,603239,2725,2725,2725,0,0,0,9222,25990,0,0
123000,205100,2735,5,70,-2.5,34.31,430110,147561,-282549,660,470,-190,620981,2725,2735,2700,17742,7,1,7933,10759,17476,266
123000,205100,2735,5,70,-2.5,34.31,430110,147561,-282549,660,470,-190,620981,2725,2735,2700,17742,7,1,7933,10759,17476,266
123000,205100,2735,5,70,-2.5,34.31,430110,147561,-282549,660,470,-190,620981,2725,2735,2700,17742,7,1,7933,10759,17476,266
123000,205100,2735,5,70,-2.5,34.31,430110,147561,-282549,660,470,-190,620981,2725,2735,2700,17742,7,1,7933,10759,17476,266
123000,205100,2725,5,80,-2.85,34.3,430210,147561,-282649,661,470,-191,621081,2725,2735,2700,17842,8,1,5638,15637,17576,266
123300,205100,2710,5,95,-3.39,34.06,433210,147561,-285649,664,470,-194,624081,2720,2720,2710,3000,3,0,6168,15022,3000,0
123300,205100,2710,5,95,-3.39,34.0,433981,147561,-286420,665,470,-195,624852,2720,2720,2710,3771,4,0,2152,12353,3771,0
123300,205100,2725,5,80,-2.85,34.15,433981,148195,-285786,665,473,-192,625486,2720,2725,2710,4405,4,3,2172,12309,3771,634
123300,205100,2725,5,80,-2.85,34.15,433981,148215,-285766,665,474,-191,625506,2720,2725,2710,4425,4,4,2167,13112,3771,654
123300,205100,2715,5,90,-3.21,34.15,433986,148215,-285771,666,474,-192,625511,2720,2725,2710,4430,5,4,2659,13687,3776,654
123300,205100,2710,5,95,-3.39,34.15,434066,148215,-285851,668,474,-194,625591,2720,2725,2710,4510,7,4,2048,13641,3856,654
123600,205100,2705,5,100,-3.57,33.96,436466,148220,-288246,669,475,-194,627996,2705,2705,2705,2400,1,0,2043,13582,2400,0
123600,205100,2705,5,100,-3.57,33.96,436466,148220,-288246,669,475,-194,627996,2705,2705,2705,2400,1,0,2043,13582,2400,0
123600,205100,2700,5,105,-3.74,33.94,436751,148220,-288531,672,475,-197,628281,2705,2705,2700,2685,4,0,2389,12934,2685,0
123600,205100,2700,5,105,-3.74,33.88,437718,148291,-289427,673,477,-196,629319,2705,2705,2700,3723,5,2,2318,12704,3652,71
123600,205100,2695,5,110,-3.92,33.7,440249,148375,-291874,676,479,-197,631934,2705,2705,2695,6338,8,4,2885,10658,6183,155
123600,205100,2695,5,110,-3.92,33.65,440968,148375,-292593,677,479,-198,632653,2705,2705,2695,7057,9,4,2467,10696,6902,155
123900,205100,2700,5,105,-3.74,33.66,441068,148475,-292593,678,480,-198,632853,2700,2700,2700,200,1,1,2466,10167,100,100
123900,205100,2705,5,100,-3.57,33.73,441068,148775,-292293,678,483,-195,633153,2700,2705,2700,500,1,4,2947,10512,100,400
123900,205100,2705,5,100,-3.57,33.73,441068,148775,-292293,678,483,-195,633153,2700,2705,2700,500,1,4,2947,10512,100,400
123900,205100,2705,5,100,-3.57,33.73,441068,148775,-292293,678,483,-195,633153,2700,2705,2700,500,1,4,2947,10512,100,400
123900,205100,2705,5,100,-3.57,33.73,441068,148775,-292293,678,483,-195,633153,2700,2705,2700,500,1,4,2947,10512,100,400
124200,205100,2715,5,90,-3.21,33.74,441074,148826,-292248,679,485,-194,633210,2715,2715,2715,0,0,0,3736,22069,0,0
124200,205100,2710,5,95,-3.39,33.71,441512,148826,-292686,680,485,-195,633648,2710,2710,2710,438,1,0,4780,22069,438,0
124200,205100,2710,5,95,-3.39,33.71,441512,148826,-292686,680,485,-195,633648,2710,2710,2710,438,1,0,4780,22069,438,0
124200,205100,2710,5,95,-3.39,33.66,442168,148826,-293342,683,485,-198,634304,2710,2710,2710,1094,4,0,4780,21731,1094,0
124200,205100,2705,5,100,-3.57,33.66,442178,148826,-293352,684,485,-199,634314,2710,2710,2705,1104,5,0,4780,21730,1104,0
124200,205100,2710,5,95,-3.39,33.58,443178,148826,-294352,685,485,-200,635314,2710,2710,2705,2104,6,0,4780,22470,2104,0
124500,205100,2710,5,95,-3.39,33.56,443478,148826,-294652,688,485,-203,635614,2710,2710,2710,0,0,0,4780,21670,0,0
124500,205100,2710,5,95,-3.39,33.56,443764,148926,-294838,689,486,-203,636000,2715,2715,2710,386,1,1,4680,22970,286,100
124500,205100,2715,5,90,-3.21,33.79,443764,149926,-293838,689,487,-202,637000,2715,2715,2710,1386,1,2,4680,22684,286,1100
124500,205100,2715,5,90,-3.21,33.79,443764,149936,-293828,689,488,-201,637010,2715,2715,2710,1396,1,3,3680,22894,286,1110
124500,205100,2715,5,90,-3.21,33.79,443764,149936,-293828,689,488,-201,637010,2715,2715,2710,1396,1,3,3680,22894,286,1110
124500,205100,2715,5,90,-3.21,33.87,443764,150323,-293441,689,490,-199,637397,2715,2715,2710,1783,1,5,3900,23224,286,1497
124800,205100,2715,5,90,-3.21,33.84,444264,150323,-293941,690,490,-200,637897,2715,2715,2715,500,1,0,5645,23752,500,0
124800,205100,2715,5,90,-3.21,33.82,444512,150323,-294189,692,490,-202,638145,2715,2715,2715,748,3,0,4073,23252,748,0
124800,205100,2710,5,95,-3.39,33.72,445800,150323,-295477,694,490,-204,639433,2715,2715,2710,2036,5,0,4073,22573,2036,0
124800,205100,2710,5,95,-3.39,33.72,445800,150323,-295477,694,490,-204,639433,2715,2715,2710,2036,5,0,4073,22573,2036,0
124800,205100,2710,5,95,-3.39,33.72,445800,150323,-295477,694,490,-204,639433,2715,2715,2710,2036,5,0,4073,22573,2036,0
124800,205100,2710,5,95,-3.39,33.72,445800,150323,-295477,694,490,-204,639433,2715,2715,2710,2036,5,0,4073,22573,2036,0
125100,205100,2710,5,95,-3.39,33.72,445800,150323,-295477,694,490,-204,639433,2710,2710,2710,0,0,0,5625,27599,0,0
125100,205100,2710,5,95,-3.39,33.72,445800,150323,-295477,694,490,-204,639433,2710,2710,2710,0,0,0,5625,27629,0,0
125100,205100,2710,5,95,-3.39,33.72,445800,150323,-295477,694,490,-204,639433,2710,2710,2710,0,0,0,5185,28629,0,0
125100,205100,2710,5,95,-3.39,33.72,445800,150323,-295477,694,490,-204,639433,2710,2710,2710,0,0,0,5185,29032,0,0
125100,205100,2710,5,95,-3.39,33.67,446400,150323,-296077,695,490,-205,640033,2710,2710,2710,600,1,0,5185,31468,600,0
125100,205100,2710,5,95,-3.39,33.67,446400,150323,-296077,695,490,-205,640033,2710,2710,2710,600,1,0,5185,31468,600,0
125400,205100,2710,5,95,-3.39,33.62,447331,150392,-296939,696,491,-205,641033,2710,2710,2710,1000,1,1,3051,31097,931,69
125400,205100,2710,5,95,-3.39,33.62,447331,150392,-296939,696,491,-205,641033,2710,2710,2710,1000,1,1,3051,31097,931,69
125400,205100,2720,5,85,-3.03,33.62,447331,150393,-296938,696,492,-204,641034,2710,2720,2710,1001,1,2,2983,31316,931,70
125400,205100,2725,5,80,-2.85,33.64,447331,150493,-296838,696,493,-203,641134,2710,2725,2710,1101,1,3,4691,25863,931,170
125400,205100,2725,5,80,-2.85,33.64,447331,150493,-296838,696,493,-203,641134,2710,2725,2710,1101,1,3,4691,25863,931,170
125400,205100,2725,5,80,-2.85,33.67,447332,150610,-296722,697,495,-202,641252,2710,2725,2710,1219,2,5,4639,26027,932,287
125700,205100,2730,5,75,-2.67,33.67,447332,150612,-296720,697,496,-201,641254,2730,2730,2730,2,0,1,5771,26768,0,2
125700,205100,2730,5,75,-2.67,33.89,447332,151613,-295719,697,498,-199,642255,2730,2730,2730,1003,0,3,5764,25804,0,1003
125700,205100,2730,5,75,-2.67,33.89,447332,151613,-295719,697,498,-199,642255,2730,2730,2730,1003,0,3,5764,25804,0,1003
125700,205100,2730,5,75,-2.67,33.89,447332,151613,-295719,697,498,-199,642255,2730,2730,2730,1003,0,3,5764,25804,0,1003
125700,205100,2730,5,75,-2.67,33.89,447332,151613,-295719,697,498,-199,642255,2730,2730,2730,1003,0,3,5764,25804,0,1003
125700,205100,2730,5,75,-2.67,33.89,447332,151613,-295719,697,498,-199,642255,2730,2730,2730,1003,0,3,5764,25804,0,1003
130000,205100,2730,5,75,-2.67,33.92,447333,151713,-295620,698,499,-199,642356,2730,2730,2730,1,1,0,6299,25052,1,0
130000,205100,2730,5,75,-2.67,33.92,447333,151713,-295620,698,499,-199,642356,2730,2730,2730,1,1,0,6299,25052,1,0
130000,205100,2730,5,75,-2.67,33.91,447342,151713,-295629,699,499,-200,642365,2730,2730,2730,10,2,0,11809,22257,10,0
130000,205100,2730,5,75,-2.67,33.92,447342,151754,-295588,699,502,-197,642406,2730,2730,2730,51,2,3,11209,24934,10,41
130000,205100,2730,5,75,-2.67,33.92,447342,151754,-295588,699,502,-197,642406,2730,2730,2730,51,2,3,11209,24934,10,41
130300,205100,2730,5,75,-2.67,33.92,447342,151754,-295588,699,502,-197,642406,2730,2730,2730,0,0,0,12097,24958,0,0
130300,205100,2730,5,75,-2.67,33.92,447342,151754,-295588,699,502,-197,642406,2730,2730,2730,0,0,0,12097,24958,0,0
130300,205100,2730,5,75,-2.67,33.92,447342,151754,-295588,699,502,-197,642406,2730,2730,2730,0,0,0,12097,24960,0,0
130300,205100,2730,5,75,-2.67,33.92,447342,151754,-295588,699,502,-197,642406,2730,2730,2730,0,0,0,11866,24964,0,0
130300,205100,2730,5,75,-2.67,33.92,447342,151754,-295588,699,502,-197,642406,2730,2730,2730,0,0,0,11866,25004,0,0
130300,205100,2730,5,75,-2.67,33.92,447342,151754,-295588,699,502,-197,642406,2730,2730,2730,0,0,0,11766,25054,0,0
130600,205100,2735,5,70,-2.5,33.95,447342,151854,-295488,699,503,-196,642506,2735,2735,2735,0,0,0,12266,22679,0,0
130600,205100,2735,5,70,-2.5,33.95,447347,151854,-295493,700,503,-197,642511,2735,2735,2735,5,1,0,13182,20518,5,0
130600,205100,2730,5,75,-2.67,33.94,447458,151854,-295604,701,503,-198,642622,2735,2735,2730,116,2,0,13182,22690,116,0
130600,205100,2730,5,75,-2.67,33.94,447458,151854,-295604,701,503,-198,642622,2735,2735,2730,116,2,0,13182,22690,116,0
130600,205100,2725,5,80,-2.85,33.91,447772,151854,-295918,702,503,-199,642936,2735,2735,2725,430,3,0,12484,25254,430,0
130600,205100,2725,5,80,-2.85,33.91,447772,151854,-295918,702,503,-199,642936,2735,2735,2725,430,3,0,12484,25254,430,0
130900,205100,2730,5,75,-2.67,33.91,447772,151855,-295917,702,504,-198,642937,2730,2730,2730,1,0,1,11959,25625,0,1
130900,205100,2730,5,75,-2.67,33.91,447772,151855,-295917,702,504,-198,642937,2730,2730,2730,1,0,1,11959,25625,0,1
130900,205100,2730,5,75,-2.67,33.94,447772,151955,-295817,702,505,-197,643037,2730,2730,2730,101,0,2,10508,25540,0,101
130900,205100,2730,5,75,-2.67,33.94,447772,151955,-295817,702,505,-197,643037,2730,2730,2730,101,0,2,10508,25540,0,101
130900,205100,2730,5,75,-2.67,33.96,447772,152055,-295717,702,506,-196,643137,2730,2730,2730,201,0,3,10408,28640,0,201
130900,205100,2730,5,75,-2.67,33.96,447772,152055,-295717,702,506,-196,643137,2730,2730,2730,201,0,3,10408,28640,0,201
131200,205100,2730,5,75,-2.67,33.96,447772,152055,-295717,702,506,-196,643137,2730,2730,2730,0,0,0,10408,28640,0,0
131200,205100,2730,5,75,-2.67,33.96,447772,152055,-295717,702,506,-196,643137,2730,2730,2730,0,0,0,10808,28660,0,0
131200,205100,2730,5,75,-2.67,33.97,447772,152088,-295684,702,507,-195,643333,2730,2730,2730,196,0,1,11861,29660,0,33
131200,205100,2730,5,75,-2.67,33.97,447772,152088,-295684,702,507,-195,643333,2730,2730,2730,196,0,1,11861,29660,0,33
131200,205100,2730,5,75,-2.67,33.97,447772,152088,-295684,702,507,-195,643333,2730,2730,2730,196,0,1,11861,29660,0,33
131200,205100,2730,5,75,-2.67,33.97,447772,152088,-295684,702,507,-195,643333,2730,2730,2730,196,0,1,11861,29660,0,33
131500,205100,2730,5,75,-2.67,33.97,447772,152088,-295684,702,507,-195,643333,2730,2730,2730,0,0,0,12955,29870,0,0
131500,205100,2730,5,75,-2.67,33.97,447772,152088,-295684,702,507,-195,643333,2730,2730,2730,0,0,0,12955,29870,0,0
131500,205100,2730,5,75,-2.67,33.97,447772,152088,-295684,702,507,-195,643333,2730,2730,2730,0,0,0,12955,29870,0,0
131500,205100,2730,5,75,-2.67,33.97,447772,152088,-295684,702,507,-195,643333,2730,2730,2730,0,0,0,12955,30349,0,0
131500,205100,2730,5,75,-2.67,33.97,447772,152088,-295684,702,507,-195,643333,2730,2730,2730,0,0,0,18268,30649,0,0
131500,205100,2740,5,65,-2.32,33.97,447772,152090,-295682,702,508,-194,643335,2740,2740,2740,2,0,1,18268,28153,0,2
131800,205100,2730,5,75,-2.67,33.96,447809,152090,-295719,703,508,-195,643372,2730,2730,2730,37,1,0,18266,28303,37,0
131800,205100,2740,5,65,-2.32,33.97,447809,152104,-295705,703,510,-193,643386,2730,2740,2730,51,1,2,17672,28364,37,14
131800,205100,2740,5,65,-2.32,33.97,447809,152104,-295705,703,510,-193,643386,2730,2740,2730,51,1,2,17672,28364,37,14
131800,205100,2740,5,65,-2.32,33.97,447809,152104,-295705,703,510,-193,643386,2730,2740,2730,51,1,2,17672,28364,37,14
131800,205100,2740,5,65,-2.32,33.97,447809,152104,-295705,703,510,-193,643386,2730,2740,2730,51,1,2,17672,28364,37,14
132100,205100,2740,5,65,-2.32,33.97,447809,152104,-295705,703,510,-193,643386,2740,2740,2740,0,0,0,18011,28475,0,0
132100,205100,2740,5,65,-2.32,33.97,447809,152104,-295705,703,510,-193,643386,2740,2740,2740,0,0,0,18011,28481,0,0
132100,205100,2740,5,65,-2.32,33.97,447809,152104,-295705,703,510,-193,643386,2740,2740,2740,0,0,0,18011,28536,0,0
132100,205100,2740,5,65,-2.32,33.97,447809,152104,-295705,703,510,-193,643386,2740,2740,2740,0,0,0,18011,28886,0,0
132100,205100,2740,5,65,-2.32,33.97,447809,152104,-295705,703,510,-193,643386,2740,2740,2740,0,0,0,18011,28886,0,0
132100,205100,2730,5,75,-2.67,33.82,449809,152104,-297705,704,510,-194,645386,2730,2730,2730,2000,1,0,18555,30573,2000,0
132400,205100,2730,5,75,-2.67,33.82,449809,152104,-297705,704,510,-194,645386,2730,2730,2730,0,0,0,18555,30573,0,0
132400,205100,2730,5,75,-2.67,33.82,449809,152104,-297705,704,510,-194,645386,2730,2730,2730,0,0,0,18555,30583,0,0
132400,205100,2730,5,75,-2.67,33.82,449809,152104,-297705,704,510,-194,645386,2730,2730,2730,0,0,0,18071,30593,0,0
132400,205100,2725,5,80,-2.85,33.67,451791,152104,-299687,707,510,-197,647368,2730,2730,2725,1982,3,0,18071,32293,1982,0
132400,205100,2725,5,80,-2.85,33.67,451791,152104,-299687,707,510,-197,647368,2730,2730,2725,1982,3,0,18071,32293,1982,0
132400,205100,2725,5,80,-2.85,33.67,451791,152104,-299687,707,510,-197,647368,2730,2730,2725,1982,3,0,18071,32293,1982,0
132700,205100,2725,5,80,-2.85,33.67,451791,152104,-299687,707,510,-197,647368,2725,2725,2725,0,0,0,18071,35698,0,0
132700,205100,2740,5,65,-2.32,33.78,451791,152637,-299154,707,511,-196,647901,2740,2740,2740,533,0,1,18071,35717,0,533
132700,205100,2740,5,65,-2.32,33.78,451791,152637,-299154,707,511,-196,647901,2740,2740,2740,533,0,1,18071,35717,0,533
132700,205100,2740,5,65,-2.32,33.78,451791,152637,-299154,707,511,-196,647901,2740,2740,2740,533,0,1,18071,35717,0,533
132700,205100,2740,5,65,-2.32,33.81,451791,152737,-299054,707,512,-195,648001,2740,2740,2740,633,0,2,18950,35767,0,633
132700,205100,2740,5,65,-2.32,34.09,451791,154027,-297764,707,514,-193,649291,2740,2740,2740,1923,0,4,18400,35768,0,1923
133000,205100,2740,5,65,-2.32,34.09,451791,154027,-297764,707,514,-193,649291,2740,2740,2740,0,0,0,18400,35768,0,0
133000,205100,2740,5,65,-2.32,34.09,451791,154027,-297764,707,514,-193,649291,2740,2740,2740,0,0,0,18400,35768,0,0
133000,205100,2740,5,65,-2.32,34.09,451791,154027,-297764,707,514,-193,649291,2740,2740,2740,0,0,0,18935,36768,0,0
133000,205100,2740,5,65,-2.32,34.09,451791,154027,-297764,707,514,-193,649291,2740,2740,2740,0,0,0,21677,36773,0,0
133000,205100,2740,5,65,-2.32,34.09,451791,154027,-297764,707,514,-193,649291,2740,2740,2740,0,0,0,22498,36773,0,0
133000,205100,2740,5,65,-2.32,34.09,451791,154027,-297764,707,514,-193,649291,2740,2740,2740,0,0,0,21249,36773,0,0
133300,205100,2740,5,65,-2.32,34.09,451791,154027,-297764,707,514,-193,649291,2740,2740,2740,0,0,0,21697,36773,0,0
133300,205100,2740,5,65,-2.32,34.09,451791,154027,-297764,707,514,-193,649291,2740,2740,2740,0,0,0,20448,36773,0,0
133300,205100,2730,5,75,-2.67,34.09,451891,154037,-297854,708,515,-193,649401,2735,2735,2730,110,1,1,21218,33448,100,10
133300,205100,2730,5,75,-2.67,34.09,451891,154037,-297854,708,515,-193,649401,2735,2735,2730,110,1,1,21218,33448,100,10
133300,205100,2730,5,75,-2.67,34.09,451911,154037,-297874,709,515,-194,649421,2735,2735,2730,130,2,1,20428,33368,120,10
133300,205100,2735,5,70,-2.5,34.11,451911,154137,-297774,709,517,-192,649521,2735,2735,2730,230,2,3,18729,37075,120,110
133600,205100,2725,5,80,-2.85,34.08,452282,154137,-298145,710,517,-193,649892,2725,2725,2725,371,1,0,20293,37076,371,0
133600,205100,2725,5,80,-2.85,34.08,452282,154137,-298145,710,517,-193,649892,2725,2725,2725,371,1,0,20293,37076,371,0
133600,205100,2725,5,80,-2.85,34.07,452382,154137,-298245,711,517,-194,649992,2725,2725,2725,471,2,0,21612,37307,471,0
133600,205100,2720,5,85,-3.03,33.89,454750,154137,-300613,714,517,-197,652360,2725,2725,2720,2839,5,0,20301,35868,2839,0
133600,205100,2720,5,85,-3.03,33.84,455456,154137,-301319,716,517,-199,653066,2725,2725,2720,3545,7,0,20911,35254,3545,0
133600,205100,2720,5,85,-3.03,33.84,455456,154137,-301319,716,517,-199,653066,2725,2725,2720,3545,7,0,20911,35254,3545,0
133900,205100,2720,5,85,-3.03,33.84,455456,154137,-301319,716,517,-199,653066,2720,2720,2720,0,0,0,19959,35820,0,0
133900,205100,2735,5,70,-2.5,33.89,455456,154337,-301119,716,518,-198,653266,2735,2735,2735,200,0,1,19959,35820,0,200
133900,205100,2735,5,70,-2.5,33.89,455456,154337,-301119,716,518,-198,653266,2735,2735,2735,200,0,1,19959,35820,0,200
133900,205100,2735,5,70,-2.5,33.89,455456,154337,-301119,716,518,-198,653266,2735,2735,2735,200,0,1,19959,35820,0,200
133900,205100,2720,5,85,-3.03,33.83,456732,154535,-302197,718,521,-197,654740,2735,2735,2720,1674,2,4,19348,35728,1276,398
134200,205100,2720,5,85,-3.03,33.83,456732,154535,-302197,718,521,-197,654740,2720,2720,2720,0,0,0,19348,35728,0,0
134200,205100,2720,5,85,-3.03,33.83,456732,154535,-302197,718,521,-197,654740,2720,2720,2720,0,0,0,19348,35728,0,0
134200,205100,2720,5,85,-3.03,33.83,456732,154535,-302197,718,521,-197,654740,2720,2720,2720,0,0,0,18663,35054,0,0
134200,205100,2720,5,85,-3.03,33.83,456732,154535,-302197,718,521,-197,654740,2720,2720,2720,0,0,0,19657,35054,0,0
134200,205100,2720,5,85,-3.03,33.83,456732,154535,-302197,718,521,-197,654740,2720,2720,2720,0,0,0,19657,38055,0,0
134200,205100,2720,5,85,-3.03,33.83,456732,154535,-302197,718,521,-197,654740,2720,2720,2720,0,0,0,19657,38055,0,0
134500,205100,2720,5,85,-3.03,33.83,456732,154535,-302197,718,521,-197,654740,2720,2720,2720,0,0,0,19657,38054,0,0
134500,205100,2740,5,65,-2.32,34.93,456732,159535,-297197,718,523,-195,659740,2730,2740,2730,5000,0,2,19158,38338,0,5000
134500,205100,2740,5,65,-2.32,34.93,456732,159540,-297192,718,524,-194,659745,2730,2740,2730,5005,0,3,16698,38338,0,5005
134500,205100,2745,5,60,-2.14,35.67,456732,162912,-293820,718,527,-191,663117,2730,2745,2730,8377,0,6,14203,50609,0,8377
134500,205100,2745,5,60,-2.14,35.54,458360,162912,-295448,721,527,-194,664745,2730,2745,2730,10005,3,6,12911,49662,1628,8377
134500,205100,2745,5,60,-2.14,35.54,458360,162912,-295448,721,527,-194,664745,2730,2745,2730,10005,3,6,12911,49662,1628,8377
134800,205100,2745,5,60,-2.14,35.54,458360,162912,-295448,721,527,-194,664745,2745,2745,2745,0,0,0,13957,38328,0,0
134800,205100,2745,5,60,-2.14,35.54,458360,162912,-295448,721,527,-194,664745,2745,2745,2745,0,0,0,13957,38328,0,0
134800,205100,2745,5,60,-2.14,35.54,458360,162912,-295448,721,527,-194,664745,2745,2745,2745,0,0,0,13957,38328,0,0
134800,205100,2745,5,60,-2.14,35.54,458360,162912,-295448,721,527,-194,664745,2745,2745,2745,0,0,0,13957,42230,0,0
134800,205100,2745,5,60,-2.14,35.54,458360,162912,-295448,721,527,-194,664745,2745,2745,2745,0,0,0,13957,54887,0,0
134800,205100,2745,5,60,-2.14,35.54,458360,162912,-295448,721,527,-194,664745,2745,2745,2745,0,0,0,13957,54885,0,0
135100,205100,2745,5,60,-2.14,35.54,458360,162912,-295448,721,527,-194,664745,2745,2745,2745,0,0,0,13957,54885,0,0
135100,205100,2745,5,60,-2.14,35.54,458360,162912,-295448,721,527,-194,664745,2745,2745,2745,0,0,0,13957,54885,0,0
135100,205100,2745,5,60,-2.14,35.54,458360,162912,-295448,721,527,-194,664745,2745,2745,2745,0,0,0,13957,54885,0,0
135100,205100,2745,5,60,-2.14,35.54,458360,162912,-295448,721,527,-194,664745,2745,2745,2745,0,0,0,13957,54885,0,0
135100,205100,2745,5,60,-2.14,35.54,458360,162912,-295448,721,527,-194,664745,2745,2745,2745,0,0,0,13712,42238,0,0
135100,205100,2745,5,60,-2.14,35.54,458360,162912,-295448,721,527,-194,664745,2745,2745,2745,0,0,0,13562,42258,0,0
135400,205100,2745,5,60,-2.14,35.54,458360,162912,-295448,721,527,-194,664745,2745,2745,2745,0,0,0,13712,42290,0,0
135400,205100,2745,5,60,-2.14,35.54,458360,162912,-295448,721,527,-194,664745,2745,2745,2745,0,0,0,13712,42290,0,0
135400,205100,2745,5,60,-2.14,35.54,458360,162912,-295448,721,527,-194,664745,2745,2745,2745,0,0,0,13712,41115,0,0
135400,205100,2745,5,60,-2.14,35.54,458360,162912,-295448,721,527,-194,664745,2745,2745,2745,0,0,0,16012,41115,0,0
135400,205100,2745,5,60,-2.14,35.54,458360,162912,-295448,721,527,-194,664745,2745,2745,2745,0,0,0,16012,41115,0,0
135700,205100,2745,5,60,-2.14,35.54,458360,162912,-295448,721,527,-194,664745,2745,2745,2745,0,0,0,16012,42174,0,0
135700,205100,2745,5,60,-2.14,35.54,458360,162912,-295448,721,527,-194,664745,2745,2745,2745,0,0,0,16012,43074,0,0
135700,205100,2745,5,60,-2.14,35.54,458360,162912,-295448,721,527,-194,664745,2745,2745,2745,0,0,0,16012,55721,0,0
135700,205100,2745,5,60,-2.14,35.54,458360,162912,-295448,721,527,-194,664745,2745,2745,2745,0,0,0,16012,55721,0,0
135700,205100,2745,5,60,-2.14,35.54,458360,162912,-295448,721,527,-194,664745,2745,2745,2745,0,0,0,16012,43074,0,0
135700,205100,2745,5,60,-2.14,35.54,458360,162912,-295448,721,527,-194,664745,2745,2745,2745,0,0,0,16012,43074,0,0
140000,205100,2745,5,60,-2.14,35.54,458360,162912,-295448,721,527,-194,664745,2745,2745,2745,0,0,0,16012,43074,0,0
140000,205100,2745,5,60,-2.14,35.54,458360,162912,-295448,721,527,-194,664745,2745,2745,2745,0,0,0,16012,43074,0,0
140000,205100,2745,5,60,-2.14,35.54,458360,162912,-295448,721,527,-194,664745,2745,2745,2745,0,0,0,16012,43074,0,0
140000,205100,2745,5,60,-2.14,35.54,458360,162912,-295448,721,527,-194,664745,2745,2745,2745,0,0,0,16012,43074,0,0
140000,205100,2745,5,60,-2.14,35.54,458360,162912,-295448,721,527,-194,664745,2745,2745,2745,0,0,0,16012,43574,0,0
140000,205100,2745,5,60,-2.14,35.54,458360,162912,-295448,721,527,-194,664745,2745,2745,2745,0,0,0,16012,43574,0,0
140300,205100,2745,5,60,-2.14,35.54,458360,162912,-295448,721,527,-194,664745,2745,2745,2745,0,0,0,16034,43574,0,0
140300,205100,2745,5,60,-2.14,35.54,458360,162912,-295448,721,527,-194,664745,2745,2745,2745,0,0,0,16034,43574,0,0
140300,205100,2745,5,60,-2.14,35.54,458360,162912,-295448,721,527,-194,664745,2745,2745,2745,0,0,0,16034,43574,0,0
140300,205100,2745,5,60,-2.14,35.54,458360,162912,-295448,721,527,-194,664745,2745,2745,2745,0,0,0,16034,43574,0,0
140300,205100,2745,5,60,-2.14,35.54,458360,162912,-295448,721,527,-194,664745,2745,2745,2745,0,0,0,16738,43574,0,0
140300,205100,2745,5,60,-2.14,35.54,458360,162912,-295448,721,527,-194,664745,2745,2745,2745,0,0,0,16738,43574,0,0
140600,205100,2745,5,60,-2.14,35.54,458360,162912,-295448,721,527,-194,664745,2745,2745,2745,0,0,0,16738,43574,0,0
140600,205100,2730,5,75,-2.67,35.5,458860,162912,-295948,722,527,-195,665245,2730,2730,2730,500,1,0,16738,43774,500,0
140600,205100,2730,5,75,-2.67,35.5,458860,162912,-295948,722,527,-195,665245,2730,2730,2730,500,1,0,16738,43774,500,0
140600,205100,2730,5,75,-2.67,35.5,458860,162912,-295948,722,527,-195,665245,2730,2730,2730,500,1,0,16738,43774,500,0
140600,205100,2730,5,75,-2.67,35.5,458960,162912,-296048,723,527,-196,665345,2730,2730,2730,600,2,0,16258,59997,600,0
140600,205100,2730,5,75,-2.67,35.5,458960,162912,-296048,723,527,-196,665345,2730,2730,2730,600,2,0,16258,59997,600,0
140900,205100,2730,5,75,-2.67,35.5,458960,162912,-296048,723,527,-196,665345,2730,2730,2730,0,0,0,16258,59997,0,0
140900,205100,2730,5,75,-2.67,35.5,458960,162912,-296048,723,527,-196,665345,2730,2730,2730,0,0,0,16258,60297,0,0
140900,205100,2730,5,75,-2.67,35.5,458960,162912,-296048,723,527,-196,665345,2730,2730,2730,0,0,0,16258,61587,0,0
140900,205100,2730,5,75,-2.67,35.5,458960,162912,-296048,723,527,-196,665345,2730,2730,2730,0,0,0,16258,63737,0,0
140900,205100,2730,5,75,-2.67,35.48,459160,162912,-296248,724,527,-197,665545,2730,2730,2730,200,1,0,16258,63547,200,0
140900,205100,2730,5,75,-2.67,35.48,459160,162912,-296248,724,527,-197,665545,2730,2730,2730,200,1,0,16258,63547,200,0
141200,205100,2730,5,75,-2.67,35.48,459160,162912,-296248,724,527,-197,665545,2730,2730,2730,0,0,0,16258,65647,0,0
141200,205100,2730,5,75,-2.67,35.48,459161,162913,-296248,725,528,-197,665547,2745,2745,2730,2,1,1,16257,65700,1,1
141200,205100,2730,5,75,-2.67,35.46,459461,162913,-296548,726,528,-198,665847,2745,2745,2730,302,2,1,16257,65449,301,1
141200,205100,2725,5,80,-2.85,35.28,461729,162913,-298816,728,528,-200,668115,2745,2745,2725,2570,4,1,16257,65549,2569,1
141200,205100,2725,5,80,-2.85,35.28,461729,162913,-298816,728,528,-200,668115,2745,2745,2725,2570,4,1,16257,65549,2569,1
141500,205100,2725,5,80,-2.85,35.28,461729,162913,-298816,728,528,-200,668115,2725,2725,2725,0,0,0,16257,63349,0,0
141500,205100,2725,5,80,-2.85,35.21,462729,162913,-299816,730,528,-202,669115,2730,2730,2725,1000,2,0,16257,48638,1000,0
141500,205100,2725,5,80,-2.85,35.21,462729,162913,-299816,730,528,-202,669115,2730,2730,2725,1000,2,0,16257,48638,1000,0
141500,205100,2725,5,80,-2.85,35.21,462729,162913,-299816,730,528,-202,669115,2730,2730,2725,1000,2,0,16257,48638,1000,0
141500,205100,2725,5,80,-2.85,35.21,462729,162913,-299816,730,528,-202,669115,2730,2730,2725,1000,2,0,16257,48638,1000,0
141500,205100,2725,5,80,-2.85,35.21,462729,162913,-299816,730,528,-202,669115,2730,2730,2725,1000,2,0,16257,48638,1000,0
141800,205100,2745,5,60,-2.14,35.21,462729,162914,-299815,730,529,-201,669116,2745,2745,2745,0,0,0,16257,40037,0,0
141800,205100,2745,5,60,-2.14,35.21,462729,162914,-299815,730,529,-201,669116,2745,2745,2745,0,0,0,16257,40037,0,0
141800,205100,2745,5,60,-2.14,35.21,462729,162914,-299815,730,529,-201,669116,2745,2745,2745,0,0,0,16256,40037,0,0
141800,205100,2745,5,60,-2.14,35.6,462731,164740,-297991,731,532,-199,670944,2740,2745,2740,1828,1,3,16570,45096,2,1826
141800,205100,2745,5,60,-2.14,35.6,462731,164740,-297991,731,532,-199,670944,2740,2745,2740,1828,1,3,16570,45096,2,1826
141800,205100,2745,5,60,-2.14,35.6,462731,164740,-297991,731,532,-199,670944,2740,2745,2740,1828,1,3,16570,45096,2,1826
142100,205100,2745,5,60,-2.14,35.6,462731,164740,-297991,731,532,-199,670944,2745,2745,2745,0,0,0,5542,45096,0,0
142100,205100,2745,5,60,-2.14,35.6,462731,164740,-297991,731,532,-199,670944,2745,2745,2745,0,0,0,5542,45096,0,0
142100,205100,2745,5,60,-2.14,35.6,462731,164740,-297991,731,532,-199,670944,2745,2745,2745,0,0,0,5742,38116,0,0
142100,205100,2745,5,60,-2.14,35.6,462731,164740,-297991,731,532,-199,670944,2745,2745,2745,0,0,0,5742,38106,0,0
142100,205100,2725,5,80,-2.85,35.47,464506,164740,-299766,735,532,-203,672719,2740,2740,2725,1775,4,0,5742,38127,1775,0
142100,205100,2725,5,80,-2.85,35.47,464506,164740,-299766,735,532,-203,672719,2740,2740,2725,1775,4,0,5742,38127,1775,0
142400,205100,2725,5,80,-2.85,35.47,464506,164740,-299766,735,532,-203,672719,2725,2725,2725,0,0,0,5742,38127,0,0
142400,205100,2725,5,80,-2.85,35.47,464506,164740,-299766,735,532,-203,672719,2725,2725,2725,0,0,0,6518,61583,0,0
142400,205100,2725,5,80,-2.85,35.47,464506,164740,-299766,735,532,-203,672719,2725,2725,2725,0,0,0,6543,61583,0,0
142400,205100,2725,5,80,-2.85,35.47,464506,164740,-299766,735,532,-203,672719,2725,2725,2725,0,0,0,6543,61583,0,0
142400,205100,2725,5,80,-2.85,35.47,464506,164740,-299766,735,532,-203,672719,2725,2725,2725,0,0,0,6543,61583,0,0
142400,205100,2720,5,85,-3.03,35.39,465506,164740,-300766,737,532,-205,673719,2725,2725,2720,1000,2,0,6543,61693,1000,0
142700,205100,2720,5,85,-3.03,35.39,465506,164740,-300766,737,532,-205,673719,2720,2720,2720,0,0,0,6543,61693,0,0
142700,205100,2720,5,85,-3.03,35.39,465506,164740,-300766,737,532,-205,673719,2720,2720,2720,0,0,0,6543,61693,0,0
142700,205100,2720,5,85,-3.03,35.39,465506,164740,-300766,737,532,-205,673719,2720,2720,2720,0,0,0,5766,61392,0,0
142700,205100,2720,5,85,-3.03,35.39,465506,164740,-300766,737,532,-205,673719,2720,2720,2720,0,0,0,5766,61392,0,0
142700,205100,2720,5,85,-3.03,35.39,465506,164740,-300766,737,532,-205,673719,2720,2720,2720,0,0,0,6516,61096,0,0
143000,205100,2720,5,85,-3.03,35.39,465506,164740,-300766,737,532,-205,673719,2720,2720,2720,0,0,0,7016,61097,0,0
143000,205100,2720,5,85,-3.03,35.39,465506,164740,-300766,737,532,-205,673719,2720,2720,2720,0,0,0,7016,61099,0,0
143000,205100,2720,5,85,-3.03,35.39,465506,164740,-300766,737,532,-205,673719,2720,2720,2720,0,0,0,7016,61100,0,0
143000,205100,2715,5,90,-3.21,35.2,468072,164742,-303330,744,533,-211,676287,2735,2735,2715,2568,7,1,7642,59883,2566,2
143000,205100,2715,5,90,-3.21,35.11,469172,164742,-304430,745,533,-212,677387,2735,2735,2715,3668,8,1,8346,59515,3666,2
143000,205100,2715,5,90,-3.21,35.11,469172,164742,-304430,745,533,-212,677387,2735,2735,2715,3668,8,1,8346,59515,3666,2
143300,205100,2715,5,90,-3.21,35.11,469172,164742,-304430,745,533,-212,677387,2715,2715,2715,0,0,0,8346,59030,0,0
143300,205100,2715,5,90,-3.21,35.11,469172,164742,-304430,745,533,-212,677387,2715,2715,2715,0,0,0,8346,59130,0,0
143300,205100,2715,5,90,-3.21,35.11,469172,164742,-304430,745,533,-212,677387,2715,2715,2715,0,0,0,8346,59130,0,0
143300,205100,2715,5,90,-3.21,35.11,469172,164742,-304430,745,533,-212,677387,2715,2715,2715,0,0,0,8346,59130,0,0
143300,205100,2725,5,80,-2.85,35.13,469172,164812,-304360,745,534,-211,677457,2725,2725,2725,70,0,1,8346,59130,0,70
143300,205100,2715,5,90,-3.21,35.02,470672,164812,-305860,747,534,-213,678957,2725,2725,2715,1570,2,1,8276,57860,1500,70
143600,205100,2720,5,85,-3.03,35.01,470692,164812,-305880,748,534,-214,678977,2720,2720,2720,0,0,0,8276,43916,0,0
143600,205100,2720,5,85,-3.03,35.02,470692,164853,-305839,748,536,-212,679018,2720,2720,2720,41,0,2,8324,57410,0,41
143600,205100,2720,5,85,-3.03,35.02,470692,164853,-305839,748,536,-212,679018,2720,2720,2720,41,0,2,8324,57410,0,41
143600,205100,2720,5,85,-3.03,35.04,471705,165266,-306439,750,538,-212,680444,2720,2720,2720,1467,2,4,7916,44290,1013,454
143600,205100,2720,5,85,-3.03,35.04,471705,165266,-306439,750,538,-212,680444,2720,2720,2720,1467,2,4,7916,44290,1013,454
143600,205100,2720,5,85,-3.03,35.04,471705,165266,-306439,750,538,-212,680444,2720,2720,2720,1467,2,4,7916,44290,1013,454
143900,205100,2720,5,85,-3.03,35.04,471705,165266,-306439,750,538,-212,680444,2720,2720,2720,0,0,0,8396,43260,0,0
143900,205100,2720,5,85,-3.03,35.04,471715,165266,-306449,751,538,-213,680454,2720,2720,2720,10,1,0,8396,42470,10,0
143900,205100,2720,5,85,-3.03,35.04,471715,165266,-306449,751,538,-213,680454,2720,2720,2720,10,1,0,8396,42470,10,0
143900,205100,2720,5,85,-3.03,35.06,472715,165716,-306999,753,539,-214,681904,2720,2720,2715,1460,3,1,8356,55145,1010,450
143900,205100,2715,5,90,-3.21,35.04,472986,165716,-307270,754,539,-215,682175,2720,2720,2715,1731,4,1,8856,54845,1281,450
143900,205100,2710,5,95,-3.39,35.09,473286,166069,-307217,755,540,-215,682828,2720,2720,2710,2384,5,2,8856,55290,1581,803
144200,205100,2710,5,95,-3.39,35.09,473286,166069,-307217,755,540,-215,682828,2710,2710,2710,0,0,0,8856,55290,0,0
144200,205100,2710,5,95,-3.39,35.08,473436,166069,-307367,756,540,-216,682978,2710,2710,2710,150,1,0,8856,53650,150,0
144200,205100,2710,5,95,-3.39,35.08,473436,166069,-307367,756,540,-216,682978,2710,2710,2710,150,1,0,8856,53650,150,0
144200,205100,2710,5,95,-3.39,35.0,474436,166069,-308367,757,540,-217,683978,2710,2710,2710,1150,2,0,7754,53399,1150,0
144200,205100,2710,5,95,-3.39,35.0,474436,166069,-308367,757,540,-217,683978,2710,2710,2710,1150,2,0,7754,53399,1150,0
144200,205100,2710,5,95,-3.39,34.91,475675,166069,-309606,758,540,-218,685217,2710,2710,2710,2389,3,0,7754,52570,2389,0
144500,205100,2710,5,95,-3.39,35.49,475675,168830,-306845,758,542,-216,687978,2710,2710,2710,2761,0,2,10075,51406,0,2761
144500,205100,2710,5,95,-3.39,35.49,475675,168830,-306845,758,542,-216,687978,2710,2710,2710,2761,0,2,10075,51406,0,2761
144500,205100,2705,5,100,-3.57,35.49,475677,168830,-306847,759,542,-217,687980,2710,2710,2705,2763,1,2,8371,54377,2,2761
144500,205100,2720,5,85,-3.03,35.49,475677,168831,-306846,759,543,-216,687981,2710,2720,2705,2764,1,3,8371,54511,2,2762
144500,205100,2720,5,85,-3.03,35.49,475677,168831,-306846,759,543,-216,687981,2710,2720,2705,2764,1,3,8371,54511,2,2762
144800,205100,2720,5,85,-3.03,35.49,475677,168831,-306846,759,543,-216,687981,2720,2720,2720,0,0,0,8370,41511,0,0
144800,205100,2720,5,85,-3.03,35.49,475677,168831,-306846,759,543,-216,687981,2720,2720,2720,0,0,0,8370,41611,0,0
144800,205100,2720,5,85,-3.03,35.49,475677,168831,-306846,759,543,-216,687981,2720,2720,2720,0,0,0,8370,41611,0,0
144800,205100,2720,5,85,-3.03,35.49,475677,168831,-306846,759,543,-216,687981,2720,2720,2720,0,0,0,8569,41661,0,0
144800,205100,2720,5,85,-3.03,35.49,475677,168831,-306846,759,543,-216,687981,2720,2720,2720,0,0,0,8569,41661,0,0
144800,205100,2720,5,85,-3.03,35.49,475677,168831,-306846,759,543,-216,687981,2720,2720,2720,0,0,0,8569,41661,0,0
145100,205100,2720,5,85,-3.03,35.49,475677,168831,-306846,759,543,-216,687981,2720,2720,2720,0,0,0,8569,41661,0,0
145100,205100,2720,5,85,-3.03,35.49,475677,168831,-306846,759,543,-216,687981,2720,2720,2720,0,0,0,8569,41661,0,0
145100,205100,2720,5,85,-3.03,35.49,475677,168831,-306846,759,543,-216,687981,2720,2720,2720,0,0,0,8569,41661,0,0
145100,205100,2720,5,85,-3.03,35.49,475677,168831,-306846,759,543,-216,687981,2720,2720,2720,0,0,0,8569,41663,0,0
145100,205100,2720,5,85,-3.03,35.49,475677,168831,-306846,759,543,-216,687981,2720,2720,2720,0,0,0,8686,41540,0,0
145100,205100,2720,5,85,-3.03,35.49,475677,168831,-306846,759,543,-216,687981,2720,2720,2720,0,0,0,8686,41540,0,0
145400,205100,2720,5,85,-3.03,35.49,475677,168831,-306846,759,543,-216,687981,2720,2720,2720,0,0,0,8686,41640,0,0
145400,205100,2710,5,95,-3.39,35.47,475927,168831,-307096,761,543,-218,688231,2710,2710,2710,250,2,0,12239,41850,250,0
145400,205100,2710,5,95,-3.39,35.47,475927,168831,-307096,761,543,-218,688231,2710,2710,2710,250,2,0,12239,41850,250,0
145400,205100,2710,5,95,-3.39,35.44,476427,168832,-307595,762,544,-218,688732,2710,2710,2710,751,3,1,11036,39926,750,1
145400,205100,2710,5,95,-3.39,35.44,476427,168832,-307595,762,544,-218,688732,2710,2710,2710,751,3,1,11036,39926,750,1
145400,205100,2710,5,95,-3.39,35.44,476437,168832,-307605,763,544,-219,688742,2710,2710,2710,761,4,1,11535,40553,760,1
145700,205100,2710,5,95,-3.39,35.44,476437,168832,-307605,763,544,-219,688742,2710,2710,2710,0,0,0,11535,40553,0,0
145700,205100,2710,5,95,-3.39,35.44,476437,168832,-307605,763,544,-219,688742,2710,2710,2710,0,0,0,11103,40543,0,0
145700,205100,2710,5,95,-3.39,35.44,476437,168832,-307605,763,544,-219,688742,2710,2710,2710,0,0,0,12155,41643,0,0
145700,205100,2710,5,95,-3.39,35.44,476437,168832,-307605,763,544,-219,688742,2710,2710,2710,0,0,0,12155,41643,0,0
145700,205100,2710,5,95,-3.39,35.44,476437,168832,-307605,763,544,-219,688742,2710,2710,2710,0,0,0,12155,41643,0,0
145700,205100,2710,5,95,-3.39,35.44,476437,168832,-307605,763,544,-219,688742,2710,2710,2710,0,0,0,10583,42043,0,0
150000,205100,2710,5,95,-3.39,35.43,476537,168832,-307705,764,544,-220,688842,2710,2710,2710,100,1,0,10641,43643,100,0
150000,205100,2710,5,95,-3.39,35.43,476537,168832,-307705,764,544,-220,688842,2710,2710,2710,100,1,0,10641,43643,100,0
150000,205100,2720,5,85,-3.03,35.45,476537,168932,-307605,764,545,-219,688942,2710,2720,2710,200,1,1,10641,43543,100,100
150000,205100,2720,5,85,-3.03,35.45,476537,168932,-307605,764,545,-219,688942,2710,2720,2710,200,1,1,10641,43543,100,100
150000,205100,2720,5,85,-3.03,35.45,476537,168932,-307605,764,545,-219,688942,2710,2720,2710,200,1,1,10641,43543,100,100
150300,205100,2720,5,85,-3.03,35.45,476537,168932,-307605,764,545,-219,688942,2720,2720,2720,0,0,0,10541,42990,0,0
150300,205100,2720,5,85,-3.03,35.45,476537,168932,-307605,764,545,-219,688942,2720,2720,2720,0,0,0,10541,43014,0,0
150300,205100,2715,5,90,-3.21,35.45,476540,168932,-307608,765,545,-220,688945,2715,2715,2715,3,1,0,10551,43014,3,0
150300,205100,2710,5,95,-3.39,35.42,476981,168932,-308049,766,545,-221,689386,2715,2715,2710,444,2,0,10060,43577,444,0
150300,205100,2715,5,90,-3.21,35.53,476981,169459,-307522,766,546,-220,689913,2715,2715,2710,971,2,1,10550,149179,444,527
150300,205100,2715,5,90,-3.21,35.53,476981,169459,-307522,766,546,-220,689913,2715,2715,2710,971,2,1,10550,149179,444,527
150600,205100,2715,5,90,-3.21,35.53,476982,169459,-307523,767,546,-221,689914,2715,2715,2715,1,1,0,10033,44329,1,0
150600,205100,2715,5,90,-3.21,35.53,476982,169459,-307523,767,546,-221,689914,2715,2715,2715,1,1,0,10033,44329,1,0
150600,205100,2715,5,90,-3.21,35.53,476982,169459,-307523,767,546,-221,689914,2715,2715,2715,1,1,0,10033,44329,1,0
150600,205100,2715,5,90,-3.21,35.53,476982,169459,-307523,767,546,-221,689914,2715,2715,2715,1,1,0,10033,44329,1,0
150600,205100,2715,5,90,-3.21,35.53,476982,169459,-307523,767,546,-221,689914,2715,2715,2715,1,1,0,10033,44329,1,0
150600,205100,2720,5,85,-3.03,35.53,476982,169460,-307522,767,547,-220,689915,2715,2720,2715,2,1,1,10135,43549,1,1
150900,205100,2720,5,85,-3.03,35.53,476982,169460,-307522,767,547,-220,689915,2720,2720,2720,0,0,0,10135,43549,0,0
150900,205100,2715,5,90,-3.21,35.53,476983,169460,-307523,768,547,-221,689916,2715,2715,2715,1,1,0,10134,43499,1,0
150900,205100,2720,5,85,-3.03,35.55,477594,169788,-307806,770,548,-222,690855,2715,2720,2715,940,3,1,10304,43550,612,328
150900,205100,2720,5,85,-3.03,35.55,477594,169788,-307806,770,548,-222,690855,2715,2720,2715,940,3,1,10304,43550,612,328
150900,205100,2725,5,80,-2.85,35.55,477594,169789,-307805,770,549,-221,690856,2715,2725,2715,941,3,2,10506,42994,612,329
150900,205100,2725,5,80,-2.85,35.55,477594,169789,-307805,770,549,-221,690856,2715,2725,2715,941,3,2,10506,42994,612,329
151200,205100,2725,5,80,-2.85,35.55,477594,169789,-307805,770,549,-221,690856,2725,2725,2725,0,0,0,10506,42994,0,0
151200,205100,2725,5,80,-2.85,35.55,477594,169789,-307805,770,549,-221,690856,2725,2725,2725,0,0,0,10505,42994,0,0
151200,205100,2725,5,80,-2.85,35.55,477594,169789,-307805,770,549,-221,690856,2725,2725,2725,0,0,0,10505,43064,0,0
151200,205100,2725,5,80,-2.85,35.55,477594,169789,-307805,770,549,-221,690856,2725,2725,2725,0,0,0,10505,43064,0,0
151200,205100,2725,5,80,-2.85,35.55,477594,169789,-307805,770,549,-221,690856,2725,2725,2725,0,0,0,10505,43064,0,0
151200,205100,2725,5,80,-2.85,35.57,477594,169889,-307705,770,550,-220,690956,2725,2725,2725,100,0,1,11201,43064,0,100
151500,205100,2725,5,80,-2.85,35.59,477594,169999,-307595,770,552,-218,691066,2725,2725,2725,110,0,2,11001,43064,0,110
151500,205100,2725,5,80,-2.85,35.59,477594,169999,-307595,770,552,-218,691066,2725,2725,2725,110,0,2,11001,43064,0,110
151500,205100,2725,5,80,-2.85,35.59,477594,169999,-307595,770,552,-218,691066,2725,2725,2725,110,0,2,11001,43064,0,110
151500,205100,2720,5,85,-3.03,35.59,477694,170020,-307674,771,555,-216,691187,2725,2725,2720,231,1,5,10484,43575,100,131
151500,205100,2725,5,80,-2.85,35.59,477694,170022,-307672,771,556,-215,691189,2725,2725,2720,233,1,6,11161,43575,100,133
151800,205100,2725,5,80,-2.85,35.59,477694,170022,-307672,771,556,-215,691189,2725,2725,2725,0,0,0,11161,43575,0,0
151800,205100,2725,5,80,-2.85,35.59,477694,170022,-307672,771,556,-215,691189,2725,2725,2725,0,0,0,11159,43585,0,0
151800,205100,2720,5,85,-3.03,35.59,477695,170032,-307663,772,557,-215,691200,2715,2720,2715,11,1,1,11119,43654,1,10
151800,205100,2720,5,85,-3.03,35.59,477695,170032,-307663,772,557,-215,691200,2715,2720,2715,11,1,1,11119,43654,1,10
151800,205100,2720,5,85,-3.03,35.59,477695,170032,-307663,772,557,-215,691200,2715,2720,2715,11,1,1,11119,43654,1,10
151800,205100,2720,5,85,-3.03,35.59,477695,170032,-307663,772,557,-215,691200,2715,2720,2715,11,1,1,11119,43654,1,10
152000,205100,2720,5,85,-3.03,35.59,477695,170032,-307663,772,557,-215,691200,2720,2720,2720,0,0,0,11109,42644,0,0
152000,205100,2715,5,90,-3.21,35.53,478693,170082,-308611,773,558,-215,692248,2720,2720,2715,1048,1,1,11559,44868,998,50
152000,205100,2720,5,85,-3.03,35.59,478693,170383,-308310,773,561,-212,692549,2720,2720,2715,1349,1,4,9470,44176,998,351
152000,205100,2720,5,85,-3.03,35.59,478693,170383,-308310,773,561,-212,692549,2720,2720,2715,1349,1,4,9470,44176,998,351
152000,205100,2720,5,85,-3.03,35.59,478693,170383,-308310,773,561,-212,692549,2720,2720,2715,1349,1,4,9470,44176,998,351
152000,205100,2720,5,85,-3.03,35.59,478693,170383,-308310,773,561,-212,692549,2720,2720,2715,1349,1,4,9470,44176,998,351
152000,205100,2720,5,85,-3.03,35.59,478693,170383,-308310,773,561,-212,692549,2720,2720,2715,1349,1,4,9470,44176,998,351
152000,205100,2720,5,85,-3.03,35.59,478693,170383,-308310,773,561,-212,692549,2720,2720,2715,1349,1,4,9470,44176,998,351
152000,205100,2720,5,85,-3.03,35.59,478693,170383,-308310,773,561,-212,692549,2720,2720,2715,1349,1,4,9470,44176,998,351
152000,205100,2720,5,85,-3.03,35.59,478693,170383,-308310,773,561,-212,692549,2720,2720,2715,1349,1,4,9470,44176,998,351
152000,205100,2720,5,85,-3.03,35.59,478693,170383,-308310,773,561,-212,692549,2720,2720,2715,1349,1,4,9470,44176,998,351
152000,205100,2720,5,85,-3.03,35.59,478693,170383,-308310,773,561,-212,692549,2720,2720,2715,1349,1,4,9470,44176,998,351
152000,205100,2720,5,85,-3.03,35.59,478693,170383,-308310,773,561,-212,692549,2720,2720,2715,1349,1,4,9470,44176,998,351
152000,205100,2720,5,85,-3.03,35.59,478693,170383,-308310,773,561,-212,692549,2720,2720,2715,1349,1,4,9470,44176,998,351
152000,205100,2720,5,85,-3.03,35.59,478693,170383,-308310,773,561,-212,692549,2720,2720,2715,1349,1,4,9470,44176,998,351
152000,205100,2720,5,85,-3.03,35.59,478693,170383,-308310,773,561,-212,692549,2720,2720,2715,1349,1,4,9470,44176,998,351
152000,205100,2720,5,85,-3.03,35.59,478693,170383,-308310,773,561,-212,692549,2720,2720,2715,1349,1,4,9470,44176,998,351
152000,205100,2720,5,85,-3.03,35.59,478693,170383,-308310,773,561,-212,692549,2720,2720,2715,1349,1,4,9470,44176,998,351
152000,205100,2720,5,85,-3.03,35.59,478693,170383,-308310,773,561,-212,692549,2720,2720,2715,1349,1,4,9470,44176,998,351
152000,205100,2720,5,85,-3.03,35.59,478693,170383,-308310,773,561,-212,692549,2720,2720,2715,1349,1,4,9470,44176,998,351
152000,205100,2720,5,85,-3.03,35.59,478693,170383,-308310,773,561,-212,692549,2720,2720,2715,1349,1,4,9470,44176,998,351
152000,205100,2720,5,85,-3.03,35.59,478693,170383,-308310,773,561,-212,692549,2720,2720,2715,1349,1,4,9470,44176,998,351
152000,205100,2720,5,85,-3.03,35.59,478693,170383,-308310,773,561,-212,692549,2720,2720,2715,1349,1,4,9470,44176,998,351
153000,205100,2720,5,85,-3.03,35.59,478693,170383,-308310,773,561,-212,692549,2720,2720,2720,0,0,0,11263,44176,0,0
