092700,33626K,5210,2,255,5.15,85.99,196008,168551,-27457,2073,2180,107,389267,5210,5220,5200,2733,9,31,3607,14949,1211,1522
092800,33626K,5200,2,245,4.94,84.44,199747,168660,-31087,2079,2184,105,393115,5210,5220,5200,3848,6,4,3421,17055,3739,109
092900,33626K,5170,2,215,4.34,83.14,204384,169920,-34464,2092,2188,96,399012,5170,5170,5170,0,0,0,1592,11437,0,0
092900,33626K,5200,2,245,4.94,82.93,204900,169922,-34978,2097,2190,93,399530,5170,5200,5170,518,5,2,2997,15953,516,2
093000,33626K,5190,2,235,4.74,82.91,205003,169965,-35038,2101,2198,97,399676,5190,5190,5190,0,0,0,2510,16325,0,0
093000,33626K,5210,2,255,5.15,83.14,205331,170715,-34616,2103,2201,98,400754,5190,5210,5190,1078,2,3,5103,13636,328,750
093100,33626K,5200,2,245,4.94,82.99,205848,170824,-35024,2107,2204,97,401380,5200,5200,5200,100,0,1,4749,16630,0,100
093100,33626K,5210,2,255,5.15,83.1,206125,171284,-34841,2110,2209,99,402117,5200,5210,5200,837,3,6,5454,9216,277,560
093200,33626K,5210,2,255,5.15,83.14,206563,171739,-34824,2111,2215,104,403010,5210,5210,5210,2,0,1,12082,11788,0,2
093200,33626K,5220,2,265,5.35,83.24,206866,172204,-34662,2115,2221,106,403778,5210,5220,5210,770,4,7,12409,9344,303,467
093300,33626K,5210,2,255,5.15,83.18,207037,172206,-34831,2117,2222,105,403951,5210,5210,5210,46,1,0,12386,9116,46,0
093300,33626K,5180,2,225,4.54,82.63,208776,172509,-36267,2127,2225,98,405993,5210,5210,5180,2088,11,3,1598,13698,1785,303
093400,33626K,5190,2,235,4.74,82.51,209230,172635,-36595,2131,2229,98,406573,5190,5190,5190,1,0,1,1705,13700,0,1
093400,33626K,5170,2,215,4.34,81.03,213053,172638,-40415,2143,2230,87,410399,5190,5190,5160,3827,12,2,1939,10549,3823,4
093500,33626K,5150,2,195,3.94,79.94,216083,172747,-43336,2158,2233,75,413538,5150,5160,5150,2297,10,1,3644,9258,2296,1
093500,33626K,5120,2,165,3.33,78.83,220251,173617,-46634,2176,2238,62,418576,5150,5160,5120,7335,28,6,3340,13067,6464,871
093600,33626K,5130,2,175,3.53,79.05,221092,174777,-46315,2181,2246,65,420577,5130,5130,5130,1110,0,3,3252,15828,0,1110
093600,33626K,5150,2,195,3.94,79.5,221590,176157,-45433,2191,2252,61,422455,5130,5150,5130,2988,10,9,3131,17456,498,2490
093700,33626K,5130,2,175,3.53,79.22,222864,176555,-46309,2197,2258,61,424127,5130,5130,5130,572,1,2,3173,17631,561,11
093700,33626K,5150,2,195,3.94,80.12,223378,178980,-44398,2216,2282,66,427066,5130,5150,5120,3511,20,26,2795,17638,1075,2436
093800,33626K,5140,2,185,3.73,80.55,223654,180145,-43509,2293,2374,81,428507,5150,5150,5130,1330,30,37,2127,20683,229,1101
093800,33626K,5180,2,225,4.54,80.6,223759,180359,-43400,2367,2478,111,428826,5150,5180,5130,1649,104,141,2833,14832,334,1315
093900,33626K,5180,2,225,4.54,80.46,224450,180589,-43861,2446,2575,129,429747,5180,5180,5160,179,32,41,3735,14768,32,147
093900,33626K,5170,2,215,4.34,80.55,224526,180858,-43668,2522,2669,147,430092,5180,5180,5160,524,108,135,4164,17636,108,416
094000,33626K,5190,2,235,4.74,80.25,225983,181352,-44631,2602,2773,171,432043,5200,5200,5190,91,36,44,3886,22501,37,54
094000,33626K,5200,2,245,4.94,79.89,227673,181892,-45781,2681,2873,192,434273,5200,5200,5190,2321,115,144,4026,19037,1727,594
094100,33626K,5180,2,225,4.54,77.62,234389,181932,-52457,2728,2909,181,441029,5180,5180,5180,4914,7,0,3809,13204,4914,0
094100,33626K,5150,2,195,3.94,77.38,235344,182111,-53233,2737,2910,173,442163,5180,5180,5150,6048,16,1,4000,19418,5869,179
094200,33626K,5150,2,195,3.94,77.36,235416,182111,-53305,2740,2910,170,442235,5160,5160,5150,72,3,0,4066,18758,72,0
094200,33626K,5160,2,205,4.14,77.31,235828,182315,-53513,2744,2914,170,442851,5160,5180,5150,688,7,4,4324,19842,484,204
094300,33626K,5160,2,205,4.14,77.36,235849,182457,-53392,2746,2922,176,443014,5150,5160,5150,61,1,2,4148,19876,1,60
094300,33626K,5180,2,225,4.54,77.33,236225,182681,-53544,2747,2926,179,443614,5150,5180,5150,661,2,6,4244,14075,377,284
094400,33626K,5180,2,225,4.54,77.48,236225,183033,-53192,2747,2931,184,443966,5180,5180,5180,194,0,1,4089,12576,0,194
094400,33626K,5190,2,235,4.74,77.31,236925,183168,-53757,2748,2936,188,444801,5180,5190,5180,1029,1,6,3700,11677,700,329
094500,33626K,5190,2,235,4.74,77.35,236925,183269,-53656,2748,2938,190,444902,5190,5190,5190,1,0,1,3641,11882,0,1
094500,33626K,5190,2,235,4.74,77.37,236925,183300,-53625,2748,2942,194,444933,5190,5190,5190,32,0,5,3729,12187,0,32
094600,33626K,5160,2,205,4.14,76.94,238237,183306,-54931,2753,2944,191,446251,5180,5180,5160,1312,5,0,3905,13474,1312,0
094600,33626K,5170,2,215,4.34,76.91,238347,183306,-55041,2754,2944,190,446361,5180,5180,5160,1422,6,0,3447,12409,1422,0
094700,33626K,5170,2,215,4.34,76.35,240524,183641,-56883,2762,2947,185,448873,5170,5170,5150,1822,5,3,5541,19066,1487,335
094700,33626K,5160,2,205,4.14,76.32,240625,183645,-56980,2765,2949,184,448978,5170,5170,5150,1927,8,5,6139,19591,1588,339
094800,33626K,5160,2,205,4.14,76.69,240625,184538,-56087,2765,2958,193,449871,5160,5160,5160,890,0,6,5768,21202,0,890
094800,33626K,5170,2,215,4.34,76.7,240625,184549,-56076,2765,2960,195,449882,5160,5170,5160,901,0,8,5590,19013,0,901
094900,33626K,5180,2,225,4.54,76.83,241595,185620,-55975,2768,2963,195,451923,5170,5180,5160,941,2,1,4754,17515,940,1
094900,33626K,5160,2,205,4.14,76.8,241695,185620,-56075,2771,2963,192,452023,5170,5180,5160,1041,5,1,4753,17452,1040,1
095000,33626K,5180,2,225,4.54,76.63,242254,185640,-56614,2773,2965,192,452602,5160,5180,5160,381,1,2,4846,18927,361,20
095000,33626K,5180,2,225,4.54,76.66,242254,185703,-56551,2773,2969,196,452665,5160,5180,5160,444,1,6,5002,18675,361,83
095100,33626K,5180,2,225,4.54,76.8,242254,186048,-56206,2773,2972,199,453010,5180,5180,5180,345,0,3,4903,19689,0,345
095100,33626K,5210,2,255,5.15,77.98,242545,189133,-53412,2774,2980,206,456386,5180,5210,5180,3721,1,11,13705,20419,291,3430
095200,33626K,5190,2,235,4.74,77.99,242664,189265,-53399,2781,3001,220,456637,5210,5210,5190,251,7,21,4228,17417,119,132
095200,33626K,5210,2,255,5.15,78.2,242692,189784,-52908,2805,3097,292,457184,5210,5210,5190,798,31,117,15049,17259,147,651
095300,33626K,5220,2,265,5.35,78.42,242721,190332,-52389,2832,3182,350,457761,5210,5220,5200,543,25,77,16297,16453,27,516
095300,33626K,5220,2,265,5.35,78.55,242772,190689,-52083,2860,3255,395,458169,5210,5220,5200,951,53,150,16334,18955,78,873
095400,33626K,5200,2,245,4.94,78.12,244386,190904,-53482,2886,3314,428,459998,5220,5220,5190,1827,25,58,5544,19235,1613,214
095500,33626K,5190,2,235,4.74,78.03,244708,190940,-53768,2899,3342,443,460356,5190,5190,5190,0,0,0,6918,18983,0,0
095500,33626K,5190,2,235,4.74,78.03,244708,190940,-53768,2899,3342,443,460356,5190,5190,5190,0,0,0,6918,18983,0,0
095600,33626K,5150,2,195,3.94,76.54,249457,190944,-58513,2908,3346,438,465109,5150,5150,5150,0,0,0,6885,20346,0,0
095600,33626K,5150,2,195,3.94,76.5,249757,191057,-58700,2909,3358,449,465522,5150,5150,5140,413,1,12,6537,21038,300,113
095700,33626K,5170,2,215,4.34,76.52,249757,191116,-58641,2909,3363,454,465581,5170,5170,5170,0,0,0,7209,19962,0,0
095700,33626K,5160,2,205,4.14,75.8,252157,191136,-61021,2911,3365,454,468001,5170,5170,5160,2420,2,2,7188,17680,2400,20
095800,33626K,5160,2,205,4.14,75.62,252762,191136,-61626,2915,3365,450,468606,5160,5160,5160,365,1,0,7263,16184,365,0
095800,33626K,5160,2,205,4.14,75.47,253262,191137,-62125,2917,3366,449,469107,5160,5160,5150,866,3,1,7411,20998,865,1
095900,33626K,5150,2,195,3.94,75.31,253937,191237,-62700,2919,3367,448,469882,5150,5150,5150,0,0,0,7677,20443,0,0
095900,33626K,5160,2,205,4.14,75.23,254341,191336,-63005,2921,3368,447,470385,5160,5160,5160,503,2,1,7430,18339,404,99
100000,33626K,5160,2,205,4.14,75.22,254361,191336,-63025,2922,3368,446,470405,5160,5160,5160,0,0,0,6930,18580,0,0
100000,33626K,5180,2,225,4.54,75.37,254361,191703,-62658,2922,3369,447,470772,5180,5180,5180,367,0,1,6954,16068,0,367
100100,33626K,5170,2,215,4.34,75.11,255243,191703,-63540,2926,3369,443,471654,5170,5170,5170,1,1,0,6808,15793,1,0
100100,33626K,5170,2,215,4.34,75.11,255243,191703,-63540,2926,3369,443,471654,5170,5170,5170,1,1,0,6808,15793,1,0
100200,33626K,5160,2,205,4.14,74.88,256026,191703,-64323,2930,3369,439,472437,5170,5170,5160,367,2,0,12319,15528,367,0
100200,33626K,5160,2,205,4.14,74.88,256126,191779,-64347,2932,3370,438,472613,5170,5170,5160,543,4,1,12419,15225,467,76
100300,33626K,5150,2,195,3.94,74.68,256807,191779,-65028,2935,3370,435,473294,5160,5160,5150,474,2,0,12848,18348,474,0
100300,33626K,5150,2,195,3.94,74.61,257044,191779,-65265,2936,3370,434,473531,5160,5160,5150,711,3,0,12992,22732,711,0
100400,33626K,5160,2,205,4.14,74.61,257045,191782,-65263,2937,3373,436,473535,5160,5160,5160,0,0,0,13011,17246,0,0
100400,33626K,5150,2,195,3.94,74.32,258037,191782,-66255,2940,3373,433,474527,5160,5160,5150,992,3,0,14059,21313,992,0
100500,33626K,5140,2,185,3.73,73.85,259696,191782,-67914,2943,3373,430,476186,5150,5150,5140,1658,2,0,14061,21028,1658,0
100500,33626K,5140,2,185,3.73,73.38,261342,191782,-69560,2944,3373,429,477832,5150,5150,5140,3304,3,0,14083,27006,3304,0
100600,33626K,5140,2,185,3.73,73.38,261343,191782,-69561,2945,3373,428,477833,5140,5140,5140,0,0,0,14093,25079,0,0
100600,33626K,5140,2,185,3.73,73.29,261661,191782,-69879,2951,3373,422,478151,5140,5140,5140,318,6,0,14315,25149,318,0
100700,33626K,5130,2,175,3.53,72.74,263671,191782,-71889,2954,3373,419,480161,5130,5130,5130,1667,1,0,14638,24791,1667,0
100700,33626K,5130,2,175,3.53,72.57,264276,191782,-72494,2956,3373,417,480766,5130,5130,5130,2272,3,0,14315,22504,2272,0
100800,33626K,5130,2,175,3.53,72.54,264397,191782,-72615,2957,3373,416,480887,5130,5130,5130,0,0,0,12993,21707,0,0
100800,33626K,5140,2,185,3.73,72.84,265003,193040,-71963,2961,3378,417,482751,5140,5140,5130,1864,4,5,13918,21128,606,1258
100900,33626K,5140,2,185,3.73,73.12,265003,193770,-71233,2961,3384,423,483481,5140,5140,5140,690,0,3,12595,23132,0,690
100900,33626K,5140,2,185,3.73,73.15,265003,193839,-71164,2961,3387,426,483550,5140,5140,5140,759,0,6,12523,23132,0,759
101000,33626K,5140,2,185,3.73,73.13,265075,193839,-71236,2963,3387,424,483622,5140,5140,5140,70,1,0,12941,23594,70,0
101000,33626K,5150,2,195,3.94,73.35,265075,194427,-70648,2963,3390,427,484210,5140,5150,5140,658,1,3,12720,23568,70,588
101100,33626K,5150,2,195,3.94,73.35,265075,194442,-70633,2963,3395,432,484225,5150,5150,5150,15,0,5,12479,25788,0,15
101100,33626K,5150,2,195,3.94,73.31,265225,194447,-70778,2965,3396,431,484380,5150,5150,5140,170,2,6,12334,27642,150,20
101200,33626K,5150,2,195,3.94,73.31,265225,194447,-70778,2965,3396,431,484380,5150,5150,5150,0,0,0,12334,27642,0,0
101200,33626K,5160,2,205,4.14,73.39,265225,194652,-70573,2965,3398,433,484585,5150,5160,5150,205,0,2,13479,21468,0,205
101300,33626K,5160,2,205,4.14,73.43,265225,194760,-70465,2965,3400,435,484693,5160,5160,5160,108,0,2,13510,21478,0,108
101300,33626K,5160,2,205,4.14,73.49,265225,194910,-70315,2965,3402,437,484843,5160,5160,5160,258,0,4,13357,21233,0,258
101400,33626K,5160,2,205,4.14,73.49,265225,194910,-70315,2965,3402,437,484843,5160,5160,5160,0,0,0,13357,21233,0,0
101400,33626K,5150,2,195,3.94,73.49,265226,194910,-70316,2966,3402,436,484844,5150,5150,5150,1,1,0,13274,21433,1,0
101500,33626K,5160,2,205,4.14,73.47,265416,194993,-70423,2968,3408,440,485117,5160,5160,5150,273,2,6,13816,22683,190,83
101500,33626K,5170,2,215,4.34,73.41,265646,195002,-70644,2970,3417,447,485356,5160,5170,5150,512,4,15,13664,19091,420,92
101600,33626K,5170,2,215,4.34,73.3,266044,195003,-71041,2971,3418,447,485755,5160,5170,5160,399,1,1,14172,22453,398,1
101600,33626K,5160,2,205,4.14,73.29,266058,195004,-71054,2973,3419,446,485770,5160,5170,5160,414,3,2,14588,18816,412,2
101700,33626K,5170,2,215,4.34,73.29,266059,195005,-71054,2974,3420,446,485772,5160,5170,5160,2,1,1,14588,19002,1,1
101800,33626K,5170,2,215,4.34,73.48,266059,195488,-70571,2974,3421,447,486255,5170,5170,5170,0,0,0,14909,19005,0,0
101800,33626K,5170,2,215,4.34,73.48,266059,195488,-70571,2974,3421,447,486255,5170,5170,5170,0,0,0,14909,19005,0,0
101900,33626K,5160,2,205,4.14,73.44,266249,195538,-70711,2976,3422,446,486495,5160,5160,5160,90,1,0,14376,20515,90,0
101900,33626K,5150,2,195,3.94,73.34,266629,195538,-71091,2978,3422,444,486875,5160,5160,5150,470,3,0,14380,24373,470,0
102000,33626K,5160,2,205,4.14,73.24,267358,195826,-71532,2981,3423,442,487892,5160,5160,5160,0,0,0,13913,23513,0,0
102000,33626K,5150,2,195,3.94,73.0,268258,195826,-72432,2983,3423,440,488792,5160,5160,5150,900,2,0,13909,19737,900,0
102100,33626K,5160,2,205,4.14,73.01,268258,195855,-72403,2983,3426,443,488821,5160,5160,5160,18,0,1,13540,22977,0,18
102100,33626K,5150,2,195,3.94,72.81,269009,195855,-73154,2986,3426,440,489572,5160,5160,5150,769,3,1,13806,19619,751,18
102200,33626K,5150,2,195,3.94,72.75,269212,195855,-73357,2987,3426,439,489775,5150,5150,5150,0,0,0,13826,23079,0,0
102200,33626K,5150,2,195,3.94,72.66,269834,196065,-73769,2989,3428,439,490607,5150,5160,5150,832,2,2,13776,23099,622,210
102300,33626K,5150,2,195,3.94,72.66,269834,196065,-73769,2989,3428,439,490607,5150,5150,5150,0,0,0,13776,23099,0,0
102300,33626K,5150,2,195,3.94,72.47,270560,196065,-74495,2991,3428,437,491333,5150,5150,5150,726,2,0,13811,22920,726,0
102400,33626K,5150,2,195,3.94,72.54,270563,196265,-74298,2992,3429,437,491536,5150,5150,5150,0,0,0,13614,22753,0,0
102400,33626K,5150,2,195,3.94,72.09,272263,196265,-75998,2995,3429,434,493236,5150,5150,5150,1700,3,0,13114,24710,1700,0
102500,33626K,5150,2,195,3.94,72.12,272268,196365,-75903,2996,3430,434,493341,5150,5150,5150,5,1,0,12514,24955,5,0
102500,33626K,5150,2,195,3.94,71.87,273217,196365,-76852,2999,3430,431,494290,5150,5150,5150,954,4,0,11841,23666,954,0
102600,33626K,5150,2,195,3.94,71.88,273217,196375,-76842,2999,3431,432,494300,5150,5150,5150,0,0,0,10685,24150,0,0
102600,33626K,5160,2,205,4.14,71.76,273980,196611,-77369,3002,3433,431,495299,5140,5160,5140,999,3,2,12341,23434,763,236
102700,33626K,5160,2,205,4.14,71.76,273980,196611,-77369,3002,3433,431,495299,5160,5160,5160,0,0,0,12341,23434,0,0
102700,33626K,5160,2,205,4.14,71.79,274077,196767,-77310,3003,3435,432,495552,5160,5160,5160,253,1,2,12577,23589,97,156
102800,33626K,5130,2,175,3.53,71.57,274919,196767,-78152,3005,3435,430,496394,5130,5130,5130,100,1,0,11401,22471,100,0
102800,33626K,5130,2,175,3.53,71.55,275011,196767,-78244,3007,3435,428,496486,5130,5130,5130,192,3,0,13383,22382,192,0
102900,33626K,5140,2,185,3.73,71.65,275011,197033,-77978,3007,3452,445,496752,5140,5140,5140,266,0,17,13118,22781,0,266
102900,33626K,5140,2,185,3.73,72.06,275011,198176,-76835,3007,3453,446,497895,5140,5140,5140,1409,0,18,13717,22941,0,1409
103000,33626K,5170,2,215,4.34,72.06,275011,198177,-76834,3007,3454,447,497896,5170,5170,5170,0,0,0,12878,23087,0,0
103000,33626K,5140,2,185,3.73,72.06,275021,198177,-76844,3008,3454,446,497906,5140,5140,5140,10,1,0,12980,25459,10,0
103100,33626K,5140,2,185,3.73,72.06,275021,198177,-76844,3008,3454,446,497906,5140,5140,5140,0,0,0,12980,25459,0,0
103100,33626K,5140,2,185,3.73,72.06,275021,198177,-76844,3008,3454,446,497906,5140,5140,5140,0,0,0,13185,24351,0,0
103200,33626K,5140,2,185,3.73,71.9,275614,198177,-77437,3009,3454,445,498499,5140,5140,5140,593,1,0,12912,25231,593,0
103200,33626K,5140,2,185,3.73,71.8,276012,198177,-77835,3012,3454,442,498897,5140,5140,5140,991,4,0,13281,23363,991,0
103300,33626K,5140,2,185,3.73,71.52,277080,198177,-78903,3015,3454,439,499965,5140,5140,5140,58,1,0,12278,22032,58,0
103300,33626K,5140,2,185,3.73,71.52,277080,198177,-78903,3015,3454,439,499965,5140,5140,5140,58,1,0,12278,22032,58,0
103400,33626K,5140,2,185,3.73,71.43,277460,198183,-79277,3017,3460,443,500351,5140,5150,5140,386,2,6,12272,22066,380,6
103400,33626K,5140,2,185,3.73,71.43,277464,198183,-79281,3018,3460,442,500355,5140,5150,5140,390,3,6,12268,22880,384,6
103500,33626K,5140,2,185,3.73,71.13,278612,198183,-80429,3023,3460,437,501503,5140,5140,5140,1148,5,0,12268,21587,1148,0
103500,33626K,5170,2,215,4.34,71.65,278612,199623,-78989,3023,3464,441,502943,5140,5170,5140,2588,5,4,13614,21860,1148,1440
103600,33626K,5170,2,215,4.34,71.76,278739,200012,-78727,3025,3465,440,503459,5180,5180,5170,516,2,1,12901,17371,127,389
103700,33626K,5180,2,225,4.54,72.19,278830,201288,-77542,3031,3467,436,504826,5180,5180,5180,21,1,0,12600,17446,21,0
103700,33626K,5180,2,225,4.54,72.19,278830,201288,-77542,3031,3467,436,504826,5180,5180,5180,21,1,0,12600,17446,21,0
103800,33626K,5180,2,225,4.54,72.2,278830,201308,-77522,3031,3468,437,504846,5180,5180,5180,0,0,0,11817,19162,0,0
103800,33626K,5180,2,225,4.54,72.2,278830,201308,-77522,3031,3468,437,504846,5180,5180,5180,0,0,0,11817,19162,0,0
103900,33626K,5180,2,225,4.54,72.2,278830,201308,-77522,3031,3468,437,504846,5180,5180,5180,0,0,0,11821,19311,0,0
103900,33626K,5150,2,195,3.94,72.15,279030,201308,-77722,3033,3468,435,505046,5160,5160,5150,200,2,0,12347,19368,200,0
104000,33626K,5150,2,195,3.94,72.14,279048,201308,-77740,3034,3468,434,505064,5150,5150,5150,0,0,0,12347,19561,0,0
104000,33626K,5150,2,195,3.94,72.14,279048,201308,-77740,3034,3468,434,505064,5150,5150,5150,0,0,0,12347,19561,0,0
104100,33626K,5140,2,185,3.73,71.87,280105,201309,-78796,3038,3469,431,506122,5140,5140,5140,0,0,0,12303,19391,0,0
104100,33626K,5140,2,185,3.73,71.87,280105,201309,-78796,3038,3469,431,506122,5140,5140,5140,0,0,0,12303,19391,0,0
104200,33626K,5140,2,185,3.73,71.87,280119,201309,-78810,3039,3469,430,506136,5140,5140,5140,0,0,0,12129,21905,0,0
104200,33626K,5140,2,185,3.73,71.87,280119,201309,-78810,3039,3469,430,506136,5140,5140,5140,0,0,0,12129,21905,0,0
104300,33626K,5140,2,185,3.73,71.87,280119,201309,-78810,3039,3469,430,506136,5140,5140,5140,0,0,0,12734,21721,0,0
104300,33626K,5140,2,185,3.73,71.77,280482,201309,-79173,3042,3469,427,506499,5140,5140,5140,363,3,0,12786,21458,363,0
104400,33626K,5170,2,215,4.34,71.77,280482,201311,-79171,3042,3471,429,506501,5170,5170,5170,0,0,0,12807,21441,0,0
104400,33626K,5170,2,215,4.34,71.77,280482,201311,-79171,3042,3471,429,506501,5170,5170,5170,0,0,0,12807,21441,0,0
104500,33626K,5140,2,185,3.73,71.72,280682,201311,-79371,3044,3471,427,506701,5160,5160,5140,200,2,0,11776,21005,200,0
104500,33626K,5140,2,185,3.73,71.7,280776,201311,-79465,3045,3471,426,506795,5160,5160,5140,294,3,0,11984,21093,294,0
104600,33626K,5140,2,185,3.73,71.7,280776,201311,-79465,3045,3471,426,506795,5140,5140,5140,0,0,0,11984,21093,0,0
104600,33626K,5140,2,185,3.73,71.7,280776,201311,-79465,3045,3471,426,506795,5140,5140,5140,0,0,0,12729,22936,0,0
104700,33626K,5150,2,195,3.94,71.69,280813,201311,-79502,3047,3471,424,506832,5150,5150,5150,8,1,0,12729,22910,8,0
104700,33626K,5140,2,185,3.73,71.68,280892,201351,-79541,3049,3472,423,506951,5150,5150,5140,127,3,1,12459,23139,87,40
104800,33626K,5140,2,185,3.73,71.68,280892,201351,-79541,3049,3472,423,506951,5140,5140,5140,0,0,0,12459,23139,0,0
104800,33626K,5140,2,185,3.73,71.62,281142,201351,-79791,3050,3472,422,507201,5140,5140,5140,250,1,0,12698,23675,250,0
104900,33626K,5140,2,185,3.73,71.6,281222,201351,-79871,3051,3472,421,507281,5140,5140,5140,80,1,0,12698,23425,80,0
104900,33626K,5140,2,185,3.73,71.6,281222,201351,-79871,3051,3472,421,507281,5140,5140,5140,80,1,0,12698,23425,80,0
105000,33626K,5140,2,185,3.73,71.6,281222,201351,-79871,3051,3472,421,507281,5140,5140,5140,0,0,0,12698,23425,0,0
105000,33626K,5140,2,185,3.73,71.6,281232,201351,-79881,3052,3472,420,507291,5140,5140,5140,10,1,0,12698,23550,10,0
105100,33626K,5140,2,185,3.73,71.6,281232,201351,-79881,3052,3472,420,507291,5140,5140,5140,0,0,0,12698,23550,0,0
105100,33626K,5140,2,185,3.73,71.58,281278,201351,-79927,3054,3472,418,507337,5140,5140,5140,46,2,0,12363,23406,46,0
105200,33626K,5140,2,185,3.73,71.34,282254,201351,-80903,3055,3472,417,508313,5140,5140,5140,976,1,0,12363,23494,976,0
105200,33626K,5140,2,185,3.73,71.23,282711,201368,-81343,3058,3473,415,508787,5140,5140,5140,1450,4,1,13511,24248,1433,17
105300,33626K,5140,2,185,3.73,71.23,282711,201368,-81343,3058,3473,415,508787,5140,5140,5140,0,0,0,13511,24248,0,0
105300,33626K,5140,2,185,3.73,71.72,282711,202752,-79959,3058,3476,418,510171,5140,5140,5140,1384,0,3,13389,24248,0,1384
105400,33626K,5130,2,175,3.53,71.62,283081,202755,-80326,3059,3477,418,510544,5140,5140,5130,373,1,1,12132,24248,370,3
105400,33626K,5170,2,215,4.34,71.63,283081,202779,-80302,3059,3480,421,510568,5140,5170,5130,397,1,4,12403,21731,370,27
105500,33626K,5170,2,215,4.34,71.63,283081,202780,-80301,3059,3481,422,510569,5170,5170,5170,0,0,0,12402,20731,0,0
105600,33626K,5170,2,215,4.34,71.63,283081,202780,-80301,3059,3481,422,510569,5170,5170,5170,0,0,0,12415,20537,0,0
105600,33626K,5170,2,215,4.34,71.63,283081,202780,-80301,3059,3481,422,510569,5170,5170,5170,0,0,0,12303,22780,0,0
105700,33626K,5170,2,215,4.34,71.63,283081,202780,-80301,3059,3481,422,510569,5170,5170,5170,0,0,0,13069,22780,0,0
105700,33626K,5140,2,185,3.73,71.63,283083,202780,-80303,3060,3481,421,510571,5140,5140,5140,2,1,0,13360,20617,2,0
105800,33626K,5140,2,185,3.73,71.53,283501,202780,-80721,3061,3481,420,510989,5140,5140,5140,418,1,0,13358,21015,418,0
105800,33626K,5150,2,195,3.94,71.57,283624,202982,-80642,3062,3483,421,511314,5140,5150,5130,743,2,2,13376,21045,541,202
105900,33626K,5140,2,185,3.73,71.43,284166,202982,-81184,3063,3483,420,511856,5140,5140,5140,0,0,0,13289,21347,0,0
105900,33626K,5140,2,185,3.73,71.43,284186,202998,-81188,3065,3486,421,511892,5140,5140,5130,36,2,3,13377,21052,20,16
110000,33626K,5140,2,185,3.73,71.38,284387,202998,-81389,3066,3486,420,512093,5140,5140,5140,0,0,0,13377,21201,0,0
110000,33626K,5150,2,195,3.94,71.38,284387,203008,-81379,3066,3487,421,512103,5150,5150,5150,10,0,1,13425,21019,0,10
110100,33626K,5140,2,185,3.73,71.38,284407,203008,-81399,3067,3487,420,512123,5140,5140,5140,20,1,0,13315,21003,20,0
110100,33626K,5140,2,185,3.73,71.42,284507,203184,-81323,3068,3489,421,512399,5140,5140,5130,296,2,2,12826,20923,120,176
110200,33626K,5140,2,185,3.73,71.42,284507,203184,-81323,3068,3489,421,512399,5140,5140,5140,0,0,0,12826,20923,0,0
110200,33626K,5140,2,185,3.73,71.39,284608,203184,-81424,3069,3489,420,512500,5140,5140,5140,101,1,0,13315,21619,101,0
110300,33626K,5130,2,175,3.53,71.15,285559,203184,-82375,3071,3489,418,513451,5130,5130,5130,0,0,0,13315,21518,0,0
110300,33626K,5140,2,185,3.73,71.16,285559,203195,-82364,3071,3491,420,513462,5140,5140,5140,11,0,2,12662,21790,0,11
110400,33626K,5140,2,185,3.73,71.12,285817,203267,-82550,3073,3493,420,513792,5140,5140,5140,158,1,0,13254,23019,158,0
110400,33626K,5150,2,195,3.94,71.38,285817,204029,-81788,3073,3496,423,514554,5140,5150,5140,920,1,3,12246,22793,158,762
110500,33626K,5140,2,185,3.73,71.38,285834,204029,-81805,3076,3496,420,514571,5140,5140,5140,17,3,0,12250,23277,17,0
110500,33626K,5140,2,185,3.73,71.37,285941,204079,-81862,3077,3501,424,514728,5140,5140,5140,174,4,5,12013,23296,124,50
110600,33626K,5140,2,185,3.73,71.52,285941,204511,-81430,3077,3507,430,515160,5150,5150,5140,15,0,3,11694,23306,0,15
110600,33626K,5130,2,175,3.53,71.52,285961,204521,-81440,3078,3508,430,515190,5150,5150,5130,45,1,4,11681,23303,20,25
110700,33626K,5130,2,175,3.53,71.52,285967,204521,-81446,3079,3508,429,515196,5130,5130,5130,0,0,0,11681,23301,0,0
110700,33626K,5140,2,185,3.73,71.55,285967,204598,-81369,3079,3510,431,515273,5140,5140,5140,77,0,2,11680,23282,0,77
110800,33626K,5140,2,185,3.73,71.55,285967,204598,-81369,3079,3510,431,515273,5140,5140,5140,0,0,0,11680,23282,0,0
110800,33626K,5140,2,185,3.73,71.53,286048,204600,-81448,3081,3511,430,515356,5140,5140,5140,83,2,1,11614,23460,81,2
110900,33626K,5130,2,175,3.53,71.4,286548,204600,-81948,3082,3511,429,515856,5130,5130,5130,500,1,0,11612,23460,500,0
110900,33626K,5130,2,175,3.53,71.27,287085,204600,-82485,3083,3511,428,516393,5130,5130,5130,1037,2,0,11612,22960,1037,0
111000,33626K,5140,2,185,3.73,71.27,287093,204602,-82491,3084,3512,428,516403,5130,5140,5130,10,1,1,11654,24108,8,2
111000,33626K,5140,2,185,3.73,71.25,287245,204651,-82594,3085,3514,429,516604,5130,5150,5130,211,2,3,12267,24144,160,51
111100,33626K,5140,2,185,3.73,71.26,287272,204719,-82553,3088,3516,428,516699,5140,5140,5130,77,2,2,11673,25598,9,68
111100,33626K,5130,2,175,3.53,71.25,287474,204813,-82661,3091,3517,426,516995,5140,5140,5130,373,5,3,11633,26956,211,162
111200,33626K,5170,2,215,4.34,71.34,287475,205082,-82393,3092,3522,430,517265,5130,5170,5130,264,1,4,12332,26431,1,263
111200,33626K,5170,2,215,4.34,71.46,287475,205443,-82032,3092,3524,432,517626,5130,5170,5130,625,1,6,13407,25917,1,624
111300,33626K,5170,2,215,4.34,71.8,287475,206400,-81075,3092,3525,433,518583,5170,5170,5170,957,0,1,13734,25952,0,957
111400,33626K,5160,2,205,4.14,71.83,287475,206500,-80975,3092,3527,435,518683,5160,5160,5160,0,0,0,12499,25953,0,0
111400,33626K,5160,2,205,4.14,71.79,287708,206550,-81158,3093,3528,435,518966,5160,5160,5160,283,1,1,12552,26303,233,50
111500,33626K,5130,2,175,3.53,71.47,288996,206550,-82446,3098,3528,430,520254,5130,5130,5130,0,0,0,13487,26106,0,0
111500,33626K,5140,2,185,3.73,71.47,289006,206550,-82456,3099,3528,429,520264,5140,5140,5140,10,1,0,12913,26346,10,0
111600,33626K,5140,2,185,3.73,71.12,290592,206666,-83926,3102,3530,428,521966,5140,5140,5140,778,1,0,13301,26406,778,0
111600,33626K,5140,2,185,3.73,71.29,290592,207173,-83419,3102,3534,432,522473,5140,5140,5140,1285,1,4,12600,25345,778,507
111700,33626K,5140,2,185,3.73,71.35,290692,207396,-83296,3103,3558,455,522796,5140,5140,5140,3,0,3,11989,25245,0,3
111700,33626K,5140,2,185,3.73,71.34,290792,207439,-83353,3104,3582,478,522939,5140,5140,5130,146,1,27,12070,25395,100,46
111800,33626K,5140,2,185,3.73,71.32,290892,207460,-83432,3105,3603,498,523060,5140,5140,5130,106,1,6,11893,25295,100,6
111800,33626K,5150,2,195,3.94,71.16,291618,207519,-84099,3106,3619,513,523845,5140,5150,5130,891,2,22,11998,25220,826,65
111900,33626K,5150,2,195,3.94,71.2,291620,207627,-83993,3108,3633,525,523955,5140,5150,5140,99,1,4,11890,25321,1,98
111900,33626K,5150,2,195,3.94,71.2,291622,207636,-83986,3109,3642,533,523966,5140,5150,5140,110,2,13,11921,25277,3,107
112000,33626K,5150,2,195,3.94,71.23,291629,207740,-83889,3110,3652,542,524077,5150,5150,5150,3,0,3,11817,25258,0,3
112000,33626K,5150,2,195,3.94,71.24,291629,207749,-83880,3110,3660,550,524086,5150,5150,5150,12,0,11,11807,25003,0,12
112100,33626K,5150,2,195,3.94,71.24,291629,207759,-83870,3110,3668,558,524096,5150,5150,5150,4,0,4,11798,24049,0,4
112100,33626K,5150,2,195,3.94,71.24,291629,207763,-83866,3110,3672,562,524100,5150,5150,5150,8,0,8,11994,24049,0,8
112200,33626K,5150,2,195,3.94,71.24,291629,207766,-83863,3110,3675,565,524103,5150,5150,5150,2,0,2,11991,23560,0,2
112200,33626K,5150,2,195,3.94,71.22,291855,207862,-83993,3112,3688,576,524425,5150,5150,5130,324,2,15,12082,23604,226,98
112300,33626K,5140,2,185,3.73,71.13,292239,207865,-84374,3113,3691,578,524812,5140,5140,5140,1,0,1,12645,23081,0,1
112300,33626K,5150,2,195,3.94,71.5,292240,208940,-83300,3114,3694,580,525888,5140,5150,5140,1077,1,4,12069,23081,1,1076
112400,33626K,5150,2,195,3.94,71.5,292240,208941,-83299,3114,3695,581,525889,5150,5150,5150,1,0,1,11947,23081,0,1
112400,33626K,5150,2,195,3.94,71.5,292240,208942,-83298,3114,3696,582,525890,5150,5150,5150,2,0,2,13229,23081,0,2
112500,33626K,5130,2,175,3.53,71.46,292407,208942,-83465,3115,3696,581,526057,5130,5130,5130,167,1,0,13228,23081,167,0
112500,33626K,5130,2,175,3.53,71.45,292438,208942,-83496,3116,3696,580,526088,5130,5130,5130,198,2,0,13228,23157,198,0
112600,33626K,5130,2,175,3.53,71.44,292459,208942,-83517,3118,3696,578,526109,5140,5140,5130,21,2,0,13228,22577,21,0
112600,33626K,5130,2,175,3.53,71.37,292759,208942,-83817,3119,3696,577,526409,5140,5140,5130,321,3,0,13854,23185,321,0
112700,33626K,5130,2,175,3.53,71.27,293159,208942,-84217,3120,3696,576,526809,5130,5130,5130,400,1,0,13859,23335,400,0
112700,33626K,5150,2,195,3.94,71.27,293160,208943,-84217,3121,3697,576,526811,5130,5150,5130,402,2,1,13731,26122,401,1
112800,33626K,5150,2,195,3.94,72.24,293160,211786,-81374,3121,3698,577,529654,5150,5150,5150,2843,0,1,16055,23368,0,2843
112800,33626K,5160,2,205,4.14,72.53,293160,212616,-80544,3121,3701,580,530484,5150,5160,5150,3673,0,4,13167,23707,0,3673
112900,33626K,5160,2,205,4.14,72.56,293160,212725,-80435,3121,3703,582,530593,5160,5160,5160,1,0,1,13058,23687,0,1
112900,33626K,5180,2,225,4.54,73.18,293160,214538,-78622,3121,3710,589,532406,5160,5180,5160,1814,0,8,11938,19455,0,1814
113000,33626K,5190,2,235,4.74,73.22,293160,214658,-78502,3121,3717,596,532526,5180,5190,5180,120,0,7,12659,20181,0,120
113000,33626K,5190,2,235,4.74,73.22,293160,214658,-78502,3121,3717,596,532526,5180,5190,5180,120,0,7,12659,20181,0,120
113100,33626K,5170,2,215,4.34,72.88,294537,214661,-79876,3123,3720,597,533906,5190,5190,5170,1380,2,3,13614,20110,1377,3
113200,33626K,5170,2,215,4.34,72.88,294537,214662,-79875,3123,3721,598,533907,5170,5170,5170,0,0,0,13893,20119,0,0
113200,33626K,5170,2,215,4.34,72.85,294673,214663,-80010,3124,3722,598,534044,5140,5170,5140,137,1,1,14893,19983,136,1
113300,33626K,5150,2,195,3.94,72.85,294673,214673,-80000,3124,3723,599,534054,5150,5150,5150,0,0,0,13092,20411,0,0
113300,33626K,5170,2,215,4.34,72.78,295087,214776,-80311,3125,3727,602,534571,5150,5170,5150,517,1,4,13044,19679,414,103
113400,33626K,5170,2,215,4.34,72.78,295087,214776,-80311,3125,3727,602,534571,5170,5170,5170,0,0,0,13044,19679,0,0
113400,33626K,5170,2,215,4.34,72.78,295087,214776,-80311,3125,3727,602,534571,5170,5170,5170,0,0,0,13043,20158,0,0
113500,33626K,5170,2,215,4.34,72.82,295087,214876,-80211,3125,3728,603,534671,5170,5170,5170,0,0,0,13557,20460,0,0
113500,33626K,5170,2,215,4.34,72.82,295087,214876,-80211,3125,3728,603,534671,5170,5170,5170,0,0,0,13557,20460,0,0
113600,33626K,5170,2,215,4.34,72.82,295089,214877,-80212,3126,3729,603,534674,5170,5170,5170,0,0,0,13460,19709,0,0
113600,33626K,5170,2,215,4.34,72.82,295089,214877,-80212,3126,3729,603,534674,5170,5170,5170,0,0,0,13460,19709,0,0
113700,33626K,5170,2,215,4.34,72.82,295090,214878,-80212,3127,3730,603,534676,5170,5170,5170,0,0,0,13404,19970,0,0
113700,33626K,5170,2,215,4.34,72.82,295090,214878,-80212,3127,3730,603,534676,5170,5170,5170,0,0,0,13404,19970,0,0
113800,33626K,5170,2,215,4.34,72.82,295090,214878,-80212,3127,3730,603,534676,5170,5170,5170,0,0,0,13403,19970,0,0
113800,33626K,5170,2,215,4.34,72.82,295090,214878,-80212,3127,3730,603,534676,5170,5170,5170,0,0,0,13353,20338,0,0
113900,33626K,5170,2,215,4.34,72.82,295090,214878,-80212,3127,3730,603,534676,5170,5170,5170,0,0,0,13421,20834,0,0
113900,33626K,5160,2,205,4.14,72.72,295485,214879,-80606,3128,3731,603,535072,5170,5170,5160,396,1,1,14323,21036,395,1
114000,33626K,5150,2,195,3.94,72.71,295531,214879,-80652,3129,3731,602,535118,5150,5150,5150,0,0,0,13354,19894,0,0
114000,33626K,5160,2,205,4.14,72.71,295531,214880,-80651,3129,3732,603,535119,5160,5160,5160,1,0,1,13312,19828,0,1
114100,33626K,5160,2,205,4.14,72.71,295531,214880,-80651,3129,3732,603,535119,5160,5160,5160,0,0,0,13312,19828,0,0
114100,33626K,5160,2,205,4.14,72.71,295531,214880,-80651,3129,3732,603,535119,5160,5160,5160,0,0,0,13311,19828,0,0
114200,33626K,5160,2,205,4.14,72.71,295531,214885,-80646,3129,3733,604,535124,5160,5160,5160,0,0,0,12911,19828,0,0
114200,33626K,5160,2,205,4.14,72.72,295531,214896,-80635,3129,3734,605,535135,5160,5160,5160,11,0,1,12906,19828,0,11
114300,33626K,5140,2,185,3.73,72.78,297152,216256,-80896,3131,3736,605,538116,5140,5140,5140,2143,1,2,12805,19563,783,1360
114300,33626K,5140,2,185,3.73,72.65,297652,216256,-81396,3132,3736,604,538616,5140,5140,5140,2643,2,2,11824,19302,1283,1360
114400,33626K,5170,2,215,4.34,72.73,297652,216492,-81160,3132,3740,608,538852,5150,5170,5150,236,0,4,12076,20398,0,236
114400,33626K,5170,2,215,4.34,72.68,297868,216493,-81375,3133,3741,608,539069,5150,5170,5150,453,1,5,14584,20382,216,237
114500,33626K,5170,2,215,4.34,72.68,297868,216494,-81374,3133,3742,609,539070,5170,5170,5170,1,0,1,14456,20346,0,1
114500,33626K,5170,2,215,4.34,72.67,297987,216544,-81443,3134,3743,609,539239,5170,5170,5150,170,1,2,14455,20227,119,51
114600,33626K,5170,2,215,4.34,72.67,297987,216544,-81443,3134,3743,609,539239,5170,5170,5170,0,0,0,14455,20227,0,0
114600,33626K,5170,2,215,4.34,72.82,297987,217009,-80978,3134,3744,610,539704,5170,5170,5170,465,0,1,14405,20827,0,465
114700,33626K,5170,2,215,4.34,72.83,297987,217011,-80976,3134,3745,611,539706,5170,5170,5170,2,0,1,13340,20827,0,2
114700,33626K,5170,2,215,4.34,72.61,298861,217012,-81849,3135,3746,611,540581,5170,5170,5150,877,1,2,13338,19953,874,3
114800,33626K,5150,2,195,3.94,72.47,299462,217012,-82450,3136,3746,610,541182,5150,5150,5150,601,1,0,13444,20211,601,0
114800,33626K,5150,2,195,3.94,72.47,299462,217012,-82450,3136,3746,610,541182,5150,5150,5150,601,1,0,13444,20211,601,0
114900,33626K,5140,2,185,3.73,72.45,299549,217012,-82537,3138,3746,608,541269,5140,5140,5140,87,2,0,12960,20407,87,0
115000,33626K,5140,2,185,3.73,72.45,299549,217012,-82537,3138,3746,608,541269,5140,5140,5140,0,0,0,12960,20407,0,0
115000,33626K,5140,2,185,3.73,72.08,301062,217012,-84050,3141,3746,605,542782,5140,5140,5140,1513,3,0,13576,19379,1513,0
115100,33626K,5140,2,185,3.73,72.0,301398,217012,-84386,3142,3746,604,543118,5140,5140,5140,0,0,0,13576,19021,0,0
115100,33626K,5140,2,185,3.73,72.0,301398,217012,-84386,3142,3746,604,543118,5140,5140,5140,0,0,0,13576,19021,0,0
115200,33626K,5150,2,195,3.94,72.0,301398,217017,-84381,3142,3747,605,543123,5150,5150,5150,0,0,0,12976,19066,0,0
115200,33626K,5150,2,195,3.94,72.0,301398,217017,-84381,3142,3747,605,543123,5150,5150,5150,0,0,0,12976,19066,0,0
115300,33626K,5150,2,195,3.94,72.0,301398,217017,-84381,3142,3747,605,543123,5150,5150,5150,0,0,0,12685,19366,0,0
115300,33626K,5130,2,175,3.53,71.68,302747,217018,-85729,3144,3748,604,544473,5150,5150,5130,1350,2,1,12684,19362,1349,1
115400,33626K,5150,2,195,3.94,71.69,302747,217028,-85719,3144,3749,605,544483,5150,5150,5150,0,0,0,12684,18118,0,0
115400,33626K,5130,2,175,3.53,71.67,302827,217028,-85799,3146,3749,603,544563,5140,5140,5130,80,2,0,13534,17793,80,0
115500,33626K,5120,2,165,3.33,71.25,304614,217028,-87586,3150,3749,599,546350,5130,5130,5120,1785,2,0,13534,17978,1785,0
115500,33626K,5120,2,165,3.33,71.22,304723,217028,-87695,3151,3749,598,546459,5130,5130,5120,1894,3,0,13349,16498,1894,0
115600,33626K,5120,2,165,3.33,71.15,305023,217028,-87995,3153,3749,596,546759,5130,5130,5120,300,2,0,13227,16394,300,0
115600,33626K,5120,2,165,3.33,71.15,305023,217028,-87995,3153,3749,596,546759,5130,5130,5120,300,2,0,13227,16394,300,0
115700,33626K,5120,2,165,3.33,71.15,305023,217028,-87995,3153,3749,596,546759,5120,5120,5120,0,0,0,13227,16394,0,0
115700,33626K,5120,2,165,3.33,71.13,305120,217028,-88092,3155,3749,594,546856,5130,5130,5120,97,2,0,13239,18308,97,0
115800,33626K,5120,2,165,3.33,71.13,305120,217028,-88092,3155,3749,594,546856,5120,5120,5120,0,0,0,13239,18308,0,0
115800,33626K,5120,2,165,3.33,70.8,306528,217028,-89500,3157,3749,592,548264,5130,5130,5120,1408,2,0,13039,17231,1408,0
115900,33626K,5120,2,165,3.33,70.68,307051,217028,-90023,3159,3749,590,548787,5120,5120,5120,0,0,0,13039,15759,0,0
115900,33626K,5120,2,165,3.33,70.6,307395,217028,-90367,3160,3749,589,549131,5120,5120,5120,344,1,0,13039,16099,344,0
120000,33626K,5120,2,165,3.33,70.64,307396,217158,-90238,3161,3764,603,549262,5110,5120,5110,111,1,11,13336,15847,1,110
120000,33626K,5140,2,185,3.73,70.82,307396,217694,-89702,3161,3767,606,549798,5110,5140,5110,647,1,14,13039,16055,1,646
120100,33626K,5140,2,185,3.73,70.82,307396,217694,-89702,3161,3767,606,549798,5140,5140,5140,0,0,0,13039,16055,0,0
120100,33626K,5140,2,185,3.73,70.82,307396,217694,-89702,3161,3767,606,549798,5140,5140,5140,0,0,0,13039,16055,0,0
120200,33626K,5140,2,185,3.73,70.82,307396,217694,-89702,3161,3767,606,549798,5140,5140,5140,0,0,0,13015,16105,0,0
120200,33626K,5140,2,185,3.73,70.82,307396,217694,-89702,3161,3767,606,549798,5140,5140,5140,0,0,0,13015,16121,0,0
120300,33626K,5140,2,185,3.73,70.82,307396,217694,-89702,3161,3767,606,549798,5140,5140,5140,0,0,0,13151,16592,0,0
120300,33626K,5140,2,185,3.73,70.82,307396,217694,-89702,3161,3767,606,549798,5140,5140,5140,0,0,0,13151,16582,0,0
120400,33626K,5130,2,175,3.53,70.77,307597,217694,-89903,3164,3767,603,549999,5130,5130,5130,201,3,0,14030,16317,201,0
120400,33626K,5130,2,175,3.53,70.77,307600,217694,-89906,3165,3767,602,550002,5130,5130,5130,204,4,0,14041,16217,204,0
120500,33626K,5130,2,175,3.53,70.72,307810,217694,-90116,3167,3767,600,550212,5130,5130,5130,210,2,0,13946,16280,210,0
120500,33626K,5130,2,175,3.53,70.75,308140,218004,-90136,3168,3769,601,550852,5130,5130,5130,850,3,2,13690,16351,540,310
120600,33626K,5130,2,175,3.53,70.9,308194,218501,-89693,3169,3771,602,551403,5130,5130,5130,451,1,1,13721,16011,54,397
120600,33626K,5140,2,185,3.73,70.96,308194,218685,-89509,3169,3773,604,551587,5130,5140,5130,635,1,3,13741,15918,54,581
120700,33626K,5140,2,185,3.73,70.96,308194,218685,-89509,3169,3773,604,551587,5140,5140,5140,0,0,0,13741,15918,0,0
120800,33626K,5140,2,185,3.73,70.96,308194,218685,-89509,3169,3773,604,551587,5140,5140,5140,0,0,0,13779,15998,0,0
120800,33626K,5140,2,185,3.73,70.96,308194,218685,-89509,3169,3773,604,551587,5140,5140,5140,0,0,0,14222,15968,0,0
120900,33626K,5130,2,175,3.53,70.87,308564,218685,-89879,3170,3773,603,551957,5130,5130,5130,0,0,0,14395,15968,0,0
120900,33626K,5110,2,155,3.13,70.79,309164,218861,-90303,3173,3775,602,552733,5130,5140,5110,776,3,2,13823,15705,600,176
121000,33626K,5140,2,185,3.73,70.81,309164,218906,-90258,3173,3776,603,552778,5140,5140,5140,0,0,0,13824,15526,0,0
121000,33626K,5130,2,175,3.53,70.81,309164,218907,-90257,3173,3777,604,552779,5130,5130,5130,1,0,1,15848,17630,0,1
121100,33626K,5130,2,175,3.53,70.81,309164,218907,-90257,3173,3777,604,552779,5130,5130,5130,0,0,0,15848,17630,0,0
121100,33626K,5130,2,175,3.53,70.94,309164,219306,-89858,3173,3778,605,553178,5130,5130,5130,399,0,1,15371,19242,0,399
121200,33626K,5130,2,175,3.53,70.94,309164,219306,-89858,3173,3778,605,553178,5130,5130,5130,0,0,0,15371,19242,0,0
121200,33626K,5130,2,175,3.53,70.93,309172,219307,-89865,3174,3779,605,553187,5120,5130,5120,9,1,1,14997,19248,8,1
121300,33626K,5120,2,165,3.33,70.84,309559,219307,-90252,3176,3779,603,553574,5120,5120,5120,287,1,0,14896,19988,287,0
121300,33626K,5120,2,165,3.33,70.83,309611,219307,-90304,3178,3779,601,553626,5120,5120,5120,339,3,0,14896,19699,339,0
121400,33626K,5120,2,165,3.33,70.81,309711,219307,-90404,3179,3779,600,553726,5120,5120,5120,100,1,0,14896,19751,100,0
121400,33626K,5120,2,165,3.33,70.7,310320,219397,-90923,3181,3781,600,554425,5120,5120,5110,799,3,2,15126,18627,709,90
121500,33626K,5120,2,165,3.33,70.63,310681,219445,-91236,3182,3784,602,554834,5120,5120,5120,47,0,2,14962,18287,0,47
121500,33626K,5120,2,165,3.33,70.67,310681,219545,-91136,3182,3785,603,554934,5120,5120,5120,147,0,3,14961,18287,0,147
121600,33626K,5120,2,165,3.33,70.5,311573,219654,-91919,3183,3787,604,555935,5120,5120,5120,1001,1,2,15164,19124,892,109
121600,33626K,5120,2,165,3.33,70.5,311573,219659,-91914,3183,3788,605,555940,5120,5120,5120,1006,1,3,16200,18317,892,114
121700,33626K,5120,2,165,3.33,70.88,311573,220834,-90739,3183,3790,607,557115,5120,5120,5120,1175,0,2,15195,18537,0,1175
121700,33626K,5130,2,175,3.53,70.88,311573,220835,-90738,3183,3791,608,557116,5120,5130,5120,1176,0,3,15164,18237,0,1176
121800,33626K,5130,2,175,3.53,70.88,311573,220835,-90738,3183,3791,608,557116,5130,5130,5130,0,0,0,15164,18237,0,0
121800,33626K,5120,2,165,3.33,70.88,311587,220846,-90741,3184,3792,608,557141,5120,5120,5120,25,1,1,10645,18149,14,11
121900,33626K,5120,2,165,3.33,70.88,311587,220846,-90741,3184,3792,608,557141,5120,5120,5120,0,0,0,10645,18149,0,0
121900,33626K,5120,2,165,3.33,70.88,311976,221134,-90842,3185,3793,608,557818,5120,5120,5120,677,1,1,10722,19245,389,288
122000,33626K,5120,2,165,3.33,70.81,312276,221134,-91142,3186,3793,607,558118,5120,5120,5120,300,1,0,9918,19952,300,0
122000,33626K,5120,2,165,3.33,70.81,312299,221134,-91165,3187,3793,606,558141,5120,5120,5120,323,2,0,9918,19902,323,0
122100,33626K,5120,2,165,3.33,70.58,313299,221134,-92165,3188,3793,605,559141,5120,5120,5120,1000,1,0,9918,20038,1000,0
122100,33626K,5120,2,165,3.33,70.58,313299,221134,-92165,3188,3793,605,559141,5120,5120,5120,1000,1,0,9918,20038,1000,0
122200,33626K,5120,2,165,3.33,70.58,313303,221134,-92169,3189,3793,604,559145,5120,5120,5120,4,1,0,9918,19038,4,0
122200,33626K,5120,2,165,3.33,70.58,313312,221134,-92178,3190,3793,603,559154,5120,5120,5120,13,2,0,9917,19034,13,0
122300,33626K,5120,2,165,3.33,70.58,313312,221134,-92178,3190,3793,603,559154,5120,5120,5120,0,0,0,9917,19034,0,0
122400,33626K,5120,2,165,3.33,70.58,313312,221134,-92178,3190,3793,603,559154,5120,5120,5120,0,0,0,9917,18974,0,0
122400,33626K,5120,2,165,3.33,70.58,313312,221134,-92178,3190,3793,603,559154,5120,5120,5120,0,0,0,9917,18984,0,0
122500,33626K,5130,2,175,3.53,70.58,313312,221135,-92177,3190,3794,604,559155,5130,5130,5130,0,0,0,10131,18985,0,0
122500,33626K,5120,2,165,3.33,70.57,313368,221135,-92233,3191,3794,603,559211,5120,5120,5120,56,1,0,10331,19391,56,0
122600,33626K,5120,2,165,3.33,70.57,313368,221135,-92233,3191,3794,603,559211,5120,5120,5120,0,0,0,10331,19391,0,0
122600,33626K,5120,2,165,3.33,70.73,313368,221635,-91733,3191,3795,604,559711,5120,5120,5120,500,0,1,10902,19640,0,500
122700,33626K,5120,2,165,3.33,70.73,313368,221635,-91733,3191,3795,604,559711,5120,5120,5120,0,0,0,10902,19640,0,0
122700,33626K,5120,2,165,3.33,70.73,313368,221635,-91733,3191,3795,604,559711,5120,5120,5120,0,0,0,10402,19641,0,0
122800,33626K,5120,2,165,3.33,70.8,313368,221850,-91518,3191,3796,605,559926,5120,5120,5120,215,0,1,10402,19733,0,215
122800,33626K,5110,2,155,3.13,70.71,313768,221850,-91918,3193,3796,603,560326,5120,5120,5110,615,2,1,10202,19733,400,215
122900,33626K,5110,2,155,3.13,70.17,316172,221865,-94307,3196,3797,601,562745,5110,5110,5110,0,0,0,13870,18548,0,0
122900,33626K,5100,2,145,2.93,69.94,317244,221865,-95379,3201,3797,596,563817,5100,5100,5100,1072,5,0,14370,17432,1072,0
123000,33626K,5100,2,145,2.93,69.54,319031,221865,-97166,3204,3797,593,565604,5100,5100,5100,600,1,0,11124,16252,600,0
123000,33626K,5100,2,145,2.93,69.15,320831,221865,-98966,3206,3797,591,567404,5100,5100,5100,2400,3,0,11124,14352,2400,0
123100,33626K,5100,2,145,2.93,69.15,320831,221865,-98966,3206,3797,591,567404,5100,5100,5100,0,0,0,11124,14352,0,0
123100,33626K,5100,2,145,2.93,69.15,320831,221865,-98966,3206,3797,591,567404,5100,5100,5100,0,0,0,11125,13852,0,0
123200,33626K,5120,2,165,3.33,69.15,320831,221869,-98962,3206,3801,595,567408,5120,5120,5120,4,0,4,11422,14815,0,4
123200,33626K,5110,2,155,3.13,69.15,320934,221931,-99003,3207,3802,595,567573,5120,5120,5110,169,1,5,11697,14917,103,66
123300,33626K,5110,2,155,3.13,69.15,320934,221931,-99003,3207,3802,595,567573,5110,5110,5110,0,0,0,11697,14917,0,0
123300,33626K,5120,2,165,3.33,69.16,320934,221951,-98983,3207,3803,596,567593,5120,5120,5120,20,0,1,11594,15211,0,20
123400,33626K,5110,2,155,3.13,68.84,322434,221951,-100483,3208,3803,595,569093,5110,5110,5110,1500,1,0,11863,16211,1500,0
123400,33626K,5110,2,155,3.13,68.58,323634,221951,-101683,3209,3803,594,570293,5110,5110,5110,2700,2,0,11863,16772,2700,0
123500,33626K,5110,2,155,3.13,68.53,323869,221951,-101918,3210,3803,593,570528,5110,5110,5110,235,1,0,11863,16072,235,0
123600,33626K,5110,2,155,3.13,68.49,324069,221951,-102118,3211,3803,592,570728,5110,5110,5110,0,0,0,11690,16124,0,0
123600,33626K,5110,2,155,3.13,68.46,324211,221951,-102260,3213,3803,590,570870,5110,5110,5110,142,2,0,11690,15842,142,0
123700,33626K,5110,2,155,3.13,68.38,324564,221951,-102613,3215,3803,588,571223,5110,5110,5110,353,2,0,11690,14289,353,0
123700,33626K,5110,2,155,3.13,68.36,324704,221961,-102743,3216,3804,588,571373,5110,5110,5110,503,3,1,11901,14696,493,10
123800,33626K,5120,2,165,3.33,68.37,324704,222011,-102693,3216,3805,589,571423,5120,5120,5120,50,0,1,11901,14569,0,50
123800,33626K,5120,2,165,3.33,68.39,324704,222051,-102653,3216,3807,591,571463,5120,5120,5120,90,0,3,11841,14552,0,90
123900,33626K,5120,2,165,3.33,68.39,324704,222051,-102653,3216,3807,591,571463,5120,5120,5120,0,0,0,11841,14552,0,0
123900,33626K,5120,2,165,3.33,68.39,324704,222051,-102653,3216,3807,591,571463,5120,5120,5120,0,0,0,11841,14552,0,0
124000,33626K,5110,2,155,3.13,68.21,325530,222051,-103479,3217,3807,590,572289,5110,5110,5110,826,1,0,12313,14826,826,0
124000,33626K,5100,2,145,2.93,68.15,325837,222051,-103786,3218,3807,589,572596,5110,5110,5100,1133,2,0,12313,15252,1133,0
124100,33626K,5100,2,145,2.93,68.15,325837,222051,-103786,3218,3807,589,572596,5100,5100,5100,0,0,0,12313,15252,0,0
124200,33626K,5110,2,155,3.13,68.15,325838,222051,-103787,3219,3807,588,572597,5110,5110,5110,0,0,0,12667,14531,0,0
124200,33626K,5110,2,155,3.13,68.15,325838,222051,-103787,3219,3807,588,572597,5110,5110,5110,0,0,0,12667,14531,0,0
124300,33626K,5110,2,155,3.13,68.16,325848,222100,-103748,3220,3809,589,572656,5110,5110,5110,20,0,1,10687,14091,0,20
124300,33626K,5110,2,155,3.13,68.18,325848,222160,-103688,3220,3812,592,572716,5110,5110,5110,80,0,4,10727,14191,0,80
124400,33626K,5110,2,155,3.13,68.19,325848,222195,-103653,3220,3816,596,572751,5110,5110,5110,0,0,0,10686,14191,0,0
124400,33626K,5110,2,155,3.13,68.2,325848,222214,-103634,3220,3817,597,572770,5110,5110,5110,19,0,1,11116,14177,0,19
124500,33626K,5110,2,155,3.13,68.2,325848,222224,-103624,3220,3818,598,572780,5110,5110,5110,0,0,0,11291,14197,0,0
124500,33626K,5110,2,155,3.13,68.34,325848,222694,-103154,3220,3819,599,573250,5110,5110,5110,470,0,1,11285,13360,0,470
124600,33626K,5110,2,155,3.13,68.34,325848,222694,-103154,3220,3819,599,573250,5110,5110,5110,0,0,0,11285,13360,0,0
124600,33626K,5110,2,155,3.13,68.36,325848,222742,-103106,3220,3820,600,573298,5110,5110,5110,48,0,1,10815,14360,0,48
124700,33626K,5110,2,155,3.13,68.36,325848,222742,-103106,3220,3820,600,573298,5110,5110,5110,0,0,0,10815,14360,0,0
124700,33626K,5120,2,165,3.33,68.36,325848,222743,-103105,3220,3821,601,573299,5120,5120,5120,1,0,1,11184,14009,0,1
124800,33626K,5120,2,165,3.33,68.36,325848,222743,-103105,3220,3821,601,573299,5120,5120,5120,0,0,0,11184,14009,0,0
124800,33626K,5120,2,165,3.33,68.42,325848,222929,-102919,3220,3822,602,573485,5120,5120,5120,186,0,1,11942,13820,0,186
124900,33626K,5110,2,155,3.13,68.41,325877,222930,-102947,3221,3823,602,573515,5120,5120,5110,30,1,1,12415,14820,29,1
124900,33626K,5120,2,165,3.33,68.42,325877,222950,-102927,3221,3825,604,573535,5120,5120,5110,50,1,3,12376,14891,29,21
125000,33626K,5120,2,165,3.33,68.42,325877,222950,-102927,3221,3825,604,573535,5120,5120,5120,0,0,0,12376,14891,0,0
125000,33626K,5120,2,165,3.33,68.42,325877,222960,-102917,3221,3826,605,573545,5120,5120,5120,10,0,1,12479,14891,0,10
125100,33626K,5110,2,155,3.13,68.42,325882,222960,-102922,3223,3826,603,573550,5110,5110,5110,5,2,0,12469,14887,5,0
125100,33626K,5110,2,155,3.13,68.39,325996,222960,-103036,3225,3826,601,573664,5110,5110,5110,119,4,0,12356,15587,119,0
125200,33626K,5110,2,155,3.13,68.39,325996,222960,-103036,3225,3826,601,573664,5110,5110,5110,0,0,0,12356,15587,0,0
125200,33626K,5110,2,155,3.13,68.39,325996,222960,-103036,3225,3826,601,573664,5110,5110,5110,0,0,0,12356,15587,0,0
125300,33626K,5110,2,155,3.13,68.35,326199,222960,-103239,3226,3826,600,573867,5110,5110,5110,203,1,0,12394,15637,203,0
125300,33626K,5110,2,155,3.13,68.25,326659,222960,-103699,3227,3826,599,574327,5110,5110,5110,663,2,0,12394,15334,663,0
125400,33626K,5110,2,155,3.13,68.14,327481,223159,-104322,3229,3831,602,575348,5110,5110,5110,1021,2,5,12091,14611,822,199
125500,33626K,5110,2,155,3.13,68.14,327481,223159,-104322,3229,3831,602,575348,5110,5110,5110,0,0,0,12091,14611,0,0
125500,33626K,5110,2,155,3.13,68.14,327493,223159,-104334,3230,3831,601,575360,5110,5110,5110,12,1,0,12394,14214,12,0
125600,33626K,5110,2,155,3.13,67.65,330305,223459,-106846,3234,3832,598,578472,5110,5110,5110,0,0,0,13975,10988,0,0
125600,33626K,5100,2,145,2.93,67.18,333359,223949,-109410,3237,3833,596,582016,5100,5100,5100,3544,3,1,13675,8153,3054,490
125700,33626K,5100,2,145,2.93,66.95,334511,223949,-110562,3240,3833,593,583168,5100,5100,5100,764,2,0,13675,9007,764,0
125700,33626K,5100,2,145,2.93,67.2,334512,224785,-109727,3241,3835,594,584005,5100,5100,5090,1601,3,2,12650,14114,765,836
125800,33626K,5100,2,145,2.93,67.29,334512,225098,-109414,3241,3839,598,584318,5100,5100,5100,60,0,3,12080,14380,0,60
125800,33626K,5090,2,135,2.72,67.33,334562,225255,-109307,3243,3841,598,584525,5100,5100,5090,267,2,5,13675,10785,50,217
125900,33626K,5090,2,135,2.72,67.33,334562,225255,-109307,3243,3841,598,584525,5090,5090,5090,0,0,0,13675,10785,0,0
125900,33626K,5090,2,135,2.72,67.32,334623,225255,-109368,3245,3841,596,584586,5090,5090,5090,61,2,0,13675,15335,61,0
130000,33626K,5090,2,135,2.72,67.25,334943,225255,-109688,3246,3841,595,584906,5090,5090,5090,0,0,0,13675,15334,0,0
130000,33626K,5100,2,145,2.93,67.26,334943,225275,-109668,3246,3842,596,584926,5100,5100,5100,20,0,1,13850,15013,0,20
130100,33626K,5100,2,145,2.93,67.26,334943,225281,-109662,3246,3843,597,584932,5100,5100,5100,0,0,0,12139,15033,0,0
130100,33626K,5090,2,135,2.72,67.23,335093,225281,-109812,3248,3843,595,585082,5090,5090,5090,150,2,0,12153,17283,150,0
130200,33626K,5090,2,135,2.72,67.11,335710,225281,-110429,3249,3843,594,585699,5090,5090,5090,617,1,0,12133,17736,617,0
130200,33626K,5080,2,125,2.52,67.01,336193,225281,-110912,3251,3843,592,586182,5090,5090,5080,1100,3,0,12133,18436,1100,0
130300,33626K,5080,2,125,2.52,66.96,336423,225281,-111142,3253,3843,590,586412,5080,5080,5080,130,1,0,10372,18397,130,0
130300,33626K,5070,2,115,2.32,66.75,337487,225281,-112206,3256,3843,587,587476,5080,5080,5070,1194,4,0,8860,17822,1194,0
130400,33626K,5070,2,115,2.32,66.64,338487,225581,-112906,3257,3845,588,588776,5080,5080,5070,1200,1,1,10578,18034,1000,200
130400,33626K,5080,2,125,2.52,66.64,338487,225582,-112905,3257,3846,589,588777,5080,5080,5070,1201,1,2,10578,17512,1000,201
130500,33626K,5070,2,115,2.32,66.46,339418,225582,-113836,3260,3846,586,589708,5070,5070,5070,931,3,0,11580,16502,931,0
130500,33626K,5050,2,95,1.92,65.95,342157,225653,-116504,3263,3847,584,592518,5070,5070,5050,3741,6,1,8902,15149,3670,71
130600,33626K,5050,2,95,1.92,65.39,345117,225678,-119439,3269,3848,579,595503,5050,5050,5030,2985,6,1,7298,10207,2960,25
130600,33626K,5070,2,115,2.32,65.39,345117,225679,-119438,3269,3849,580,595504,5050,5070,5030,2986,6,2,10698,10592,2960,26
130700,33626K,5050,2,95,1.92,65.6,345174,226444,-118730,3271,3858,587,596326,5060,5060,5050,822,2,9,8156,12539,57,765
130800,33626K,5070,2,115,2.32,65.49,345753,226448,-119305,3273,3862,589,596909,5070,5070,5070,0,0,0,10021,14172,0,0
130800,33626K,5070,2,115,2.32,65.45,346003,226449,-119554,3274,3863,589,597160,5050,5070,5050,251,1,1,10525,13932,250,1
130900,33626K,5060,2,105,2.12,65.35,346504,226451,-120053,3276,3865,589,597663,5060,5060,5060,1,1,0,9537,13683,1,0
130900,33626K,5070,2,115,2.32,65.36,346504,226461,-120043,3276,3867,591,597673,5060,5070,5060,11,1,2,9537,14173,1,10
131000,33626K,5070,2,115,2.32,65.37,346504,226521,-119983,3276,3868,592,597733,5070,5070,5070,0,0,0,7914,14837,0,0
131000,33626K,5070,2,115,2.32,65.38,346504,226531,-119973,3276,3869,593,597743,5070,5070,5070,10,0,1,7854,14598,0,10
131100,33626K,5070,2,115,2.32,65.38,346504,226531,-119973,3276,3869,593,597743,5070,5070,5070,0,0,0,7854,14598,0,0
131100,33626K,5070,2,115,2.32,65.38,346504,226531,-119973,3276,3869,593,597743,5070,5070,5070,0,0,0,7844,15160,0,0
131200,33626K,5070,2,115,2.32,65.72,346504,227732,-118772,3276,3873,597,598944,5070,5070,5070,100,0,1,6858,15895,0,100
131200,33626K,5070,2,115,2.32,65.73,346505,227768,-118737,3277,3878,601,598981,5070,5070,5060,137,1,6,6788,15678,1,136
131300,33626K,5070,2,115,2.32,65.74,346505,227808,-118697,3277,3880,603,599021,5070,5070,5070,10,0,1,6757,15678,0,10
131300,33626K,5060,2,105,2.12,65.64,347380,228009,-119371,3280,3882,602,600097,5070,5070,5060,1086,3,3,6431,14929,875,211
131400,33626K,5070,2,115,2.32,65.62,347480,228011,-119469,3281,3884,603,600199,5060,5070,5060,101,1,1,6449,14882,100,1
131400,33626K,5070,2,115,2.32,65.62,347490,228025,-119465,3282,3889,607,600223,5060,5070,5060,125,2,6,6678,14972,110,15
131500,33626K,5050,2,95,1.92,65.55,347876,228037,-119839,3285,3892,607,600621,5060,5060,5050,386,3,0,6665,14923,386,0
131500,33626K,5060,2,105,2.12,65.59,347876,228166,-119710,3285,3898,613,600750,5060,5060,5050,515,3,6,6163,14800,386,129
131600,33626K,5060,2,105,2.12,65.6,347876,228195,-119681,3285,3901,616,600779,5060,5060,5060,24,0,2,6176,14800,0,24
131600,33626K,5060,2,105,2.12,65.58,348043,228255,-119788,3287,3902,615,601006,5060,5060,5060,251,2,3,6751,15400,167,84
131700,33626K,5060,2,105,2.12,65.61,348043,228358,-119685,3287,3906,619,601109,5060,5060,5060,2,0,2,6589,13249,0,2
131700,33626K,5050,2,95,1.92,65.65,348048,228479,-119569,3288,3909,621,601235,5060,5060,5050,128,1,5,8617,13350,5,123
131800,33626K,5060,2,105,2.12,65.6,348291,228490,-119801,3289,3911,622,601489,5060,5060,5050,254,1,2,8364,13507,243,11
131800,33626K,5050,2,95,1.92,65.6,348292,228491,-119801,3290,3912,622,601491,5060,5060,5050,256,2,3,8363,13507,244,12
131900,33626K,5050,2,95,1.92,65.58,348392,228491,-119901,3291,3912,621,601591,5050,5050,5050,100,1,0,8463,14508,100,0
132000,33626K,5050,2,95,1.92,65.58,348392,228491,-119901,3291,3912,621,601591,5050,5050,5050,0,0,0,8463,14508,0,0
132000,33626K,5060,2,105,2.12,65.53,348696,228493,-120203,3294,3914,620,601897,5050,5060,5050,306,3,2,9462,13106,304,2
132100,33626K,5060,2,105,2.12,65.53,348696,228498,-120198,3294,3919,625,601902,5060,5060,5060,1,0,1,9447,14121,0,1
132100,33626K,5060,2,105,2.12,65.53,348696,228507,-120189,3294,3923,629,601911,5060,5060,5060,10,0,5,9438,14130,0,10
132200,33626K,5060,2,105,2.12,65.52,348767,228508,-120259,3295,3924,629,601983,5060,5060,5060,0,0,0,9237,14059,0,0
132200,33626K,5060,2,105,2.12,65.52,348767,228514,-120253,3295,3926,631,601989,5060,5060,5060,6,0,2,9235,14059,0,6
132300,33626K,5060,2,105,2.12,65.52,348767,228515,-120252,3295,3927,632,601990,5060,5060,5060,0,0,0,9982,14059,0,0
132300,33626K,5060,2,105,2.12,65.52,348767,228523,-120244,3295,3928,633,601998,5060,5060,5060,8,0,1,9981,14059,0,8
132400,33626K,5060,2,105,2.12,65.59,348767,228743,-120024,3295,3929,634,602218,5060,5060,5060,220,0,1,9973,14071,0,220
132400,33626K,5060,2,105,2.12,65.62,348767,228854,-119913,3295,3932,637,602329,5060,5060,5060,331,0,4,9441,14071,0,331
132500,33626K,5060,2,105,2.12,65.62,348767,228854,-119913,3295,3932,637,602329,5060,5060,5060,0,0,0,9441,14071,0,0
132600,33626K,5060,2,105,2.12,65.73,348812,229264,-119548,3296,3933,637,602784,5060,5060,5060,0,0,0,9668,13924,0,0
132600,33626K,5060,2,105,2.12,65.72,348937,229320,-119617,3298,3935,637,602965,5060,5070,5060,181,2,2,9677,14256,125,56
132700,33626K,5070,2,115,2.32,65.72,348941,229322,-119619,3299,3937,638,602971,5070,5070,5070,1,0,1,10179,15139,0,1
132700,33626K,5070,2,115,2.32,65.72,348944,229323,-119621,3300,3938,638,602975,5070,5070,5060,5,1,2,10578,15126,3,2
132800,33626K,5070,2,115,2.32,65.72,348944,229323,-119621,3300,3938,638,602975,5070,5070,5070,0,0,0,10578,15126,0,0
132800,33626K,5070,2,115,2.32,65.72,348944,229324,-119620,3300,3939,639,602976,5070,5070,5070,1,0,1,10577,15409,0,1
132900,33626K,5060,2,105,2.12,65.54,349902,229324,-120578,3301,3939,638,603934,5060,5060,5060,958,1,0,10576,15409,958,0
132900,33626K,5070,2,115,2.32,65.19,351944,229424,-122520,3302,3940,638,606076,5060,5070,5050,3100,2,1,10576,11896,3000,100
133000,33626K,5070,2,115,2.32,65.19,351944,229424,-122520,3302,3940,638,606076,5070,5070,5070,0,0,0,10576,11896,0,0
133000,33626K,5070,2,115,2.32,65.19,351944,229424,-122520,3302,3940,638,606076,5070,5070,5070,0,0,0,10576,11896,0,0
133100,33626K,5060,2,105,2.12,65.19,351955,229424,-122531,3303,3940,637,606087,5060,5060,5060,11,1,0,10701,12123,11,0
133100,33626K,5040,2,85,1.72,65.11,352343,229424,-122919,3306,3940,634,606475,5060,5060,5040,399,4,0,9484,18361,399,0
133200,33626K,5040,2,85,1.72,64.96,353171,229424,-123747,3308,3940,632,607303,5040,5040,5040,828,2,0,9919,18033,828,0
133200,33626K,5040,2,85,1.72,64.96,353171,229424,-123747,3308,3940,632,607303,5040,5040,5040,828,2,0,9919,18033,828,0
133300,33626K,5040,2,85,1.72,64.93,353399,229475,-123924,3309,3942,633,607582,5040,5040,5040,279,1,2,9098,17305,228,51
133300,33626K,5040,2,85,1.72,64.99,353429,229679,-123750,3310,3952,642,607816,5040,5040,5040,513,2,12,10029,17068,258,255
133400,33626K,5040,2,85,1.72,64.98,353449,229679,-123770,3311,3952,641,607836,5040,5040,5040,20,1,0,9769,17144,20,0
133400,33626K,5040,2,85,1.72,64.98,353449,229679,-123770,3311,3952,641,607836,5040,5040,5040,20,1,0,9769,17144,20,0
133500,33626K,5050,2,95,1.92,64.98,353451,229679,-123772,3312,3952,640,607838,5050,5050,5050,2,1,0,9769,21316,2,0
133500,33626K,5050,2,95,1.92,64.98,353457,229679,-123778,3315,3952,637,607844,5050,5050,5050,8,4,0,11928,21321,8,0
133600,33626K,5050,2,95,1.92,64.98,353472,229680,-123792,3316,3953,637,607860,5050,5050,5050,16,1,1,11347,22589,15,1
133700,33626K,5040,2,85,1.72,64.97,353501,229680,-123821,3317,3953,636,607889,5040,5040,5040,0,0,0,11346,22589,0,0
133700,33626K,5040,2,85,1.72,64.86,354124,229680,-124444,3320,3953,633,608512,5040,5040,5040,623,3,0,11317,21939,623,0
133800,33626K,5060,2,105,2.12,64.86,354124,229681,-124443,3320,3954,634,608513,5060,5060,5060,0,0,0,11769,21867,0,0
133800,33626K,5060,2,105,2.12,64.86,354124,229690,-124434,3320,3956,636,608522,5060,5060,5060,9,0,2,12417,20865,0,9
133900,33626K,5060,2,105,2.12,64.86,354124,229690,-124434,3320,3956,636,608522,5060,5060,5060,0,0,0,12417,20865,0,0
133900,33626K,5060,2,105,2.12,65.09,354124,230500,-123624,3320,3958,638,609332,5060,5060,5060,810,0,2,12416,20652,0,810
134000,33626K,5060,2,105,2.12,65.09,354124,230500,-123624,3320,3958,638,609332,5060,5060,5060,0,0,0,12416,20652,0,0
134000,33626K,5050,2,95,1.92,65.09,354135,230500,-123635,3321,3958,637,609343,5050,5050,5050,11,1,0,11386,20662,11,0
134100,33626K,5050,2,95,1.92,65.16,354135,230749,-123386,3321,3959,638,609592,5050,5050,5050,0,0,0,10450,20867,0,0
134100,33626K,5060,2,105,2.12,65.14,354235,230758,-123477,3322,3968,646,609701,5050,5060,5050,109,1,9,11492,20762,100,9
134200,33626K,5040,2,85,1.72,65.05,354761,230759,-124002,3324,3969,645,610228,5050,5050,5040,526,2,0,11490,20792,526,0
134200,33626K,5060,2,105,2.12,65.05,354761,230760,-124001,3324,3970,646,610229,5050,5060,5040,527,2,1,11490,20346,526,1
134300,33626K,5050,2,95,1.92,65.04,354781,230760,-124021,3325,3970,645,610249,5050,5050,5050,20,1,0,12146,20496,20,0
134300,33626K,5060,2,105,2.12,65.02,354931,230765,-124166,3327,3971,644,610404,5050,5060,5040,175,3,1,12186,20934,170,5
134400,33626K,5040,2,85,1.72,65.01,354958,230765,-124193,3328,3971,643,610431,5040,5040,5040,0,0,0,12212,21569,0,0
134400,33626K,5040,2,85,1.72,65.01,354958,230765,-124193,3328,3971,643,610431,5040,5040,5040,0,0,0,12212,21569,0,0
134500,33626K,5050,2,95,1.92,65.01,354958,230770,-124188,3328,3976,648,610436,5050,5050,5050,5,0,5,9974,19509,0,5
134500,33626K,5040,2,85,1.72,64.95,355295,230770,-124525,3330,3976,646,610773,5050,5050,5040,342,2,5,10283,19508,337,5
134600,33626K,5040,2,85,1.72,64.53,357599,230771,-126828,3338,3977,639,613078,5040,5040,5040,2233,7,0,9591,23194,2233,0
134600,33626K,5030,2,75,1.51,64.51,358000,230950,-127050,3339,3978,639,613658,5040,5040,5030,2813,8,1,7860,24025,2634,179
134700,33626K,5030,2,75,1.51,64.22,359608,230951,-128657,3341,3979,638,615267,5030,5030,5030,1559,1,0,9290,23918,1559,0
134700,33626K,5020,2,65,1.31,64.43,359609,231692,-127917,3342,3987,645,616009,5030,5030,5020,2301,2,8,8035,22127,1560,741
134800,33626K,5030,2,75,1.51,64.44,359609,231748,-127861,3342,3988,646,616065,5030,5030,5030,56,0,1,8035,22226,0,56
134800,33626K,5030,2,75,1.51,64.62,359609,232392,-127217,3342,3990,648,616709,5030,5030,5030,700,0,3,7579,22246,0,700
134900,33626K,5030,2,75,1.51,64.62,359609,232392,-127217,3342,3990,648,616709,5030,5030,5030,0,0,0,7579,22246,0,0
134900,33626K,5030,2,75,1.51,64.47,360474,232392,-128082,3343,3990,647,617574,5030,5030,5030,865,1,0,9039,23715,865,0
135000,33626K,5030,2,75,1.51,64.62,360515,232982,-127533,3344,3991,647,618205,5030,5030,5030,631,1,1,9039,22892,41,590
135100,33626K,5040,2,85,1.72,64.67,360515,233142,-127373,3344,3995,651,618365,5040,5040,5040,0,0,0,9039,23043,0,0
135100,33626K,5030,2,75,1.51,64.63,360757,233142,-127615,3346,3995,649,618607,5030,5030,5030,242,2,0,9038,23017,242,0
135200,33626K,5020,2,65,1.31,64.58,361024,233145,-127879,3347,3996,649,618877,5020,5020,5020,0,0,0,7368,22996,0,0
135200,33626K,5020,2,65,1.31,64.57,361050,233145,-127905,3349,3996,647,618903,5020,5020,5020,26,2,0,7368,22723,26,0
135300,33626K,5030,2,75,1.51,64.41,362050,233179,-128871,3351,3997,646,619937,5030,5030,5030,944,1,0,9038,23615,944,0
135300,33626K,5030,2,75,1.51,64.49,362050,233481,-128569,3351,3999,648,620239,5030,5030,5030,1246,1,2,8250,22713,944,302
135400,33626K,5030,2,75,1.51,64.49,362050,233488,-128562,3351,4002,651,620246,5030,5030,5030,7,0,3,8036,22813,0,7
135400,33626K,5030,2,75,1.51,64.49,362050,233500,-128550,3351,4005,654,620258,5030,5030,5030,19,0,6,7730,17890,0,19
135500,33626K,5020,2,65,1.31,64.36,362787,233500,-129287,3353,4005,652,620995,5020,5020,5020,0,0,0,7649,17811,0,0
135500,33626K,5030,2,75,1.51,64.59,362787,234315,-128472,3353,4007,654,621810,5030,5030,5030,815,0,2,4878,17157,0,815
135600,33626K,5030,2,75,1.51,64.59,362787,234325,-128462,3353,4008,655,621820,5030,5030,5030,10,0,1,7177,17157,0,10
135600,33626K,5030,2,75,1.51,64.59,362787,234326,-128461,3353,4009,656,621821,5030,5030,5030,11,0,2,7167,17457,0,11
135700,33626K,5020,2,65,1.31,64.56,362987,234328,-128659,3355,4011,656,622023,5030,5030,5020,201,2,1,7064,17357,200,1
135700,33626K,5020,2,65,1.31,64.55,363007,234328,-128679,3356,4011,655,622043,5030,5030,5020,221,3,1,6964,17209,220,1
135800,33626K,5020,2,65,1.31,64.55,363017,234338,-128679,3358,4012,654,622063,5020,5020,5020,0,0,0,6954,17204,0,0
135800,33626K,5020,2,65,1.31,64.51,364017,234838,-129179,3360,4013,653,623563,5030,5030,5020,1500,2,1,6164,16904,1000,500
135900,33626K,5020,2,65,1.31,64.4,365061,235088,-129973,3361,4015,654,624857,5030,5030,5020,1294,1,2,5914,16204,1044,250
135900,33626K,5020,2,65,1.31,64.4,365070,235088,-129982,3362,4015,653,624866,5030,5030,5020,1303,2,2,5914,15310,1053,250
140000,33626K,5020,2,65,1.31,64.33,365445,235088,-130357,3363,4015,652,625241,5020,5020,5020,0,0,0,5914,15301,0,0
140000,33626K,5020,2,65,1.31,64.3,365628,235088,-130540,3365,4015,650,625424,5020,5020,5020,183,2,0,5619,14877,183,0
140100,33626K,5020,2,65,1.31,64.15,366493,235100,-131393,3366,4018,652,626301,5030,5030,5020,876,1,2,8495,14785,865,11
140100,33626K,5020,2,65,1.31,64.11,366693,235100,-131593,3367,4018,651,626501,5030,5030,5020,1076,2,2,5807,14120,1065,11
140200,33626K,5020,2,65,1.31,64.11,366724,235100,-131624,3369,4018,649,626532,5020,5020,5020,31,2,0,5607,13914,31,0
140200,33626K,5020,2,65,1.31,64.11,366724,235100,-131624,3369,4018,649,626532,5020,5020,5020,31,2,0,5607,13914,31,0
140300,33626K,5020,2,65,1.31,64.11,366724,235100,-131624,3369,4018,649,626532,5020,5020,5020,0,0,0,5607,13914,0,0
140300,33626K,5030,2,75,1.51,64.16,366724,235303,-131421,3369,4019,650,626735,5030,5030,5030,203,0,1,4227,14064,0,203
140400,33626K,5040,2,85,1.72,63.83,368724,235346,-133378,3370,4022,652,628778,5030,5040,5030,2043,1,3,6526,14552,2000,43
140500,33626K,5040,2,85,1.72,63.83,368724,235356,-133368,3370,4023,653,628788,5040,5040,5040,0,0,0,7384,15492,0,0
140500,33626K,5040,2,85,1.72,63.83,368724,235366,-133358,3370,4024,654,628798,5040,5040,5040,10,0,1,9596,15096,0,10
140600,33626K,5040,2,85,1.72,63.84,368724,235396,-133328,3370,4025,655,628828,5040,5040,5040,0,0,0,10052,15096,0,0
140600,33626K,5040,2,85,1.72,63.84,368724,235396,-133328,3370,4025,655,628828,5040,5040,5040,0,0,0,10052,15096,0,0
140700,33626K,5030,2,75,1.51,63.84,368730,235396,-133334,3371,4025,654,628834,5030,5030,5030,0,0,0,7598,15096,0,0
140700,33626K,5020,2,65,1.31,63.67,369730,235396,-134334,3373,4025,652,629834,5030,5030,5020,1000,2,0,7598,15090,1000,0
140800,33626K,5020,2,65,1.31,63.6,370097,235396,-134701,3374,4025,651,630201,5020,5020,5020,367,1,0,5894,14541,367,0
140800,33626K,5030,2,75,1.51,63.61,370097,235436,-134661,3374,4026,652,630241,5020,5030,5020,407,1,1,5894,14243,367,40
140900,33626K,5030,2,75,1.51,63.61,370097,235436,-134661,3374,4026,652,630241,5030,5030,5030,0,0,0,5894,14243,0,0
140900,33626K,5030,2,75,1.51,63.65,370097,235560,-134537,3374,4027,653,630365,5030,5030,5030,124,0,1,5654,14989,0,124
141000,33626K,5030,2,75,1.51,63.66,370097,235596,-134501,3374,4029,655,630401,5030,5030,5030,18,0,1,5512,14971,0,18
141000,33626K,5030,2,75,1.51,63.66,370097,235596,-134501,3374,4029,655,630401,5030,5030,5030,18,0,1,5512,14971,0,18
141100,33626K,5030,2,75,1.51,63.66,370097,235597,-134500,3374,4030,656,630402,5030,5030,5030,1,0,1,4193,15777,0,1
141100,33626K,5050,2,95,1.92,64.2,370108,237598,-132510,3375,4033,658,632414,5030,5050,5030,2013,1,4,5895,15753,11,2002
141200,33626K,5050,2,95,1.92,64.24,370183,237800,-132383,3450,4121,671,632691,5050,5060,5020,217,47,58,5510,13737,47,170
141200,33626K,5080,2,125,2.52,64.26,370264,237932,-132332,3531,4228,697,632904,5050,5080,5020,430,128,165,6546,11312,128,302
141300,33626K,5070,2,115,2.32,64.24,370546,238052,-132494,3619,4328,709,633306,5080,5080,5060,330,57,66,7172,11236,250,80
141300,33626K,5080,2,125,2.52,64.45,370644,238890,-131754,3703,4433,730,634242,5080,5090,5060,1266,141,171,7641,11359,348,918
141400,33626K,5090,2,135,2.72,64.45,370837,239005,-131832,3787,4527,740,634550,5080,5090,5080,137,59,64,8158,12072,59,78
141400,33626K,5070,2,115,2.32,64.37,371467,239102,-132365,3869,4610,741,635277,5080,5090,5070,864,141,147,9386,13844,689,175
141500,33626K,5070,2,115,2.32,64.09,373212,239192,-134020,3953,4695,742,637112,5070,5080,5070,1033,65,66,9334,12773,962,71
141500,33626K,5060,2,105,2.12,64.08,373421,239292,-134129,4030,4783,753,637421,5070,5080,5060,1342,142,154,9195,13407,1171,171
141600,33626K,5070,2,115,2.32,64.09,373488,239368,-134120,4097,4855,758,637564,5080,5080,5050,123,57,62,8273,15483,57,66
141600,33626K,5050,2,95,1.92,63.93,374539,239449,-135090,4172,4927,755,638696,5080,5080,5050,1255,132,134,7665,14967,1108,147
141700,33626K,5070,2,115,2.32,63.89,374849,239496,-135353,4213,4974,761,639053,5070,5070,5050,349,37,43,7347,15852,306,43
141700,33626K,5040,2,85,1.72,63.88,374901,239496,-135405,4217,4974,757,639105,5070,5070,5040,401,41,43,7346,15927,358,43
141800,33626K,5040,2,85,1.72,63.88,374940,239496,-135444,4218,4974,756,639144,5040,5040,5040,39,1,0,7596,16738,39,0
141900,33626K,5040,2,85,1.72,63.88,374940,239496,-135444,4218,4974,756,639144,5040,5040,5040,0,0,0,7596,16738,0,0
141900,33626K,5040,2,85,1.72,63.88,374940,239496,-135444,4218,4974,756,639144,5040,5040,5040,0,0,0,7396,16961,0,0
142000,33626K,5040,2,85,1.72,63.88,374940,239496,-135444,4218,4974,756,639144,5040,5040,5040,0,0,0,7199,17572,0,0
142000,33626K,5050,2,95,1.92,63.86,375623,239857,-135766,4219,4975,756,640188,5050,5050,5050,1044,1,1,6479,17159,683,361
142100,33626K,5050,2,95,1.92,63.86,375623,239872,-135751,4219,4977,758,640203,5050,5050,5050,5,0,1,7875,17551,0,5
142100,33626K,5050,2,95,1.92,63.86,375623,239877,-135746,4219,4978,759,640208,5050,5050,5050,10,0,2,7870,16461,0,10
142200,33626K,5050,2,95,1.92,63.88,375623,239937,-135686,4219,4979,760,640268,5050,5050,5050,0,0,0,7776,16461,0,0
142200,33626K,5040,2,85,1.72,63.72,376555,239937,-136618,4221,4979,758,641200,5040,5040,5040,932,2,0,7419,16321,932,0
142300,33626K,5040,2,85,1.72,63.74,376555,240026,-136529,4221,4982,761,641289,5040,5040,5040,0,0,0,6477,16407,0,0
142300,33626K,5070,2,115,2.32,63.75,376555,240036,-136519,4221,4984,763,641299,5040,5070,5040,10,0,2,7614,16281,0,10
142400,33626K,5070,2,115,2.32,63.7,376852,240037,-136815,4223,4985,762,641597,5070,5070,5070,1,0,1,7363,16094,0,1
142400,33626K,5070,2,115,2.32,63.7,376852,240037,-136815,4223,4985,762,641597,5070,5070,5070,1,0,1,7363,16094,0,1
142500,33626K,5040,2,85,1.72,63.69,376866,240037,-136829,4224,4985,761,641611,5040,5040,5040,14,1,0,6187,15873,14,0
142500,33626K,5040,2,85,1.72,63.69,376877,240037,-136840,4225,4985,760,641622,5040,5040,5040,25,2,0,6187,15370,25,0
142600,33626K,5040,2,85,1.72,63.69,376877,240037,-136840,4225,4985,760,641622,5040,5040,5040,0,0,0,6187,15370,0,0
142600,33626K,5040,2,85,1.72,63.69,376877,240037,-136840,4225,4985,760,641622,5040,5040,5040,0,0,0,6187,15370,0,0
142700,33626K,5060,2,105,2.12,63.69,376877,240038,-136839,4225,4986,761,641623,5060,5060,5060,1,0,1,6587,15978,0,1
142700,33626K,5060,2,105,2.12,63.69,376877,240038,-136839,4225,4986,761,641623,5060,5060,5060,1,0,1,6587,15978,0,1
142800,33626K,5060,2,105,2.12,63.69,376877,240038,-136839,4225,4986,761,641623,5060,5060,5060,0,0,0,6587,15978,0,0
142800,33626K,5030,2,75,1.51,63.65,377102,240038,-137064,4228,4986,758,641848,5050,5050,5030,225,3,0,6846,14353,225,0
142900,33626K,5030,2,75,1.51,63.65,377102,240038,-137064,4228,4986,758,641848,5030,5030,5030,0,0,0,6846,14353,0,0
142900,33626K,5030,2,75,1.51,63.65,377102,240038,-137064,4228,4986,758,641848,5030,5030,5030,0,0,0,6846,14353,0,0
143000,33626K,5030,2,75,1.51,63.65,377102,240038,-137064,4228,4986,758,641848,5030,5030,5030,0,0,0,6876,15447,0,0
143000,33626K,5030,2,75,1.51,63.65,377102,240038,-137064,4228,4986,758,641848,5030,5030,5030,0,0,0,6906,15352,0,0
143100,33626K,5030,2,75,1.51,63.65,377102,240038,-137064,4228,4986,758,641848,5030,5030,5030,0,0,0,7406,15490,0,0
143200,33626K,5030,2,75,1.51,63.55,377704,240038,-137666,4229,4986,757,642450,5030,5030,5030,0,0,0,5516,16155,0,0
143200,33626K,5030,2,75,1.51,63.55,377704,240038,-137666,4229,4986,757,642450,5030,5030,5030,0,0,0,5516,16155,0,0
143300,33626K,5030,2,75,1.51,63.55,377704,240038,-137666,4229,4986,757,642450,5030,5030,5030,0,0,0,5516,15240,0,0
143300,33626K,5040,2,85,1.72,63.55,377708,240038,-137670,4230,4986,756,642454,5040,5040,5040,4,1,0,5516,14263,4,0
143400,33626K,5040,2,85,1.72,63.58,377718,240149,-137569,4231,4989,758,642575,5040,5040,5040,109,0,2,5777,15220,0,109
143400,33626K,5030,2,75,1.51,63.56,377818,240149,-137669,4232,4989,757,642675,5040,5040,5030,209,1,2,5768,15220,100,109
143500,33626K,5050,2,95,1.92,63.42,378663,240150,-138513,4233,4990,757,643521,5050,5050,5050,1,0,1,5407,14375,0,1
143500,33626K,5060,2,105,2.12,63.48,378663,240384,-138279,4233,4992,759,643755,5050,5060,5050,235,0,3,6299,14375,0,235
143600,33626K,5060,2,105,2.12,63.48,378663,240384,-138279,4233,4992,759,643755,5060,5060,5060,0,0,0,6299,14375,0,0
143600,33626K,5050,2,95,1.92,63.51,378663,240485,-138178,4233,4994,761,643856,5050,5050,5050,101,0,2,6503,15542,0,101
143700,33626K,5030,2,75,1.51,63.51,378664,240485,-138179,4234,4994,760,643857,5030,5030,5030,1,1,0,6280,15542,1,0
143700,33626K,5050,2,95,1.92,63.51,378664,240487,-138177,4234,4996,762,643859,5030,5050,5030,3,1,2,6279,15541,1,2
143800,33626K,5050,2,95,1.92,63.51,378664,240487,-138177,4234,4996,762,643859,5050,5050,5050,0,0,0,6279,15541,0,0
143800,33626K,5050,2,95,1.92,63.51,378664,240487,-138177,4234,4996,762,643859,5050,5050,5050,0,0,0,6279,15541,0,0
143900,33626K,5040,2,85,1.72,63.51,378684,240487,-138197,4235,4996,761,643879,5040,5040,5040,20,1,0,6278,17300,20,0
143900,33626K,5040,2,85,1.72,63.51,378684,240487,-138197,4235,4996,761,643879,5040,5040,5040,20,1,0,6278,17300,20,0
144000,33626K,5040,2,85,1.72,63.55,378684,240638,-138046,4235,4998,763,644030,5040,5040,5040,10,0,1,5705,18319,0,10
144000,33626K,5050,2,95,1.92,63.78,378684,241535,-137149,4235,4999,764,644927,5040,5050,5040,907,0,2,6279,18319,0,907
144100,33626K,5050,2,95,1.92,63.77,378784,241535,-137249,4236,4999,763,645027,5050,5050,5050,100,1,0,6454,17441,100,0
144100,33626K,5050,2,95,1.92,63.77,378784,241535,-137249,4236,4999,763,645027,5050,5050,5050,100,1,0,6454,17441,100,0
144200,33626K,5060,2,105,2.12,63.79,378784,241635,-137149,4236,5000,764,645127,5060,5060,5060,100,0,1,7555,20641,0,100
144200,33626K,5080,2,125,2.52,63.91,378784,242077,-136707,4236,5002,766,645569,5060,5080,5060,542,0,3,7597,20985,0,542
144300,33626K,5080,2,125,2.52,63.96,378784,242277,-136507,4236,5004,768,645769,5090,5090,5080,200,0,2,8100,20745,0,200
144300,33626K,5100,2,145,2.93,64.07,379145,242933,-136212,4237,5008,771,646786,5090,5100,5080,1217,1,6,8130,19713,361,856
144400,33626K,5100,2,145,2.93,64.07,379145,242933,-136212,4237,5008,771,646786,5100,5100,5100,0,0,0,8130,19713,0,0
144500,33626K,5110,2,155,3.13,64.03,379436,242936,-136500,4241,5011,770,647080,5110,5110,5110,0,0,0,7632,19731,0,0
144500,33626K,5100,2,145,2.93,64.0,379915,243149,-136766,4243,5013,770,647772,5110,5110,5100,692,2,2,7618,19955,479,213
144600,33626K,5100,2,145,2.93,64.0,379915,243149,-136766,4243,5013,770,647772,5100,5100,5100,0,0,0,7618,19955,0,0
144600,33626K,5080,2,125,2.52,64.0,379916,243149,-136767,4244,5013,769,647773,5080,5080,5080,1,1,0,7304,23222,1,0
144700,33626K,5100,2,145,2.93,64.0,379917,243151,-136766,4245,5015,770,647776,5100,5100,5100,0,0,0,7103,23220,0,0
144700,33626K,5100,2,145,2.93,64.0,379917,243151,-136766,4245,5015,770,647776,5100,5100,5100,0,0,0,7103,23220,0,0
144800,33626K,5080,2,125,2.52,63.98,380025,243151,-136874,4248,5015,767,647884,5080,5080,5080,100,1,0,5642,21766,100,0
144800,33626K,5100,2,145,2.93,64.0,380025,243221,-136804,4248,5017,769,647954,5080,5100,5080,170,1,2,6611,21666,100,70
144900,33626K,5100,2,145,2.93,64.0,380025,243221,-136804,4248,5017,769,647954,5100,5100,5100,0,0,0,6611,21666,0,0
144900,33626K,5100,2,145,2.93,64.0,380025,243221,-136804,4248,5017,769,647954,5100,5100,5100,0,0,0,8262,22496,0,0
145000,33626K,5100,2,145,2.93,64.0,380025,243223,-136802,4248,5018,770,647956,5100,5100,5100,2,0,1,6750,21517,0,2
145000,33626K,5100,2,145,2.93,64.0,380025,243223,-136802,4248,5018,770,647956,5100,5100,5100,2,0,1,6750,21517,0,2
145100,33626K,5080,2,125,2.52,63.97,380228,243223,-137005,4249,5018,769,648159,5080,5080,5080,203,1,0,7460,21813,203,0
145100,33626K,5080,2,125,2.52,64.03,380228,243475,-136753,4249,5020,771,648411,5080,5080,5080,455,1,2,6738,23010,203,252
145200,33626K,5060,2,105,2.12,64.02,380328,243475,-136853,4251,5020,769,648511,5060,5060,5060,0,0,0,6533,21510,0,0
145200,33626K,5060,2,105,2.12,64.02,380328,243475,-136853,4251,5020,769,648511,5060,5060,5060,0,0,0,6533,21510,0,0
145300,33626K,5060,2,105,2.12,64.02,380328,243475,-136853,4251,5020,769,648511,5060,5060,5060,0,0,0,6386,20780,0,0
145300,33626K,5060,2,105,2.12,64.02,380328,243475,-136853,4251,5020,769,648511,5060,5060,5060,0,0,0,6386,20783,0,0
145400,33626K,5060,2,105,2.12,64.02,380328,243475,-136853,4251,5020,769,648511,5060,5060,5060,0,0,0,6978,20789,0,0
145400,33626K,5060,2,105,2.12,64.02,380328,243475,-136853,4251,5020,769,648511,5060,5060,5060,0,0,0,7066,21306,0,0
145500,33626K,5060,2,105,2.12,63.99,380503,243475,-137028,4252,5020,768,648686,5060,5060,5060,175,1,0,7117,18889,175,0
145500,33626K,5060,2,105,2.12,63.91,380973,243475,-137498,4253,5020,767,649156,5060,5060,5060,645,2,0,7117,18714,645,0
145600,33626K,5060,2,105,2.12,63.91,380973,243475,-137498,4253,5020,767,649156,5060,5060,5060,0,0,0,7117,18714,0,0
145700,33626K,5060,2,105,2.12,63.91,380973,243475,-137498,4253,5020,767,649156,5060,5060,5060,0,0,0,7049,18044,0,0
145700,33626K,5060,2,105,2.12,63.91,380973,243475,-137498,4253,5020,767,649156,5060,5060,5060,0,0,0,6318,18165,0,0
145800,33626K,5060,2,105,2.12,63.91,380973,243475,-137498,4253,5020,767,649156,5060,5060,5060,0,0,0,6966,18165,0,0
145800,33626K,5060,2,105,2.12,63.91,380974,243475,-137499,4254,5020,766,649157,5060,5060,5060,1,1,0,6967,18685,1,0
145900,33626K,5060,2,105,2.12,63.91,380974,243475,-137499,4254,5020,766,649157,5060,5060,5060,0,0,0,6967,18685,0,0
145900,33626K,5070,2,115,2.32,63.9,381007,243475,-137532,4255,5020,765,649190,5070,5070,5070,33,1,0,6803,19071,33,0
150000,33626K,5060,2,105,2.12,63.86,381257,243475,-137782,4258,5020,762,649440,5060,5060,5060,0,0,0,6855,18988,0,0
150000,33626K,5060,2,105,2.12,63.86,381267,243475,-137792,4259,5020,761,649450,5060,5060,5060,10,1,0,6202,19602,10,0
150100,33626K,5070,2,115,2.32,63.88,381276,243555,-137721,4260,5021,761,649539,5070,5070,5070,0,0,0,6841,19797,0,0
150100,33626K,5070,2,115,2.32,63.86,381376,243555,-137821,4261,5021,760,649639,5070,5070,5070,100,1,0,6841,20788,100,0
150200,33626K,5090,2,135,2.72,63.92,381376,243791,-137585,4261,5023,762,649875,5090,5090,5090,21,0,1,6830,21472,0,21
150200,33626K,5090,2,135,2.72,63.92,381376,243791,-137585,4261,5023,762,649875,5090,5090,5090,21,0,1,6830,21472,0,21
150300,33626K,5090,2,135,2.72,63.99,381426,244093,-137333,4262,5024,762,650227,5090,5090,5090,50,1,0,7852,21982,50,0
150300,33626K,5090,2,135,2.72,63.99,381483,244093,-137390,4263,5024,761,650284,5090,5090,5090,107,2,0,7861,21953,107,0
150400,33626K,5090,2,135,2.72,63.96,381643,244093,-137550,4265,5024,759,650444,5090,5090,5090,0,0,0,7861,21796,0,0
150400,33626K,5090,2,135,2.72,63.96,381643,244093,-137550,4265,5024,759,650444,5090,5090,5090,0,0,0,7861,21796,0,0
150500,33626K,5090,2,135,2.72,63.85,382303,244093,-138210,4266,5024,758,651104,5090,5090,5090,660,1,0,7861,22506,660,0
150500,33626K,5100,2,145,2.93,63.85,382503,244245,-138258,4267,5028,761,651456,5090,5100,5090,1012,2,4,7269,21646,860,152
150600,33626K,5110,2,155,3.13,64.23,382953,245975,-136978,4269,5031,762,653636,5100,5110,5100,2178,2,2,8373,12599,450,1728
150600,33626K,5110,2,155,3.13,64.49,382953,246976,-135977,4269,5035,766,654637,5100,5110,5100,3179,2,6,6599,12554,450,2729
150700,33626K,5110,2,155,3.13,64.5,382953,246993,-135960,4269,5038,769,654654,5110,5110,5110,3,0,2,6638,13054,0,3
150700,33626K,5110,2,155,3.13,64.59,382953,247335,-135618,4269,5041,772,654996,5110,5110,5110,345,0,5,6632,13416,0,345
150800,33626K,5120,2,165,3.33,64.57,383054,247339,-135715,4271,5044,773,655101,5110,5120,5110,105,2,3,6608,12786,101,4
150800,33626K,5120,2,165,3.33,64.57,383054,247339,-135715,4271,5044,773,655101,5110,5120,5110,105,2,3,6608,12786,101,4
150900,33626K,5110,2,155,3.13,64.33,384458,247341,-137117,4274,5046,772,656507,5120,5120,5110,1406,3,2,14255,14046,1404,2
151000,33626K,5100,2,145,2.93,64.42,384958,247997,-136961,4279,5048,769,657663,5100,5100,5100,55,1,0,14134,14485,55,0
151000,33626K,5110,2,155,3.13,64.39,385130,248001,-137129,4281,5049,768,657839,5100,5110,5100,231,3,1,14062,14258,227,4
151100,33626K,5110,2,155,3.13,64.39,385160,248002,-137158,4282,5050,768,657870,5110,5110,5110,1,0,1,14068,14228,0,1
151100,33626K,5110,2,155,3.13,64.39,385160,248002,-137158,4282,5050,768,657870,5110,5110,5110,1,0,1,14068,14228,0,1
151200,33626K,5110,2,155,3.13,64.49,385237,248425,-136812,4284,5051,767,658370,5110,5110,5110,0,0,0,13760,13629,0,0
151200,33626K,5110,2,155,3.13,64.49,385238,248426,-136812,4285,5052,767,658372,5100,5110,5100,2,1,1,15652,14245,1,1
151300,33626K,5100,2,145,2.93,64.51,385239,248526,-136713,4286,5053,767,658473,5100,5100,5100,0,0,0,15604,14245,0,0
151300,33626K,5100,2,145,2.93,64.51,385239,248526,-136713,4286,5053,767,658473,5100,5100,5100,0,0,0,15604,14245,0,0
151400,33626K,5100,2,145,2.93,64.51,385239,248527,-136712,4286,5054,768,658474,5100,5100,5100,1,0,1,14820,20023,0,1
151400,33626K,5100,2,145,2.93,64.66,385289,249127,-136162,4287,5059,772,659124,5100,5110,5100,651,1,6,15872,14017,50,601
151500,33626K,5110,2,155,3.13,64.87,385299,249931,-135368,4288,5062,774,659938,5110,5110,5110,3,0,1,15061,13957,0,3
151500,33626K,5100,2,145,2.93,64.79,385731,249931,-135800,4290,5062,772,660370,5110,5110,5100,435,2,1,14960,13720,432,3
151600,33626K,5100,2,145,2.93,64.76,385931,249931,-136000,4291,5062,771,660570,5100,5100,5100,200,1,0,14960,13785,200,0
151600,33626K,5120,2,165,3.33,64.92,386355,250806,-135549,4292,5064,772,661869,5100,5120,5100,1499,2,2,15255,12725,624,875
151700,33626K,5120,2,165,3.33,64.89,386520,250808,-135712,4294,5066,772,662036,5110,5120,5110,167,2,2,15253,12560,165,2
151700,33626K,5110,2,155,3.13,64.87,386719,250879,-135840,4296,5068,772,662306,5110,5120,5110,437,4,4,15891,12567,364,73
151800,33626K,5110,2,155,3.13,64.93,386720,251088,-135632,4297,5070,773,662516,5110,5110,5100,210,1,2,16116,14167,1,209
151800,33626K,5110,2,155,3.13,64.93,386720,251088,-135632,4297,5070,773,662516,5110,5110,5100,210,1,2,16116,14167,1,209
151900,33626K,5110,2,155,3.13,64.98,386720,251288,-135432,4297,5072,775,662716,5110,5110,5110,200,0,2,16215,13788,0,200
152000,33626K,5110,2,155,3.13,65.02,386720,251458,-135262,4297,5073,776,662886,5110,5110,5110,0,0,0,16615,13702,0,0
152000,33626K,5110,2,155,3.13,65.02,386755,251459,-135296,4299,5074,775,662922,5100,5110,5090,36,2,1,16445,20274,35,1
152000,33626K,5100,2,145,2.93,65.02,386757,251469,-135288,4300,5075,775,662934,5100,5110,5090,48,3,2,14811,20658,37,11
152000,33626K,5100,2,145,2.93,65.02,386757,251469,-135288,4300,5075,775,662934,5100,5110,5090,48,3,2,14811,20658,37,11
152000,33626K,5100,2,145,2.93,65.02,386757,251469,-135288,4300,5075,775,662934,5100,5110,5090,48,3,2,14811,20658,37,11
152000,33626K,5100,2,145,2.93,65.02,386757,251469,-135288,4300,5075,775,662934,5100,5110,5090,48,3,2,14811,20658,37,11
152000,33626K,5100,2,145,2.93,65.02,386757,251469,-135288,4300,5075,775,662934,5100,5110,5090,48,3,2,14811,20658,37,11
152000,33626K,5100,2,145,2.93,65.02,386757,251469,-135288,4300,5075,775,662934,5100,5110,5090,48,3,2,14811,20658,37,11
152000,33626K,5100,2,145,2.93,65.02,386757,251469,-135288,4300,5075,775,662934,5100,5110,5090,48,3,2,14811,20658,37,11
152000,33626K,5100,2,145,2.93,65.02,386757,251469,-135288,4300,5075,775,662934,5100,5110,5090,48,3,2,14811,20658,37,11
152000,33626K,5100,2,145,2.93,65.02,386757,251469,-135288,4300,5075,775,662934,5100,5110,5090,48,3,2,14811,20658,37,11
152000,33626K,5100,2,145,2.93,65.02,386757,251469,-135288,4300,5075,775,662934,5100,5110,5090,48,3,2,14811,20658,37,11
152000,33626K,5100,2,145,2.93,65.02,386757,251469,-135288,4300,5075,775,662934,5100,5110,5090,48,3,2,14811,20658,37,11
152000,33626K,5100,2,145,2.93,65.02,386757,251469,-135288,4300,5075,775,662934,5100,5110,5090,48,3,2,14811,20658,37,11
152000,33626K,5100,2,145,2.93,65.02,386757,251469,-135288,4300,5075,775,662934,5100,5110,5090,48,3,2,14811,20658,37,11
152000,33626K,5100,2,145,2.93,65.02,386757,251469,-135288,4300,5075,775,662934,5100,5110,5090,48,3,2,14811,20658,37,11
152000,33626K,5100,2,145,2.93,65.02,386757,251469,-135288,4300,5075,775,662934,5100,5110,5090,48,3,2,14811,20658,37,11
152000,33626K,5100,2,145,2.93,65.02,386757,251469,-135288,4300,5075,775,662934,5100,5110,5090,48,3,2,14811,20658,37,11
152000,33626K,5100,2,145,2.93,65.02,386757,251469,-135288,4300,5075,775,662934,5100,5110,5090,48,3,2,14811,20658,37,11
152000,33626K,5100,2,145,2.93,65.02,386757,251469,-135288,4300,5075,775,662934,5100,5110,5090,48,3,2,14811,20658,37,11
152000,33626K,5100,2,145,2.93,65.02,386757,251469,-135288,4300,5075,775,662934,5100,5110,5090,48,3,2,14811,20658,37,11
153000,33626K,5100,2,145,2.93,65.02,386757,251469,-135288,4300,5075,775,662934,5100,5100,5100,0,0,0,14801,20658,0,0
153000,33626K,5100,2,145,2.93,65.02,386757,251469,-135288,4300,5075,775,667916,5100,5100,5100,4982,0,0,14801,20658,0,0
153000,33626K,5100,2,145,2.93,65.02,386757,251469,-135288,4300,5075,775,667916,5100,5100,5100,4982,0,0,14801,20658,0,0
