092700,011390,173000,2,7000,4.22,81.87,19281,15785,-3496,666,525,-141,39216,173000,173500,173000,355,2,3,5924,3826,341,14
092800,011390,172000,2,6000,3.61,80.5,19615,15790,-3825,670,526,-144,39555,172000,172000,172000,2,1,0,5946,3570,2,0
092800,011390,172500,2,6500,3.92,80.36,19663,15801,-3862,676,528,-148,39614,172000,173000,172000,61,7,2,6019,3596,50,11
092900,011390,172500,2,6500,3.92,80.28,19682,15801,-3881,679,528,-151,39633,172500,172500,172500,0,0,0,6023,3612,0,0
092900,011390,173000,2,7000,4.22,79.67,19839,15806,-4033,682,532,-150,39795,172500,173000,172500,162,3,4,5726,3571,157,5
093000,011390,173000,2,7000,4.22,79.69,19839,15810,-4029,682,534,-148,39799,173000,173000,173000,2,0,1,5985,3848,0,2
093000,011390,173000,2,7000,4.22,79.79,19854,15841,-4013,684,535,-149,39845,173000,173000,172500,48,2,2,6011,3866,15,33
093100,011390,173000,2,7000,4.22,79.4,19954,15843,-4111,685,537,-148,39947,173000,173000,173000,1,0,1,5998,3835,0,1
093100,011390,172500,2,6500,3.92,79.38,20040,15907,-4133,694,540,-154,40097,173000,173000,172500,151,9,4,5915,3758,86,65
093200,011390,172500,2,6500,3.92,79.14,20126,15928,-4198,698,542,-156,40204,172500,172500,172500,56,3,0,5897,3718,56,0
093200,011390,172500,2,6500,3.92,79.22,20141,15956,-4185,702,546,-156,40247,172500,172500,172000,99,7,4,4752,3866,71,28
093300,011390,172500,2,6500,3.92,79.51,20141,16014,-4127,702,551,-151,40305,172500,172500,172500,9,0,3,5114,3884,0,9
093300,011390,172000,2,6000,3.61,79.46,20153,16014,-4139,705,551,-154,40317,172500,172500,172000,21,3,3,5112,3889,12,9
093400,011390,173000,2,7000,4.22,78.7,20567,16187,-4380,710,554,-156,40904,172500,173000,172500,173,0,3,5819,3517,0,173
093400,011390,173000,2,7000,4.22,78.7,20567,16187,-4380,710,554,-156,40904,172500,173000,172500,173,0,3,5819,3517,0,173
093500,011390,173500,2,7500,4.52,79.66,20567,16384,-4183,710,558,-152,41101,173500,173500,173500,1,0,1,7170,3369,0,1
093500,011390,173000,2,7000,4.22,79.66,20571,16387,-4184,712,559,-153,41108,173500,173500,173000,8,2,2,7150,3404,4,4
093600,011390,173500,2,7500,4.52,79.63,20581,16388,-4193,713,560,-153,41119,173000,173500,173000,11,1,1,7155,3398,10,1
093600,011390,173000,2,7000,4.22,79.78,20618,16450,-4168,715,564,-151,41218,173000,173500,173000,110,3,5,5754,3750,47,63
093700,011390,173500,2,7500,4.52,79.96,20627,16494,-4133,718,566,-152,41271,173000,173500,173000,53,3,2,7088,3493,9,44
093700,011390,173500,2,7500,4.52,79.96,20627,16494,-4133,718,566,-152,41271,173000,173500,173000,53,3,2,7088,3493,9,44
093800,011390,173500,2,7500,4.52,80.41,20629,16588,-4041,719,569,-150,41367,173500,173500,173500,93,0,2,7021,3496,0,93
093800,011390,173000,2,7000,4.22,80.57,20651,16638,-4013,722,571,-151,41439,173500,173500,173000,165,3,4,7020,3524,22,143
093900,011390,173000,2,7000,4.22,80.35,20707,16638,-4069,725,571,-154,41495,173000,173000,173000,56,3,0,7146,3647,56,0
093900,011390,173000,2,7000,4.22,79.44,20946,16640,-4306,727,572,-155,41736,173000,173000,172500,297,5,1,5775,3686,295,2
094000,011390,172000,2,6000,3.61,79.37,20965,16640,-4325,730,572,-158,41755,172500,172500,172000,14,2,0,5785,3699,14,0
094000,011390,173000,2,7000,4.22,79.32,20979,16641,-4338,732,573,-159,41770,172500,173000,172000,29,4,1,5825,4115,28,1
094100,011390,173000,2,7000,4.22,79.32,20979,16641,-4338,732,573,-159,41770,173000,173000,173000,0,0,0,5825,4115,0,0
094100,011390,172000,2,6000,3.61,79.32,20980,16641,-4339,733,573,-160,41771,172000,172000,172000,1,1,0,6035,4210,1,0
094200,011390,172500,2,6500,3.92,79.27,20993,16641,-4352,734,573,-161,41784,172500,172500,172500,13,1,0,6067,4253,13,0
094200,011390,172500,2,6500,3.92,79.27,21031,16671,-4360,738,575,-163,41852,172500,172500,172500,81,5,2,4935,4275,51,30
094300,011390,172000,2,6000,3.61,79.28,21033,16675,-4358,739,577,-162,41858,172500,172500,172000,6,1,2,4910,4293,2,4
094400,011390,172500,2,6500,3.92,79.72,21033,16768,-4265,739,583,-156,41951,172500,172500,172500,0,0,0,4876,4302,0,0
094400,011390,172500,2,6500,3.92,80.04,21033,16835,-4198,739,588,-151,42018,172500,172500,172500,67,0,5,4969,4460,0,67
094500,011390,172000,2,6000,3.61,80.03,21036,16836,-4200,740,589,-151,42022,172000,172000,172000,0,0,0,4938,4461,0,0
094500,011390,172000,2,6000,3.61,78.6,21421,16836,-4585,744,589,-155,42407,172000,172000,172000,385,4,0,4944,4710,385,0
094600,011390,172500,2,6500,3.92,78.8,21478,16925,-4553,747,591,-156,42553,172500,172500,172500,0,0,0,4900,4655,0,0
094600,011390,172500,2,6500,3.92,78.74,21494,16925,-4569,749,591,-158,42569,172500,172500,172500,16,2,0,6073,4770,16,0
094700,011390,172500,2,6500,3.92,78.73,21502,16928,-4574,750,594,-156,42580,172500,172500,172500,8,1,0,6183,4790,8,0
094700,011390,173000,2,7000,4.22,78.73,21502,16929,-4573,750,595,-155,42581,172500,173000,172500,9,1,1,6183,4782,8,1
094800,011390,172500,2,6500,3.92,78.73,21504,16930,-4574,752,596,-156,42584,172500,172500,172500,0,0,0,6190,4810,0,0
094800,011390,173000,2,7000,4.22,78.73,21506,16932,-4574,753,597,-156,42588,172500,173000,172500,4,1,1,6204,4809,2,2
094900,011390,173000,2,7000,4.22,78.75,21506,16937,-4569,753,598,-155,42593,173000,173000,173000,0,0,0,6196,4826,0,0
094900,011390,172500,2,6500,3.92,78.75,21508,16937,-4571,754,598,-156,42595,172500,172500,172500,2,1,0,6234,4799,2,0
095000,011390,172500,2,6500,3.92,78.48,21581,16937,-4644,759,598,-161,42668,172500,172500,172500,37,3,0,6272,4762,37,0
095000,011390,172500,2,6500,3.92,78.46,21586,16937,-4649,760,598,-162,42673,172500,172500,172500,42,4,0,6272,4736,42,0
095100,011390,172500,2,6500,3.92,78.36,21617,16939,-4678,767,599,-168,42706,172500,172500,172500,0,0,0,6317,4782,0,0
095100,011390,172500,2,6500,3.92,78.36,21617,16939,-4678,767,599,-168,42706,172500,172500,172500,0,0,0,6317,4782,0,0
095200,011390,173000,2,7000,4.22,78.36,21617,16940,-4677,767,600,-167,42707,173000,173000,173000,0,0,0,6359,4776,0,0
095200,011390,173000,2,7000,4.22,78.37,21617,16941,-4676,767,601,-166,42708,173000,173000,173000,1,0,1,6527,4786,0,1
095300,011390,173000,2,7000,4.22,79.51,21629,17197,-4432,769,610,-159,42976,173000,173000,173000,12,0,4,6285,4801,0,12
095300,011390,173000,2,7000,4.22,79.73,21632,17247,-4385,770,612,-158,43029,173000,173000,173000,65,1,6,7777,4402,3,62
095400,011390,173000,2,7000,4.22,79.69,21643,17247,-4396,772,612,-160,43040,173000,173000,173000,8,1,0,7771,3988,8,0
095400,011390,174000,2,8000,4.82,81.76,21645,17697,-3948,774,620,-154,43492,173000,174500,173000,460,3,8,8602,3432,10,450
095500,011390,174500,2,8500,5.12,82.7,21769,18004,-3765,780,625,-155,43923,174500,175000,174500,118,5,3,8813,3273,94,24
095500,011390,174500,2,8500,5.12,82.61,21809,18017,-3792,785,628,-157,43976,174500,175000,174500,171,10,6,8540,3892,134,37
095600,011390,174000,2,8000,4.82,82.49,21850,18024,-3826,791,629,-162,44024,174000,174000,174000,0,0,0,8855,3940,0,0
095600,011390,173500,2,7500,4.52,82.19,21930,18024,-3906,796,629,-167,44104,174000,174000,173500,80,5,0,8206,4673,80,0
095700,011390,174000,2,8000,4.82,82.43,21988,18124,-3864,798,633,-165,44262,174000,174000,173500,107,1,3,8241,5223,8,99
095700,011390,176000,2,10000,6.02,91.02,22101,20117,-1984,802,663,-139,46368,174000,176000,173500,2213,5,33,10598,3679,121,2092
095800,011390,176000,2,10000,6.02,95.43,22328,21307,-1021,809,726,-83,47785,176000,176500,176000,445,6,12,9702,3510,225,220
095800,011390,176000,2,10000,6.02,96.0,22824,21911,-913,816,755,-61,48885,176000,176500,175000,1545,13,41,9917,3806,721,824
095900,011390,175500,2,9500,5.72,96.2,23246,22363,-883,832,779,-53,49759,176000,176000,175500,555,15,10,10141,3682,418,137
095900,011390,175500,2,9500,5.72,95.82,23410,22431,-979,836,786,-50,49991,176000,176000,175500,787,19,17,10107,3836,582,205
100000,011390,175500,2,9500,5.72,94.88,23790,22573,-1217,844,803,-41,50513,175000,176000,175000,148,3,14,10508,4247,28,120
100000,011390,175000,2,9000,5.42,92.67,24572,22772,-1800,853,820,-33,51494,175000,176000,174500,1129,12,31,11029,4341,810,319
100100,011390,174500,2,8500,5.12,91.28,25056,22872,-2184,862,821,-41,52078,175000,175000,174500,383,7,0,11471,4077,383,0
100100,011390,175000,2,9000,5.42,90.54,25327,22931,-2396,875,828,-47,52408,175000,175500,174500,713,20,7,8047,4434,654,59
100200,011390,174500,2,8500,5.12,89.97,25488,22932,-2556,882,829,-53,52570,174500,175000,174500,161,6,1,8203,4391,160,1
100200,011390,174000,2,8000,4.82,88.61,25879,22932,-2947,887,829,-58,52961,174500,175000,174000,552,11,1,8190,4482,551,1
100300,011390,175000,2,9000,5.42,88.62,25879,22933,-2946,887,830,-57,52962,175000,175000,175000,1,0,1,8200,4365,0,1
100300,011390,174000,2,8000,4.82,88.08,26036,22933,-3103,891,830,-61,53119,175000,175000,174000,158,4,1,8295,4579,157,1
100400,011390,174000,2,8000,4.82,87.78,26132,22938,-3194,895,831,-64,53220,174000,174500,174000,46,2,1,7385,4881,41,5
100400,011390,173000,2,7000,4.22,86.43,26542,22939,-3603,905,832,-73,53631,174000,174500,173000,457,12,2,6615,5396,451,6
100500,011390,174000,2,8000,4.82,86.42,26552,22947,-3605,906,834,-72,53649,174000,174000,173500,18,1,2,7059,5771,10,8
100500,011390,175000,2,9000,5.42,87.12,26583,23159,-3424,908,838,-70,53892,174000,175000,173500,261,3,6,8842,4978,41,220
100600,011390,174500,2,8500,5.12,86.72,26740,23190,-3550,913,839,-74,54080,174000,174500,174000,44,1,1,7979,4838,13,31
100600,011390,174500,2,8500,5.12,86.74,26740,23193,-3547,913,840,-73,54083,174000,174500,174000,47,1,2,8430,5036,13,34
100700,011390,174500,2,8500,5.12,86.74,26740,23193,-3547,913,840,-73,54083,174500,174500,174500,0,0,0,8430,5036,0,0
100700,011390,174500,2,8500,5.12,86.74,26740,23193,-3547,913,840,-73,54083,174500,174500,174500,0,0,0,8430,5036,0,0
100800,011390,174000,2,8000,4.82,86.79,26794,23254,-3540,916,843,-73,54198,174000,174000,174000,115,3,3,7743,5697,54,61
100800,011390,176000,2,10000,6.02,94.61,26813,25367,-1446,918,883,-35,56330,174000,176000,174000,2247,5,43,11122,4432,73,2174
100900,011390,175000,2,9000,5.42,94.93,26869,25508,-1361,921,896,-25,56527,175500,175500,175000,197,3,13,11203,4541,56,141
101000,011390,174500,2,8500,5.12,94.95,26988,25626,-1362,924,902,-22,56764,174500,174500,174500,0,0,0,8134,4970,0,0
101000,011390,174500,2,8500,5.12,94.74,27050,25627,-1423,928,903,-25,56827,174500,175000,174500,63,4,1,10674,5249,62,1
101100,011390,174500,2,8500,5.12,94.68,27068,25628,-1440,929,904,-25,56846,174500,174500,174500,18,1,0,11313,5560,18,0
101100,011390,174500,2,8500,5.12,94.4,27149,25628,-1521,932,904,-28,56927,174500,174500,174500,99,4,0,11639,5476,99,0
101200,011390,174500,2,8500,5.12,93.91,27293,25632,-1661,940,905,-35,57075,174500,174500,174500,0,0,0,11611,5588,0,0
101200,011390,174500,2,8500,5.12,93.89,27300,25632,-1668,943,905,-38,57082,174500,174500,174500,7,3,0,11682,5615,7,0
101300,011390,175500,2,9500,5.72,94.83,27319,25906,-1413,944,910,-34,57375,175500,175500,175500,0,0,0,14667,5137,0,0
101300,011390,175000,2,9000,5.42,94.87,27392,25988,-1404,945,918,-27,57530,175500,175500,175000,155,1,8,11510,5579,73,82
101400,011390,175000,2,9000,5.42,97.02,27416,26599,-817,947,926,-21,58165,175000,175000,175000,189,1,2,11171,6586,14,175
101400,011390,175500,2,9500,5.72,97.09,27416,26618,-798,947,929,-18,58184,175000,175500,175000,208,1,5,14754,6324,14,194
101500,011390,175000,2,9000,5.42,97.09,27423,26624,-799,948,930,-18,58197,175000,175000,175000,7,1,0,14763,6276,7,0
101500,011390,174500,2,8500,5.12,95.98,27761,26644,-1117,958,931,-27,58555,175000,175500,174500,365,11,1,11126,6391,345,20
101600,011390,175000,2,9000,5.42,96.08,27789,26700,-1089,960,935,-25,58639,175000,175000,175000,3,0,1,11259,6358,0,3
101600,011390,175000,2,9000,5.42,97.14,27792,26998,-794,961,940,-21,58940,175000,175000,174500,304,1,6,11023,6559,3,301
101700,011390,175000,2,9000,5.42,97.18,27804,27021,-783,962,944,-18,58975,175000,175000,175000,11,0,2,11064,6555,0,11
101700,011390,175000,2,9000,5.42,97.24,27827,27058,-769,964,946,-18,59035,175000,175000,175000,71,2,4,11088,6540,23,48
101800,011390,175000,2,9000,5.42,97.24,27827,27059,-768,964,947,-17,59036,175000,175000,175000,0,0,0,11157,6560,0,0
101800,011390,174500,2,8500,5.12,97.19,27843,27061,-782,966,948,-18,59054,175000,175000,174500,18,2,1,11245,6633,16,2
101900,011390,175000,2,9000,5.42,93.76,28900,27097,-1803,969,950,-19,60147,175000,175000,175000,26,0,1,10736,5580,0,26
101900,011390,174000,2,8000,4.82,93.02,29131,27099,-2032,974,951,-23,60380,175000,175000,174000,259,5,2,10031,5576,231,28
102000,011390,174500,2,8500,5.12,92.98,29147,27100,-2047,976,952,-24,60397,174000,174500,174000,13,1,1,10066,5563,12,1
102000,011390,174500,2,8500,5.12,92.59,29282,27112,-2170,980,953,-27,60544,174000,174500,174000,160,5,2,10735,5583,147,13
102100,011390,174500,2,8500,5.12,92.46,29323,27113,-2210,984,954,-30,60586,174500,174500,174500,5,1,0,10802,5546,5,0
102100,011390,174500,2,8500,5.12,92.27,29385,27115,-2270,988,955,-33,60650,174500,174500,174500,69,5,1,10104,5650,67,2
102200,011390,174000,2,8000,4.82,92.17,29418,27115,-2303,992,955,-37,60683,174000,174000,174000,21,2,0,10116,5648,21,0
102200,011390,174000,2,8000,4.82,92.11,29439,27115,-2324,994,955,-39,60704,174000,174000,174000,42,4,0,10161,5633,42,0
102300,011390,174500,2,8500,5.12,92.15,29439,27129,-2310,994,956,-38,60718,174500,174500,174500,14,0,1,10180,5693,0,14
102300,011390,175000,2,9000,5.42,92.19,29439,27141,-2298,994,958,-36,60730,174500,175000,174500,26,0,3,10803,5632,0,26
102400,011390,175000,2,9000,5.42,92.98,29456,27389,-2067,996,961,-35,60995,175000,175000,175000,258,1,3,13631,5355,10,248
102400,011390,175000,2,9000,5.42,92.45,29626,27389,-2237,1004,961,-43,61165,175000,175000,175000,428,9,3,13699,5263,180,248
102500,011390,174500,2,8500,5.12,92.4,29647,27394,-2253,1007,962,-45,61191,175000,175000,174500,6,1,1,10573,5743,1,5
102500,011390,174500,2,8500,5.12,92.21,29707,27394,-2313,1008,962,-46,61251,175000,175000,174500,66,2,1,10645,5724,61,5
102600,011390,174500,2,8500,5.12,92.17,29722,27394,-2328,1011,962,-49,61266,174500,174500,174500,13,2,0,10698,5704,13,0
102600,011390,174500,2,8500,5.12,92.11,29741,27394,-2347,1012,962,-50,61285,174500,174500,174500,32,3,0,10698,5702,32,0
102700,011390,174500,2,8500,5.12,91.92,29804,27395,-2409,1013,963,-50,61349,175000,175000,174500,64,1,1,10730,5687,63,1
102700,011390,174500,2,8500,5.12,91.83,29833,27395,-2438,1015,963,-52,61378,175000,175000,174500,93,3,1,10721,5619,92,1
102800,011390,174500,2,8500,5.12,91.88,29833,27412,-2421,1015,965,-50,61395,174500,174500,174500,17,0,2,10136,5738,0,17
102900,011390,174500,2,8500,5.12,91.8,29862,27412,-2450,1016,965,-51,61424,174500,174500,174500,0,0,0,10861,5692,0,0
102900,011390,174500,2,8500,5.12,91.96,29862,27462,-2400,1016,966,-50,61474,174500,174500,174500,50,0,1,10210,5782,0,50
103000,011390,175000,2,9000,5.42,92.15,29862,27517,-2345,1016,969,-47,61529,175000,175000,175000,5,0,1,10892,5820,0,5
103000,011390,175000,2,9000,5.42,92.22,29862,27538,-2324,1016,972,-44,61550,175000,175000,175000,26,0,4,10916,5851,0,26
103100,011390,175000,2,9000,5.42,92.22,29862,27538,-2324,1016,972,-44,61550,175000,175000,175000,0,0,0,10916,5851,0,0
103100,011390,175000,2,9000,5.42,91.7,30052,27559,-2493,1018,975,-43,61761,175000,175000,174000,211,2,3,10936,5551,190,21
103200,011390,175000,2,9000,5.42,91.7,30052,27559,-2493,1018,975,-43,61761,175000,175000,175000,0,0,0,10936,5551,0,0
103200,011390,174000,2,8000,4.82,91.52,30169,27612,-2557,1023,978,-45,61931,174500,174500,174000,170,5,3,10414,5677,117,53
103300,011390,174000,2,8000,4.82,91.54,30169,27617,-2552,1023,980,-43,61936,174000,174000,174000,3,0,1,9406,6324,0,3
103300,011390,174500,2,8500,5.12,91.54,30169,27618,-2551,1023,981,-42,61937,174000,174500,174000,4,0,2,10476,5681,0,4
103400,011390,174000,2,8000,4.82,91.53,30175,27618,-2557,1025,981,-44,61943,174000,174000,174000,5,1,0,10491,5699,5,0
103400,011390,174000,2,8000,4.82,91.49,30187,27618,-2569,1026,981,-45,61955,174000,174000,174000,17,2,0,10510,5743,17,0
103500,011390,173500,2,7500,4.52,91.47,30192,27618,-2574,1030,981,-49,61960,173500,173500,173500,1,1,0,9516,6415,1,0
103500,011390,173500,2,7500,4.52,91.22,30277,27618,-2659,1032,981,-51,62045,173500,173500,173500,86,3,0,9633,6321,86,0
103600,011390,173500,2,7500,4.52,89.59,30839,27630,-3209,1034,983,-51,62619,173500,173500,173500,12,0,2,8342,5751,0,12
103600,011390,173000,2,7000,4.22,89.33,30933,27633,-3300,1037,986,-51,62716,173500,173500,173000,109,3,5,8382,5568,94,15
103700,011390,173500,2,7500,4.52,89.33,30936,27634,-3302,1038,987,-51,62720,173500,173500,173500,0,0,0,8255,5555,0,0
103700,011390,173000,2,7000,4.22,88.92,31257,27794,-3463,1041,991,-50,63201,173500,173500,173000,481,3,4,6781,5770,321,160
103800,011390,173000,2,7000,4.22,88.68,31366,27816,-3550,1044,992,-52,63332,173000,173000,173000,69,1,0,9091,5604,69,0
103800,011390,173500,2,7500,4.52,88.69,31366,27819,-3547,1044,993,-51,63335,173000,173500,173000,72,1,1,8368,5594,69,3
103900,011390,173500,2,7500,4.52,88.69,31366,27819,-3547,1044,993,-51,63335,173500,173500,173500,0,0,0,8368,5594,0,0
103900,011390,173500,2,7500,4.52,88.67,31378,27824,-3554,1045,994,-51,63352,173000,173500,173000,17,1,1,8453,5637,12,5
104000,011390,173500,2,7500,4.52,88.71,31378,27834,-3544,1045,995,-50,63362,173500,173500,173500,10,0,1,8469,6548,0,10
104000,011390,174000,2,8000,4.82,88.71,31378,27836,-3542,1045,996,-49,63364,173500,174000,173500,12,0,2,9222,6585,0,12
104100,011390,174000,2,8000,4.82,88.71,31378,27836,-3542,1045,996,-49,63364,174000,174000,174000,0,0,0,9222,6585,0,0
104100,011390,174000,2,8000,4.82,88.71,31378,27836,-3542,1045,996,-49,63364,174000,174000,174000,0,0,0,9222,6585,0,0
104200,011390,173000,2,7000,4.22,87.32,31879,27836,-4043,1048,996,-52,63865,173500,173500,173000,500,2,0,9239,6680,500,0
104200,011390,174000,2,8000,4.82,87.28,31895,27837,-4058,1049,997,-52,63882,173500,174000,173000,517,3,1,9223,6583,516,1
104300,011390,173500,2,7500,4.52,87.35,31902,27865,-4037,1052,998,-54,63917,173000,173500,173000,35,3,1,8612,6742,7,28
104300,011390,173500,2,7500,4.52,87.44,31902,27896,-4006,1052,1001,-51,63948,173000,173500,173000,66,3,4,8574,6745,7,59
104400,011390,173500,2,7500,4.52,87.03,32055,27896,-4159,1054,1001,-53,64101,173500,173500,173500,153,2,0,9234,6825,153,0
104400,011390,173500,2,7500,4.52,87.03,32055,27896,-4159,1054,1001,-53,64101,173500,173500,173500,153,2,0,9234,6825,153,0
104500,011390,173000,2,7000,4.22,85.14,32764,27896,-4868,1057,1001,-56,64810,173000,173000,173000,709,3,0,8650,6615,709,0
104500,011390,173000,2,7000,4.22,85.14,32764,27896,-4868,1057,1001,-56,64810,173000,173000,173000,709,3,0,8650,6615,709,0
104600,011390,172500,2,6500,3.92,82.99,33666,27939,-5727,1059,1004,-55,65755,172500,172500,172500,43,0,3,5539,5588,0,43
104600,011390,172500,2,6500,3.92,83.31,33666,28048,-5618,1059,1011,-48,65864,172500,172500,172500,152,0,10,5589,5647,0,152
104700,011390,172500,2,6500,3.92,84.09,33767,28396,-5371,1062,1013,-49,66313,172500,173000,172500,449,3,2,8293,5694,101,348
104800,011390,172500,2,6500,3.92,84.03,33791,28396,-5395,1065,1013,-52,66337,173000,173000,172500,22,2,0,8366,5457,22,0
104800,011390,172000,2,6000,3.61,83.61,33964,28396,-5568,1069,1013,-56,66510,173000,173000,172000,195,6,0,8188,5651,195,0
104900,011390,172000,2,6000,3.61,83.61,33964,28396,-5568,1069,1013,-56,66510,172000,172000,172000,0,0,0,8188,5651,0,0
104900,011390,172500,2,6500,3.92,83.13,34165,28402,-5763,1072,1014,-58,66717,172000,172500,172000,207,3,1,5394,5539,201,6
105000,011390,172500,2,6500,3.92,83.07,34190,28402,-5788,1074,1014,-60,66742,172500,172500,172500,0,0,0,6746,5566,0,0
105000,011390,172500,2,6500,3.92,83.13,34250,28471,-5779,1077,1019,-58,66871,172500,172500,172500,129,3,5,5426,5698,60,69
105100,011390,172500,2,6500,3.92,82.11,34702,28493,-6209,1080,1022,-58,67345,172500,172500,172500,10,0,1,5457,5353,0,10
105100,011390,172500,2,6500,3.92,82.1,34747,28527,-6220,1082,1026,-56,67424,172500,172500,172500,89,2,5,5421,5374,45,44
105200,011390,172500,2,6500,3.92,82.1,34747,28527,-6220,1082,1026,-56,67424,172500,172500,172500,0,0,0,5421,5374,0,0
105200,011390,172500,2,6500,3.92,82.1,34747,28527,-6220,1082,1026,-56,67424,172500,172500,172500,0,0,0,5421,5374,0,0
105300,011390,172500,2,6500,3.92,82.1,34748,28527,-6221,1083,1026,-57,67425,172500,172500,172500,0,0,0,6886,5439,0,0
105300,011390,172500,2,6500,3.92,82.05,34766,28527,-6239,1084,1026,-58,67443,172500,172500,172500,18,1,0,6896,5525,18,0
105400,011390,173000,2,7000,4.22,82.09,34766,28538,-6228,1084,1028,-56,67454,173000,173000,173000,0,0,0,6895,5574,0,0
105400,011390,173000,2,7000,4.22,82.26,34766,28598,-6168,1084,1030,-54,67542,173000,173000,173000,88,0,2,8326,5883,0,60
105500,011390,173000,2,7000,4.22,82.25,34771,28599,-6172,1085,1031,-54,67548,173000,173000,173000,1,0,1,6825,5906,0,1
105500,011390,173500,2,7500,4.52,82.34,34781,28637,-6144,1086,1034,-52,67596,173000,173500,173000,49,1,4,8444,5570,10,39
105600,011390,173500,2,7500,4.52,82.34,34781,28637,-6144,1086,1034,-52,67596,173500,173500,173500,0,0,0,8444,5570,0,0
105600,011390,173500,2,7500,4.52,82.34,34781,28640,-6141,1086,1035,-51,67599,173500,173500,173500,3,0,1,8397,6107,0,3
105700,011390,173500,2,7500,4.52,82.77,34782,28788,-5994,1087,1037,-50,67748,173500,173500,173500,0,0,0,8950,5926,0,0
105700,011390,174000,2,8000,4.82,83.13,34782,28913,-5869,1087,1040,-47,67873,174000,174000,174000,125,0,3,8863,5887,0,125
105800,011390,174000,2,8000,4.82,83.16,34782,28925,-5857,1087,1041,-46,67885,174000,174000,174000,12,0,1,8945,6031,0,12
105800,011390,174000,2,8000,4.82,83.16,34782,28925,-5857,1087,1041,-46,67885,174000,174000,174000,12,0,1,8945,6031,0,12
105900,011390,174000,2,8000,4.82,83.17,34782,28927,-5855,1087,1042,-45,67887,174000,174000,174000,2,0,1,8938,6053,0,2
105900,011390,174000,2,8000,4.82,83.42,34850,29071,-5779,1088,1044,-44,68099,174000,174000,174000,214,1,3,9943,5565,68,146
110000,011390,174500,2,8500,5.12,83.42,34860,29081,-5779,1089,1045,-44,68119,174500,174500,174500,10,0,1,9949,6149,0,10
110000,011390,174500,2,8500,5.12,83.44,34860,29086,-5774,1089,1046,-43,68124,174500,174500,174500,15,0,2,10010,6168,0,15
110100,011390,174500,2,8500,5.12,83.46,34860,29093,-5767,1089,1047,-42,68131,174500,174500,174500,7,0,1,9951,5676,0,7
110100,011390,173500,2,7500,4.52,83.33,34911,29093,-5818,1092,1047,-45,68182,174500,174500,173500,58,3,1,10085,6296,51,7
110200,011390,174000,2,8000,4.82,83.35,34912,29098,-5814,1093,1048,-45,68188,174000,174000,174000,5,0,1,9047,6319,0,5
110200,011390,174000,2,8000,4.82,83.35,34914,29100,-5814,1095,1050,-45,68192,174000,174500,174000,9,2,3,10127,5731,2,7
110300,011390,174500,2,8500,5.12,83.52,34914,29161,-5753,1095,1054,-41,68253,174500,174500,174500,61,0,4,10078,5724,0,61
110300,011390,174500,2,8500,5.12,83.51,34919,29162,-5757,1096,1055,-41,68259,174500,174500,174000,67,1,5,10129,6359,5,62
110400,011390,174500,2,8500,5.12,83.51,34919,29162,-5757,1096,1055,-41,68259,174500,174500,174500,0,0,0,10129,6359,0,0
110400,011390,174000,2,8000,4.82,83.62,34919,29200,-5719,1096,1058,-38,68297,174000,174000,174000,38,0,3,9152,6298,0,38
110500,011390,173500,2,7500,4.52,83.65,34929,29218,-5711,1098,1060,-38,68325,174000,174000,173500,28,2,2,10148,5696,10,18
110600,011390,173500,2,7500,4.52,83.65,34929,29218,-5711,1098,1060,-38,68325,173500,173500,173500,0,0,0,10148,5696,0,0
110600,011390,174000,2,8000,4.82,83.79,34929,29267,-5662,1098,1061,-37,68374,174000,174000,174000,49,0,1,9174,6302,0,49
110700,011390,173500,2,7500,4.52,83.78,34949,29281,-5668,1099,1063,-36,68408,173500,173500,173500,0,0,0,9117,6250,0,0
110700,011390,173500,2,7500,4.52,83.78,34949,29281,-5668,1099,1063,-36,68408,173500,173500,173500,0,0,0,9117,6250,0,0
110800,011390,173500,2,7500,4.52,83.42,35099,29281,-5818,1100,1063,-37,68558,173500,173500,173500,0,0,0,9128,6219,0,0
110800,011390,173500,2,7500,4.52,83.42,35099,29281,-5818,1100,1063,-37,68558,173500,173500,173500,0,0,0,9128,6219,0,0
110900,011390,173500,2,7500,4.52,83.36,35127,29282,-5845,1101,1064,-37,68587,173500,173500,173500,0,0,0,8420,6398,0,0
110900,011390,174000,2,8000,4.82,83.36,35127,29283,-5844,1101,1065,-36,68588,174000,174000,174000,1,0,1,9155,6522,0,1
111000,011390,174000,2,8000,4.82,83.36,35127,29283,-5844,1101,1065,-36,68588,174000,174000,174000,0,0,0,9155,6522,0,0
111000,011390,173000,2,7000,4.22,82.82,35358,29283,-6075,1103,1065,-38,68819,173000,173000,173000,231,2,0,9246,6508,231,0
111100,011390,173000,2,7000,4.22,82.81,35363,29283,-6080,1104,1065,-39,68824,173000,173000,173000,0,0,0,9246,6251,0,0
111100,011390,173000,2,7000,4.22,82.81,35363,29283,-6080,1104,1065,-39,68824,173000,173000,173000,0,0,0,9246,6251,0,0
111200,011390,173000,2,7000,4.22,82.81,35363,29283,-6080,1104,1065,-39,68824,173000,173000,173000,0,0,0,9286,6312,0,0
111200,011390,173000,2,7000,4.22,81.75,35898,29348,-6550,1105,1067,-38,69424,173000,173000,173000,600,1,2,6585,6138,535,65
111300,011390,173000,2,7000,4.22,81.75,35898,29348,-6550,1105,1067,-38,69424,173000,173000,173000,0,0,0,6585,6138,0,0
111300,011390,173000,2,7000,4.22,81.75,35899,29348,-6551,1106,1067,-39,69425,173000,173000,173000,1,1,0,8087,5857,1,0
111400,011390,173000,2,7000,4.22,81.67,35934,29348,-6586,1108,1067,-41,69460,173000,173000,173000,35,2,0,8157,5841,35,0
111400,011390,172500,2,6500,3.92,81.67,35936,29348,-6588,1110,1067,-43,69462,173000,173000,172500,37,4,0,8181,6168,37,0
111500,011390,172500,2,6500,3.92,81.66,35940,29348,-6592,1112,1067,-45,69466,172500,172500,172500,4,2,0,6678,6260,4,0
111500,011390,172500,2,6500,3.92,81.66,35940,29348,-6592,1112,1067,-45,69466,172500,172500,172500,4,2,0,6678,6260,4,0
111600,011390,172500,2,6500,3.92,81.06,36206,29348,-6858,1115,1067,-48,69732,172500,172500,172500,256,2,0,6791,6140,256,0
111600,011390,172500,2,6500,3.92,81.05,36240,29374,-6866,1116,1068,-48,69792,172500,173000,172500,316,3,1,6769,6057,290,26
111700,011390,172500,2,6500,3.92,81.04,36249,29375,-6874,1117,1069,-48,69802,172500,172500,172500,9,1,0,6832,5979,9,0
111700,011390,172500,2,6500,3.92,80.98,36275,29375,-6900,1118,1069,-49,69828,172500,172500,172500,35,2,0,6828,6105,35,0
111800,011390,172500,2,6500,3.92,80.57,36460,29376,-7084,1120,1070,-50,70014,172500,172500,172500,2,1,0,6837,5942,2,0
111800,011390,172500,2,6500,3.92,79.48,36960,29376,-7584,1121,1070,-51,70514,172500,172500,172500,502,2,0,6837,6450,502,0
111900,011390,172500,2,6500,3.92,79.46,36971,29376,-7595,1122,1070,-52,70525,172500,172500,172500,0,0,0,6855,5965,0,0
111900,011390,172000,2,6000,3.61,77.52,38103,29539,-8564,1125,1073,-52,71820,172000,172000,171500,1295,3,3,5532,5162,1132,163
112000,011390,172000,2,6000,3.61,77.42,38154,29539,-8615,1127,1073,-54,71871,172000,172000,172000,50,1,0,6837,5113,50,0
112000,011390,172000,2,6000,3.61,77.3,38214,29539,-8675,1128,1073,-55,71931,172000,172000,172000,110,2,0,6892,5147,110,0
112100,011390,172000,2,6000,3.61,77.28,38224,29539,-8685,1129,1073,-56,71941,172000,172000,172000,10,1,0,5555,5515,10,0
112100,011390,172000,2,6000,3.61,77.34,38231,29568,-8663,1131,1074,-57,71977,172000,172500,172000,46,3,1,7009,5562,17,29
112200,011390,172500,2,6500,3.92,77.29,38262,29574,-8688,1133,1075,-58,72014,172000,172500,172000,37,2,1,6307,5634,31,6
112200,011390,172000,2,6000,3.61,77.03,38393,29574,-8819,1137,1075,-62,72145,172000,172500,172000,168,6,1,7677,5572,162,6
112300,011390,172000,2,6000,3.61,77.02,38398,29574,-8824,1139,1075,-64,72150,172000,172000,172000,5,2,0,7679,5812,5,0
112300,011390,172000,2,6000,3.61,77.04,38401,29586,-8815,1141,1077,-64,72165,172000,172500,172000,20,4,2,6708,5725,8,12
112400,011390,172500,2,6500,3.92,77.05,38401,29587,-8814,1141,1078,-63,72166,172500,172500,172500,1,0,1,6720,5730,0,1
112500,011390,172500,2,6500,3.92,77.06,38401,29591,-8810,1141,1080,-61,72170,172500,172500,172500,0,0,0,6821,5794,0,0
112500,011390,172000,2,6000,3.61,76.64,38611,29591,-9020,1143,1080,-63,72380,172000,172000,172000,210,2,0,6851,5684,210,0
112600,011390,172000,2,6000,3.61,76.6,38632,29591,-9041,1145,1080,-65,72401,172000,172000,172000,1,1,0,6821,5534,1,0
112600,011390,172500,2,6500,3.92,76.86,38632,29691,-8941,1145,1081,-64,72501,172000,172500,172000,101,1,1,6823,5520,1,100
112700,011390,172500,2,6500,3.92,77.15,38632,29803,-8829,1145,1084,-61,72613,172500,172500,172500,0,0,0,6593,5520,0,0
112700,011390,172500,2,6500,3.92,77.15,38632,29803,-8829,1145,1084,-61,72613,172500,172500,172500,0,0,0,6593,5520,0,0
112800,011390,172500,2,6500,3.92,77.15,38632,29803,-8829,1145,1084,-61,72613,172500,172500,172500,0,0,0,6612,5535,0,0
112800,011390,172500,2,6500,3.92,77.27,38633,29852,-8781,1146,1086,-60,72663,172500,172500,172000,50,1,2,6523,5511,1,49
112900,011390,172000,2,6000,3.61,77.27,38634,29852,-8782,1147,1086,-61,72664,172000,172000,172000,0,0,0,6524,5513,0,0
112900,011390,172000,2,6000,3.61,77.26,38639,29852,-8787,1148,1086,-62,72669,172000,172000,172000,5,1,0,6523,5532,5,0
113000,011390,172500,2,6500,3.92,77.26,38639,29853,-8786,1148,1087,-61,72670,172500,172500,172500,0,0,0,6531,5505,0,0
113000,011390,172500,2,6500,3.92,77.34,38666,29903,-8763,1149,1088,-61,72747,172000,172500,172000,77,1,1,6510,5391,27,50
113100,011390,172000,2,6000,3.61,77.33,38670,29903,-8767,1150,1088,-62,72751,172000,172000,172000,0,0,0,6460,5401,0,0
113100,011390,172500,2,6500,3.92,77.38,38670,29922,-8748,1150,1090,-60,72770,172500,172500,172500,19,0,2,6452,5575,0,19
113200,011390,172500,2,6500,3.92,77.53,38670,29982,-8688,1150,1092,-58,72830,172500,172500,172500,60,0,2,6425,5613,0,60
113200,011390,172500,2,6500,3.92,77.53,38670,29982,-8688,1150,1092,-58,72830,172500,172500,172500,60,0,2,6425,5613,0,60
113300,011390,173000,2,7000,4.22,77.54,38670,29985,-8685,1150,1093,-57,72833,173000,173000,173000,3,0,1,7797,6177,0,3
113300,011390,172500,2,6500,3.92,77.54,38671,29985,-8686,1151,1093,-58,72834,173000,173000,172500,4,1,1,7783,6177,1,3
113400,011390,173000,2,7000,4.22,77.54,38671,29986,-8685,1151,1094,-57,72835,173000,173000,173000,1,0,1,7804,6187,0,1
113400,011390,173000,2,7000,4.22,77.54,38671,29986,-8685,1151,1094,-57,72835,173000,173000,173000,1,0,1,7804,6187,0,1
113500,011390,172500,2,6500,3.92,77.5,38690,29986,-8704,1154,1094,-60,72854,172500,172500,172500,19,3,0,7844,6176,19,0
113500,011390,172500,2,6500,3.92,77.5,38690,29986,-8704,1154,1094,-60,72854,172500,172500,172500,19,3,0,7844,6176,19,0
113600,011390,173000,2,7000,4.22,77.52,38690,29992,-8698,1154,1095,-59,72860,173000,173000,173000,0,0,0,7845,6182,0,0
113600,011390,173000,2,7000,4.22,77.52,38690,29992,-8698,1154,1095,-59,72860,173000,173000,173000,0,0,0,7845,6182,0,0
113700,011390,172500,2,6500,3.92,77.51,38693,29992,-8701,1155,1095,-60,72863,172500,172500,172500,0,0,0,7814,6185,0,0
113700,011390,173000,2,7000,4.22,77.72,38693,30073,-8620,1155,1096,-59,72944,173000,173000,173000,81,0,1,7794,6145,0,81
113800,011390,173000,2,7000,4.22,77.72,38693,30073,-8620,1155,1096,-59,72944,173000,173000,173000,0,0,0,7794,6145,0,0
113800,011390,173000,2,7000,4.22,77.72,38693,30073,-8620,1155,1096,-59,72944,173000,173000,173000,0,0,0,7794,6145,0,0
113900,011390,173000,2,7000,4.22,77.72,38693,30073,-8620,1155,1096,-59,72944,173000,173000,173000,0,0,0,7691,6145,0,0
113900,011390,173000,2,7000,4.22,77.72,38693,30073,-8620,1155,1096,-59,72944,173000,173000,173000,0,0,0,7721,6162,0,0
114000,011390,173000,2,7000,4.22,77.78,38693,30097,-8596,1155,1098,-57,72968,173000,173000,173000,24,0,2,7965,6386,0,24
114000,011390,173000,2,7000,4.22,77.89,38693,30137,-8556,1155,1102,-53,73008,173000,173000,173000,64,0,6,8003,6390,0,64
114100,011390,173000,2,7000,4.22,77.89,38693,30139,-8554,1155,1103,-52,73010,173000,173000,173000,0,0,0,8002,6388,0,0
114100,011390,173000,2,7000,4.22,77.89,38693,30139,-8554,1155,1103,-52,73010,173000,173000,173000,0,0,0,8002,6388,0,0
114200,011390,173000,2,7000,4.22,77.89,38693,30139,-8554,1155,1103,-52,73010,173000,173000,173000,0,0,0,7950,6436,0,0
114300,011390,172500,2,6500,3.92,77.87,38706,30139,-8567,1157,1103,-54,73023,172500,172500,172500,0,0,0,7863,6433,0,0
114300,011390,172500,2,6500,3.92,77.87,38706,30139,-8567,1157,1103,-54,73023,172500,172500,172500,0,0,0,7863,6433,0,0
114400,011390,172500,2,6500,3.92,77.87,38706,30139,-8567,1157,1103,-54,73023,172500,172500,172500,0,0,0,7843,6427,0,0
114400,011390,172500,2,6500,3.92,77.87,38706,30139,-8567,1157,1103,-54,73023,172500,172500,172500,0,0,0,8043,6408,0,0
114500,011390,172500,2,6500,3.92,77.87,38706,30139,-8567,1157,1103,-54,73023,172500,172500,172500,0,0,0,8039,6406,0,0
114500,011390,173000,2,7000,4.22,78.02,38706,30199,-8507,1157,1105,-52,73083,173000,173000,173000,60,0,2,7996,6415,0,60
114600,011390,173000,2,7000,4.22,78.02,38706,30199,-8507,1157,1105,-52,73083,173000,173000,173000,0,0,0,7996,6415,0,0
114600,011390,172500,2,6500,3.92,78.0,38715,30199,-8516,1159,1105,-54,73092,172500,172500,172500,9,2,0,7995,6426,9,0
114700,011390,172500,2,6500,3.92,78.0,38715,30199,-8516,1159,1105,-54,73092,172500,172500,172500,0,0,0,7995,6426,0,0
114700,011390,172500,2,6500,3.92,77.98,38725,30199,-8526,1160,1105,-55,73102,172500,172500,172500,10,1,0,8035,6370,10,0
114800,011390,172500,2,6500,3.92,77.98,38726,30199,-8527,1161,1105,-56,73103,172500,172500,172500,0,0,0,8065,6360,0,0
114800,011390,172500,2,6500,3.92,77.98,38726,30199,-8527,1161,1105,-56,73103,172500,172500,172500,0,0,0,8065,6360,0,0
114900,011390,172500,2,6500,3.92,77.98,38726,30199,-8527,1161,1105,-56,73103,172500,172500,172500,0,0,0,8075,6360,0,0
114900,011390,172500,2,6500,3.92,77.98,38726,30199,-8527,1161,1105,-56,73103,172500,172500,172500,0,0,0,8090,6360,0,0
115000,011390,172500,2,6500,3.92,77.98,38727,30199,-8528,1162,1105,-57,73104,172500,172500,172500,0,0,0,8093,6460,0,0
115000,011390,173000,2,7000,4.22,77.94,38747,30200,-8547,1163,1106,-57,73125,172500,173000,172500,21,1,1,8130,6450,20,1
115100,011390,173000,2,7000,4.22,77.94,38747,30200,-8547,1163,1106,-57,73125,173000,173000,173000,0,0,0,8130,6450,0,0
115100,011390,173000,2,7000,4.22,77.94,38747,30201,-8546,1163,1107,-56,73126,173000,173000,173000,1,0,1,8134,6450,0,1
115200,011390,173000,2,7000,4.22,77.94,38747,30201,-8546,1163,1107,-56,73126,173000,173000,173000,0,0,0,8134,6450,0,0
115200,011390,173000,2,7000,4.22,77.89,38777,30204,-8573,1164,1110,-54,73159,173000,173000,172500,33,1,3,8132,6422,30,3
115300,011390,173000,2,7000,4.22,77.89,38777,30204,-8573,1164,1110,-54,73159,173000,173000,173000,0,0,0,8132,6422,0,0
115300,011390,172500,2,6500,3.92,77.89,38780,30204,-8576,1165,1110,-55,73162,172500,172500,172500,3,1,0,8239,6419,3,0
115400,011390,172500,2,6500,3.92,77.8,38823,30204,-8619,1168,1110,-58,73205,172500,172500,172500,22,2,0,8262,6199,22,0
115400,011390,173000,2,7000,4.22,77.81,38823,30209,-8614,1168,1111,-57,73210,172500,173000,172500,27,2,1,8263,6222,22,5
115500,011390,173000,2,7000,4.22,77.81,38823,30209,-8614,1168,1111,-57,73210,173000,173000,173000,0,0,0,8263,6222,0,0
115500,011390,173000,2,7000,4.22,77.7,38878,30210,-8668,1169,1112,-57,73266,172500,173000,172500,56,1,1,8260,6171,55,1
115600,011390,173000,2,7000,4.22,77.7,38878,30210,-8668,1169,1112,-57,73266,173000,173000,173000,0,0,0,8260,6171,0,0
115600,011390,172500,2,6500,3.92,77.66,38898,30210,-8688,1170,1112,-58,73286,172500,172500,172500,20,1,0,8260,6230,20,0
115700,011390,172500,2,6500,3.92,77.6,38931,30210,-8721,1172,1112,-60,73319,172500,172500,172500,33,2,0,8213,6207,33,0
115700,011390,172500,2,6500,3.92,77.6,38932,30210,-8722,1173,1112,-61,73320,172500,172500,172500,34,3,0,8213,6177,34,0
115800,011390,173000,2,7000,4.22,77.61,38932,30215,-8717,1173,1113,-60,73325,173000,173000,173000,5,0,1,8192,6202,0,5
115800,011390,173000,2,7000,4.22,77.61,38932,30215,-8717,1173,1113,-60,73325,173000,173000,173000,5,0,1,8192,6202,0,5
115900,011390,172500,2,6500,3.92,77.64,39035,30305,-8730,1174,1114,-60,73518,173000,173000,172500,193,1,1,8148,6218,103,90
120000,011390,173000,2,7000,4.22,77.64,39035,30306,-8729,1174,1115,-59,73519,173000,173000,173000,0,0,0,8148,6122,0,0
120000,011390,173000,2,7000,4.22,77.64,39035,30307,-8728,1174,1116,-58,73520,173000,173000,173000,1,0,1,8147,6122,0,1
120100,011390,173000,2,7000,4.22,77.66,39035,30314,-8721,1174,1117,-57,73527,173000,173000,173000,0,0,0,8147,6208,0,0
120100,011390,173000,2,7000,4.22,77.66,39035,30314,-8721,1174,1117,-57,73527,173000,173000,173000,0,0,0,8147,6208,0,0
120200,011390,172500,2,6500,3.92,77.48,39126,30315,-8811,1176,1118,-58,73619,172500,172500,172500,0,0,0,8132,6125,0,0
120200,011390,172500,2,6500,3.92,77.45,39140,30315,-8825,1177,1118,-59,73633,172500,172500,172500,14,1,0,8151,6199,14,0
120300,011390,172500,2,6500,3.92,77.43,39150,30315,-8835,1178,1118,-60,73643,172500,172500,172500,0,0,0,8151,6174,0,0
120300,011390,172500,2,6500,3.92,77.42,39159,30315,-8844,1180,1118,-62,73652,172500,172500,172500,9,2,0,8151,6087,9,0
120400,011390,172500,2,6500,3.92,77.42,39159,30315,-8844,1180,1118,-62,73652,172500,172500,172500,0,0,0,8151,6087,0,0
120400,011390,172500,2,6500,3.92,77.35,39193,30316,-8877,1182,1119,-63,73687,173000,173000,172500,35,2,1,8171,6168,34,1
120500,011390,173000,2,7000,4.22,77.38,39194,30330,-8864,1183,1121,-62,73702,173000,173000,173000,0,0,0,7920,6143,0,0
120500,011390,173000,2,7000,4.22,77.39,39194,30331,-8863,1183,1122,-61,73703,173000,173000,173000,1,0,1,7917,6163,0,1
120600,011390,172500,2,6500,3.92,77.37,39204,30333,-8871,1184,1123,-61,73715,172500,172500,172500,0,0,0,7914,6165,0,0
120600,011390,173000,2,7000,4.22,77.37,39204,30334,-8870,1184,1124,-60,73716,173000,173000,173000,1,0,1,7887,6148,0,1
120700,011390,172500,2,6500,3.92,77.32,39234,30334,-8900,1185,1124,-61,73746,172500,172500,172500,0,0,0,7887,6218,0,0
120700,011390,172500,2,6500,3.92,77.32,39234,30334,-8900,1185,1124,-61,73746,172500,172500,172500,0,0,0,7887,6218,0,0
120800,011390,172500,2,6500,3.92,77.32,39234,30334,-8900,1185,1124,-61,73746,172500,172500,172500,0,0,0,8000,6121,0,0
120800,011390,173000,2,7000,4.22,77.32,39234,30336,-8898,1185,1126,-59,73748,173000,173000,173000,2,0,2,7962,6141,0,2
120900,011390,173000,2,7000,4.22,77.32,39234,30336,-8898,1185,1126,-59,73748,173000,173000,173000,0,0,0,7962,6141,0,0
120900,011390,172500,2,6500,3.92,77.23,39280,30336,-8944,1186,1126,-60,73794,172500,172500,172500,46,1,0,8011,5974,46,0
121000,011390,173000,2,7000,4.22,77.24,39280,30338,-8942,1186,1127,-59,73796,173000,173000,173000,2,0,1,8011,5933,0,2
121000,011390,172500,2,6500,3.92,77.21,39292,30338,-8954,1188,1127,-61,73808,173000,173000,172500,14,2,1,7969,6114,12,2
121100,011390,172500,2,6500,3.92,77.21,39293,30338,-8955,1189,1127,-62,73809,172500,172500,172500,1,1,0,7971,6115,1,0
121100,011390,172500,2,6500,3.92,77.21,39293,30338,-8955,1189,1127,-62,73809,172500,172500,172500,1,1,0,7971,6115,1,0
121200,011390,172500,2,6500,3.92,77.21,39293,30338,-8955,1189,1127,-62,73809,172500,172500,172500,0,0,0,7971,6115,0,0
121200,011390,173000,2,7000,4.22,77.26,39293,30358,-8935,1189,1128,-61,73829,173000,173000,173000,20,0,1,7966,6122,0,20
121300,011390,173000,2,7000,4.22,77.26,39293,30358,-8935,1189,1128,-61,73829,173000,173000,173000,0,0,0,7966,6122,0,0
121300,011390,173000,2,7000,4.22,77.26,39293,30358,-8935,1189,1128,-61,73829,173000,173000,173000,0,0,0,7951,6122,0,0
121400,011390,173000,2,7000,4.22,77.26,39293,30358,-8935,1189,1128,-61,73829,173000,173000,173000,0,0,0,7942,6122,0,0
121400,011390,173000,2,7000,4.22,77.26,39293,30358,-8935,1189,1128,-61,73829,173000,173000,173000,0,0,0,7942,6119,0,0
121500,011390,173000,2,7000,4.22,77.21,39321,30359,-8962,1190,1129,-61,73858,172500,173000,172500,29,1,1,7973,6183,28,1
121500,011390,173000,2,7000,4.22,77.21,39321,30359,-8962,1190,1129,-61,73858,172500,173000,172500,29,1,1,7973,6183,28,1
121600,011390,173000,2,7000,4.22,77.21,39321,30359,-8962,1190,1129,-61,73858,173000,173000,173000,0,0,0,7973,6183,0,0
121600,011390,173000,2,7000,4.22,77.38,39321,30426,-8895,1190,1131,-59,73925,173000,173000,173000,67,0,2,8268,6136,0,67
121700,011390,172500,2,6500,3.92,77.41,39322,30440,-8882,1191,1132,-59,73940,173000,173000,172500,15,1,1,8188,6141,1,14
121800,011390,173000,2,7000,4.22,77.39,39338,30445,-8893,1192,1133,-59,73961,173000,173000,173000,5,0,1,8217,6124,0,5
121800,011390,173000,2,7000,4.22,77.4,39338,30447,-8891,1192,1135,-57,73963,173000,173000,173000,7,0,3,8218,6124,0,7
121900,011390,173000,2,7000,4.22,77.81,39338,30607,-8731,1192,1137,-55,74123,173000,173000,173000,10,0,1,7863,6203,0,10
121900,011390,173000,2,7000,4.22,78.36,39338,30825,-8513,1192,1141,-51,74341,173000,173000,173000,228,0,5,7807,6210,0,228
122000,011390,173000,2,7000,4.22,78.36,39339,30827,-8512,1193,1143,-50,74344,173000,173000,173000,0,0,0,7650,6174,0,0
122000,011390,173000,2,7000,4.22,78.41,39339,30845,-8494,1193,1145,-48,74362,173000,173000,173000,18,0,2,7864,6207,0,18
122100,011390,173500,2,7500,4.52,78.55,39339,30899,-8440,1193,1147,-46,74416,173500,173500,173500,0,0,0,9336,5827,0,0
122100,011390,173500,2,7500,4.52,78.55,39339,30899,-8440,1193,1147,-46,74416,173500,173500,173500,0,0,0,9336,5827,0,0
122200,011390,173500,2,7500,4.52,78.55,39339,30899,-8440,1193,1147,-46,74416,173500,173500,173500,0,0,0,9306,5749,0,0
122200,011390,173500,2,7500,4.52,78.55,39339,30899,-8440,1193,1147,-46,74416,173500,173500,173500,0,0,0,9316,5876,0,0
122300,011390,173500,2,7500,4.52,78.56,39339,30904,-8435,1193,1148,-45,74421,173500,173500,173500,0,0,0,9326,5729,0,0
122300,011390,173500,2,7500,4.52,78.93,39389,31090,-8299,1194,1150,-44,74657,173500,173500,173500,236,1,2,9179,5831,50,186
122400,011390,173500,2,7500,4.52,78.93,39389,31090,-8299,1194,1150,-44,74657,173500,173500,173500,0,0,0,9179,5831,0,0
122400,011390,173500,2,7500,4.52,78.93,39389,31091,-8298,1194,1151,-43,74658,173500,173500,173500,1,0,1,9217,5687,0,1
122500,011390,173500,2,7500,4.52,79.0,39389,31119,-8270,1194,1152,-42,74686,173500,173500,173500,0,0,0,9254,5838,0,0
122500,011390,173500,2,7500,4.52,79.01,39389,31120,-8269,1194,1153,-41,74687,173500,173500,173500,1,0,1,9280,5888,0,1
122600,011390,173000,2,7000,4.22,78.79,39501,31123,-8378,1195,1154,-41,74802,173500,173500,173000,115,1,1,9307,5891,112,3
122600,011390,173000,2,7000,4.22,78.78,39506,31123,-8383,1196,1154,-42,74807,173500,173500,173000,120,2,1,9307,5795,117,3
122700,011390,173000,2,7000,4.22,78.75,39521,31123,-8398,1197,1154,-43,74822,173000,173000,173000,15,1,0,9312,5831,15,0
122700,011390,173000,2,7000,4.22,78.66,39566,31124,-8442,1199,1155,-44,74868,173000,173000,173000,61,3,1,7740,6177,60,1
122800,011390,173000,2,7000,4.22,78.66,39566,31124,-8442,1199,1155,-44,74868,173000,173000,173000,0,0,0,7740,6177,0,0
122800,011390,173000,2,7000,4.22,78.81,39567,31184,-8383,1200,1158,-42,74929,173000,173000,172500,61,1,3,7894,6225,1,60
122900,011390,173000,2,7000,4.22,78.81,39567,31184,-8383,1200,1158,-42,74929,173000,173000,173000,0,0,0,7894,6225,0,0
122900,011390,173000,2,7000,4.22,78.82,39567,31188,-8379,1200,1159,-41,74933,173000,173000,173000,4,0,1,7881,6289,0,4
123000,011390,173000,2,7000,4.22,78.82,39567,31188,-8379,1200,1159,-41,74933,173000,173000,173000,0,0,0,7881,6289,0,0
123000,011390,172500,2,6500,3.92,78.58,39690,31188,-8502,1201,1159,-42,75056,172500,172500,172500,123,1,0,7877,6342,123,0
123100,011390,172500,2,6500,3.92,78.57,39697,31188,-8509,1202,1159,-43,75063,172500,172500,172500,7,1,0,7877,6220,7,0
123100,011390,172500,2,6500,3.92,78.54,39709,31188,-8521,1203,1159,-44,75075,172500,172500,172500,19,2,0,7865,6213,19,0
123200,011390,172500,2,6500,3.92,78.18,39895,31188,-8707,1207,1159,-48,75261,172500,172500,172500,186,4,0,7871,6689,186,0
123300,011390,172500,2,6500,3.92,78.18,39895,31188,-8707,1207,1159,-48,75261,172500,172500,172500,0,0,0,7871,6689,0,0
123300,011390,172500,2,6500,3.92,78.13,39918,31188,-8730,1209,1159,-50,75284,172500,172500,172500,23,2,0,7916,6012,23,0
123400,011390,172500,2,6500,3.92,78.13,39918,31188,-8730,1209,1159,-50,75284,172500,172500,172500,0,0,0,7916,6012,0,0
123400,011390,173000,2,7000,4.22,78.21,39918,31221,-8697,1209,1162,-47,75317,173000,173000,173000,33,0,3,7905,6003,0,33
123500,011390,173000,2,7000,4.22,78.22,39918,31222,-8696,1209,1163,-46,75318,173000,173000,173000,0,0,0,7889,5983,0,0
123500,011390,173000,2,7000,4.22,78.22,39918,31223,-8695,1209,1164,-45,75319,173000,173000,173000,1,0,1,7929,6012,0,1
123600,011390,173000,2,7000,4.22,78.22,39918,31223,-8695,1209,1164,-45,75319,173000,173000,173000,0,0,0,7929,6012,0,0
123600,011390,173000,2,7000,4.22,78.2,39931,31228,-8703,1211,1165,-46,75337,172500,173000,172500,18,2,1,7935,5996,13,5
123700,011390,173000,2,7000,4.22,78.2,39931,31228,-8703,1211,1165,-46,75337,173000,173000,173000,0,0,0,7935,5996,0,0
123700,011390,173000,2,7000,4.22,78.21,39931,31231,-8700,1211,1166,-45,75340,173000,173000,173000,3,0,1,8000,5998,0,3
123800,011390,173000,2,7000,4.22,78.21,39931,31231,-8700,1211,1166,-45,75340,173000,173000,173000,0,0,0,8000,5998,0,0
123900,011390,173000,2,7000,4.22,78.33,39931,31279,-8652,1211,1168,-43,75388,173000,173000,173000,0,0,0,7954,6054,0,0
123900,011390,173000,2,7000,4.22,78.33,39931,31279,-8652,1211,1168,-43,75388,173000,173000,173000,0,0,0,7954,6054,0,0
124000,011390,173000,2,7000,4.22,78.33,39931,31279,-8652,1211,1168,-43,75388,173000,173000,173000,0,0,0,7952,6202,0,0
124000,011390,173000,2,7000,4.22,78.34,39931,31280,-8651,1211,1169,-42,75389,173000,173000,173000,1,0,1,7952,6212,0,1
124100,011390,173000,2,7000,4.22,78.34,39931,31280,-8651,1211,1169,-42,75389,173000,173000,173000,0,0,0,7952,6212,0,0
124100,011390,173000,2,7000,4.22,78.34,39931,31280,-8651,1211,1169,-42,75389,173000,173000,173000,0,0,0,7952,6212,0,0
124200,011390,172500,2,6500,3.92,78.31,39945,31280,-8665,1212,1169,-43,75403,172500,172500,172500,0,0,0,8034,6487,0,0
124200,011390,172500,2,6500,3.92,78.25,39975,31280,-8695,1215,1169,-46,75433,172500,172500,172500,30,3,0,8014,6479,30,0
124300,011390,172500,2,6500,3.92,78.23,39985,31281,-8704,1216,1170,-46,75444,172500,172500,172500,10,1,0,8014,6345,10,0
124300,011390,172500,2,6500,3.92,78.23,39985,31281,-8704,1216,1170,-46,75444,172500,172500,172500,10,1,0,8014,6345,10,0
124400,011390,172500,2,6500,3.92,77.37,40429,31281,-9148,1217,1170,-47,75888,172500,172500,172500,444,1,0,8014,6335,444,0
124400,011390,172500,2,6500,3.92,76.99,40629,31281,-9348,1220,1170,-50,76088,172500,172500,172500,644,4,0,8062,5698,644,0
124500,011390,172500,2,6500,3.92,76.99,40629,31281,-9348,1220,1170,-50,76088,172500,172500,172500,0,0,0,8062,5698,0,0
124500,011390,172500,2,6500,3.92,76.8,40732,31281,-9451,1223,1170,-53,76191,172500,172500,172500,103,3,0,8079,5700,103,0
124600,011390,172500,2,6500,3.92,76.83,40732,31293,-9439,1223,1172,-51,76203,172500,172500,172500,12,0,2,6757,5805,0,12
124600,011390,172000,2,6000,3.61,76.82,40738,31293,-9445,1224,1172,-52,76209,172500,172500,172000,18,1,2,6762,5815,6,12
124700,011390,172500,2,6500,3.92,76.83,40739,31301,-9438,1225,1173,-52,76218,172000,172500,172000,9,1,1,6792,5823,1,8
124700,011390,172500,2,6500,3.92,76.66,40875,31333,-9542,1229,1176,-53,76386,172000,172500,172000,177,5,4,6798,6089,137,40
124800,011390,172500,2,6500,3.92,76.73,40880,31367,-9513,1230,1177,-53,76425,172500,172500,172500,39,1,1,8076,6091,5,34
124800,011390,172500,2,6500,3.92,76.68,40907,31367,-9540,1231,1177,-54,76452,172500,172500,172500,66,2,1,8076,6086,32,34
124900,011390,172500,2,6500,3.92,76.68,40907,31367,-9540,1231,1177,-54,76452,172500,172500,172500,0,0,0,6829,6099,0,0
125000,011390,172500,2,6500,3.92,76.68,40907,31368,-9539,1231,1178,-53,76453,172500,172500,172500,0,0,0,6868,6099,0,0
125000,011390,172500,2,6500,3.92,76.7,40907,31377,-9530,1231,1179,-52,76462,172500,172500,172500,9,0,1,6863,6101,0,9
125100,011390,172500,2,6500,3.92,76.9,40907,31456,-9451,1231,1182,-49,76541,172500,172500,172500,1,0,1,6787,6102,0,1
125100,011390,172500,2,6500,3.92,76.96,40907,31484,-9423,1231,1184,-47,76569,172500,172500,172500,29,0,3,6805,6102,0,29
125200,011390,172500,2,6500,3.92,76.96,40907,31484,-9423,1231,1184,-47,76569,172500,172500,172500,0,0,0,6805,6102,0,0
125200,011390,172500,2,6500,3.92,76.96,40907,31484,-9423,1231,1184,-47,76569,172500,172500,172500,0,0,0,8098,6060,0,0
125300,011390,173000,2,7000,4.22,77.01,40907,31504,-9403,1231,1185,-46,76589,173000,173000,173000,0,0,0,8105,6091,0,0
125300,011390,172500,2,6500,3.92,77.01,40908,31504,-9404,1232,1185,-47,76590,172500,172500,172500,1,1,0,8015,6147,1,0
125400,011390,173000,2,7000,4.22,77.13,40908,31554,-9354,1232,1186,-46,76640,173000,173000,173000,0,0,0,8015,6146,0,0
125400,011390,172500,2,6500,3.92,77.11,40923,31554,-9369,1234,1186,-48,76655,172500,172500,172500,15,2,0,8053,6143,15,0
125500,011390,172500,2,6500,3.92,77.11,40923,31554,-9369,1234,1186,-48,76655,172500,172500,172500,0,0,0,8053,6143,0,0
125500,011390,173000,2,7000,4.22,77.12,40923,31559,-9364,1234,1187,-47,76660,173000,173000,173000,5,0,1,8071,6092,0,5
125600,011390,172500,2,6500,3.92,77.13,40933,31572,-9361,1235,1188,-47,76683,173000,173000,172500,23,1,1,8053,6092,10,13
125600,011390,173000,2,7000,4.22,77.13,40933,31573,-9360,1235,1189,-46,76684,173000,173000,172500,24,1,2,8053,5981,10,14
125700,011390,173000,2,7000,4.22,77.14,40933,31574,-9359,1235,1190,-45,76685,173000,173000,173000,1,0,1,8036,5973,0,1
125700,011390,173000,2,7000,4.22,77.14,40933,31574,-9359,1235,1190,-45,76685,173000,173000,173000,1,0,1,8036,5973,0,1
125800,011390,172500,2,6500,3.92,77.13,40934,31574,-9360,1236,1190,-46,76686,172500,172500,172500,1,1,0,8176,6032,1,0
125800,011390,172500,2,6500,3.92,77.13,40934,31574,-9360,1236,1190,-46,76686,172500,172500,172500,1,1,0,8176,6032,1,0
125900,011390,172500,2,6500,3.92,77.13,40934,31574,-9360,1236,1190,-46,76686,172500,172500,172500,0,0,0,8176,6032,0,0
125900,011390,172500,2,6500,3.92,77.13,40935,31574,-9361,1237,1190,-47,76687,172500,172500,172500,1,1,0,8177,6303,1,0
130000,011390,173000,2,7000,4.22,77.16,40935,31585,-9350,1237,1192,-45,76698,173000,173000,173000,11,0,2,8225,6201,0,11
130000,011390,173000,2,7000,4.22,77.15,40940,31586,-9354,1238,1193,-45,76704,173000,173000,172500,17,1,3,8215,6197,5,12
130100,011390,172500,2,6500,3.92,77.15,40941,31586,-9355,1239,1193,-46,76705,172500,172500,172500,1,1,0,8217,6197,1,0
130200,011390,172500,2,6500,3.92,77.15,40942,31586,-9356,1240,1193,-47,76706,172500,172500,172500,0,0,0,8194,6196,0,0
130200,011390,172500,2,6500,3.92,77.05,40992,31586,-9406,1241,1193,-48,76756,172500,172500,172500,50,1,0,8198,6190,50,0
130300,011390,172500,2,6500,3.92,77.02,41009,31586,-9423,1242,1193,-49,76773,172500,172500,172500,17,1,0,8198,6228,17,0
130300,011390,173000,2,7000,4.22,77.4,41009,31743,-9266,1242,1196,-46,76930,172500,173000,172500,174,1,3,8082,6239,17,157
130400,011390,173500,2,7500,4.52,77.76,41009,31890,-9119,1242,1201,-41,77077,173500,173500,173500,1,0,1,9427,5857,0,1
130400,011390,173500,2,7500,4.52,77.77,41009,31891,-9118,1242,1202,-40,77078,173500,173500,173500,2,0,2,9426,5740,0,2
130500,011390,173500,2,7500,4.52,78.39,41009,32148,-8861,1242,1205,-37,77335,173500,173500,173500,0,0,0,9497,5818,0,0
130500,011390,173500,2,7500,4.52,78.49,41009,32189,-8820,1242,1207,-35,77376,173500,173500,173500,41,0,2,9404,5889,0,41
130600,011390,173000,2,7000,4.22,78.48,41017,32189,-8828,1243,1207,-36,77384,173000,173000,173000,0,0,0,9364,5889,0,0
130600,011390,173000,2,7000,4.22,78.48,41017,32189,-8828,1243,1207,-36,77384,173000,173000,173000,0,0,0,9364,5889,0,0
130700,011390,173000,2,7000,4.22,78.42,41047,32189,-8858,1244,1207,-37,77414,173000,173000,173000,30,1,0,9336,6043,30,0
130700,011390,173000,2,7000,4.22,78.42,41047,32189,-8858,1244,1207,-37,77414,173000,173000,173000,30,1,0,9336,6043,30,0
130800,011390,173000,2,7000,4.22,78.42,41047,32189,-8858,1244,1207,-37,77414,173000,173000,173000,0,0,0,9336,6043,0,0
130800,011390,173000,2,7000,4.22,78.42,41047,32189,-8858,1244,1207,-37,77414,173000,173000,173000,0,0,0,9323,5959,0,0
130900,011390,173000,2,7000,4.22,77.99,41272,32189,-9083,1248,1207,-41,77639,173000,173000,173000,53,1,0,9313,5840,53,0
130900,011390,173000,2,7000,4.22,77.99,41272,32189,-9083,1248,1207,-41,77639,173000,173000,173000,53,1,0,9313,5840,53,0
131000,011390,172500,2,6500,3.92,77.65,41472,32202,-9270,1251,1208,-43,77852,173000,173000,172500,113,1,1,7741,6006,100,13
131000,011390,172500,2,6500,3.92,77.46,41574,32202,-9372,1253,1208,-45,77954,173000,173000,172500,215,3,1,7753,6016,202,13
131100,011390,172500,2,6500,3.92,77.45,41578,32202,-9376,1255,1208,-47,77958,172500,172500,172500,4,2,0,7753,5964,4,0
131100,011390,172500,2,6500,3.92,77.02,41810,32202,-9608,1259,1208,-51,78190,172500,172500,172500,236,6,0,7828,5701,236,0
131200,011390,172500,2,6500,3.92,77.02,41811,32202,-9609,1260,1208,-52,78191,172500,172500,172500,1,1,0,7868,5882,1,0
131200,011390,172500,2,6500,3.92,76.81,41926,32202,-9724,1261,1208,-53,78306,172500,172500,172500,116,2,0,7868,5881,116,0
131300,011390,172500,2,6500,3.92,76.7,41986,32202,-9784,1263,1208,-55,78366,172500,172500,172500,60,2,0,7868,5761,60,0
131300,011390,172500,2,6500,3.92,76.65,42013,32202,-9811,1266,1208,-58,78393,172500,172500,172500,87,5,0,7819,5699,87,0
131400,011390,172500,2,6500,3.92,76.65,42013,32202,-9811,1266,1208,-58,78393,172500,172500,172500,0,0,0,7819,5699,0,0
131500,011390,172500,2,6500,3.92,76.65,42013,32202,-9811,1266,1208,-58,78393,172500,172500,172500,0,0,0,7949,5581,0,0
131500,011390,172500,2,6500,3.92,76.63,42020,32202,-9818,1268,1208,-60,78400,172500,172500,172500,7,2,0,8008,5565,7,0
131600,011390,173000,2,7000,4.22,76.64,42020,32203,-9817,1268,1209,-59,78401,173000,173000,173000,0,0,0,8008,5612,0,0
131600,011390,173000,2,7000,4.22,76.66,42020,32213,-9807,1268,1210,-58,78411,173000,173000,173000,10,0,1,8027,5612,0,10
131700,011390,173000,2,7000,4.22,76.67,42020,32215,-9805,1268,1211,-57,78413,173000,173000,173000,0,0,0,8017,5613,0,0
131700,011390,173000,2,7000,4.22,76.67,42020,32216,-9804,1268,1212,-56,78414,173000,173000,173000,1,0,1,7889,5613,0,1
131800,011390,173000,2,7000,4.22,76.67,42020,32216,-9804,1268,1212,-56,78414,173000,173000,173000,0,0,0,7889,5613,0,0
131800,011390,173000,2,7000,4.22,76.67,42020,32216,-9804,1268,1212,-56,78414,173000,173000,173000,0,0,0,7986,5613,0,0
131900,011390,172500,2,6500,3.92,76.58,42069,32216,-9853,1270,1212,-58,78463,172500,172500,172500,1,1,0,8125,5565,1,0
131900,011390,172500,2,6500,3.92,76.58,42069,32216,-9853,1270,1212,-58,78463,172500,172500,172500,1,1,0,8125,5565,1,0
132000,011390,172500,2,6500,3.92,76.57,42073,32216,-9857,1271,1212,-59,78467,172500,172500,172500,4,1,0,8030,5568,4,0
132000,011390,172000,2,6000,3.61,76.56,42078,32216,-9862,1272,1212,-60,78472,172500,172500,172000,9,2,0,6783,5683,9,0
132100,011390,172500,2,6500,3.92,76.56,42080,32217,-9863,1273,1213,-60,78475,172500,172500,172500,1,0,1,6826,5682,0,1
132100,011390,172500,2,6500,3.92,76.68,42080,32267,-9813,1273,1214,-59,78525,172500,172500,172500,51,0,2,6833,5679,0,51
132200,011390,172500,2,6500,3.92,76.68,42080,32267,-9813,1273,1214,-59,78525,172500,172500,172500,0,0,0,6833,5679,0,0
132200,011390,172500,2,6500,3.92,76.69,42080,32271,-9809,1273,1216,-57,78529,172500,172500,172500,4,0,2,6873,5714,0,4
132300,011390,172000,2,6000,3.61,76.58,42149,32276,-9873,1275,1217,-58,78603,172500,172500,172000,74,2,1,6868,5645,69,5
132400,011390,172000,2,6000,3.61,76.57,42154,32276,-9878,1276,1217,-59,78608,172000,172000,172000,0,0,0,6868,5659,0,0
132400,011390,172000,2,6000,3.61,76.57,42155,32276,-9879,1277,1217,-60,78609,172000,172000,172000,1,1,0,6863,5655,1,0
132500,011390,172000,2,6000,3.61,76.47,42208,32276,-9932,1280,1217,-63,78662,172000,172000,172000,0,0,0,6873,5394,0,0
132500,011390,172000,2,6000,3.61,76.46,42212,32276,-9936,1282,1217,-65,78666,172000,172000,172000,4,2,0,6873,5385,4,0
132600,011390,172000,2,6000,3.61,76.46,42212,32276,-9936,1282,1217,-65,78666,172000,172000,172000,0,0,0,6873,5385,0,0
132600,011390,172500,2,6500,3.92,76.56,42212,32317,-9895,1282,1219,-63,78707,172500,172500,172500,41,0,2,6873,5392,0,41
132700,011390,172000,2,6000,3.61,76.52,42240,32323,-9917,1283,1220,-63,78741,172000,172000,172000,28,1,0,6827,5393,28,0
132700,011390,172000,2,6000,3.61,76.52,42240,32323,-9917,1283,1220,-63,78741,172000,172000,172000,28,1,0,6827,5393,28,0
132800,011390,172500,2,6500,3.92,76.47,42269,32324,-9945,1285,1221,-64,78771,172000,172500,172000,21,1,1,6992,5342,20,1
132800,011390,172500,2,6500,3.92,76.47,42269,32324,-9945,1285,1221,-64,78771,172000,172500,172000,21,1,1,6992,5342,20,1
132900,011390,172500,2,6500,3.92,76.47,42269,32325,-9944,1285,1222,-63,78772,172500,172500,172500,1,0,1,7002,5347,0,1
132900,011390,172500,2,6500,3.92,76.48,42271,32330,-9941,1286,1223,-63,78779,172500,172500,172000,8,1,2,7046,5343,2,6
133000,011390,172000,2,6000,3.61,76.08,42494,32330,-10164,1290,1223,-67,79002,172000,172000,172000,223,4,0,7029,5187,223,0
133100,011390,172000,2,6000,3.61,75.23,42981,32334,-10647,1297,1227,-70,79493,172000,172000,172000,0,0,0,6070,4803,0,0
133100,011390,171500,2,5500,3.31,75.05,43082,32334,-10748,1301,1227,-74,79594,171500,171500,171500,101,4,0,6117,4806,101,0
133200,011390,172000,2,6000,3.61,75.06,43082,32339,-10743,1301,1228,-73,79599,172000,172000,172000,0,0,0,6027,4780,0,0
133200,011390,172000,2,6000,3.61,75.06,43082,32339,-10743,1301,1228,-73,79599,172000,172000,172000,0,0,0,6027,4780,0,0
133300,011390,172000,2,6000,3.61,75.11,43082,32360,-10722,1301,1230,-71,79620,172000,172000,172000,0,0,0,6071,4824,0,0
133300,011390,172000,2,6000,3.61,75.11,43082,32361,-10721,1301,1231,-70,79621,172000,172000,172000,1,0,1,6061,4814,0,1
133400,011390,172000,2,6000,3.61,75.11,43082,32361,-10721,1301,1231,-70,79621,172000,172000,172000,0,0,0,6061,4814,0,0
133400,011390,172000,2,6000,3.61,75.29,43082,32436,-10646,1301,1238,-63,79696,172000,172000,172000,75,0,7,5992,4785,0,75
133500,011390,172000,2,6000,3.61,75.34,43082,32456,-10626,1301,1239,-62,79716,172000,172000,172000,20,0,1,6002,4733,0,20
133500,011390,172000,2,6000,3.61,75.36,43082,32466,-10616,1301,1241,-60,79726,172000,172000,172000,30,0,3,5977,4733,0,30
133600,011390,172000,2,6000,3.61,75.48,43082,32520,-10562,1301,1247,-54,79780,172000,172000,172000,0,0,0,5971,4733,0,0
133600,011390,172000,2,6000,3.61,75.53,43082,32541,-10541,1301,1248,-53,79801,172000,172000,172000,21,0,1,6026,4732,0,21
133700,011390,172000,2,6000,3.61,75.57,43088,32560,-10528,1302,1249,-53,79826,172000,172000,172000,19,0,1,6086,4726,0,19
133700,011390,172000,2,6000,3.61,75.57,43088,32560,-10528,1302,1249,-53,79826,172000,172000,172000,19,0,1,6086,4726,0,19
133800,011390,172000,2,6000,3.61,75.57,43088,32560,-10528,1302,1249,-53,79826,172000,172000,172000,0,0,0,6086,4726,0,0
133800,011390,172000,2,6000,3.61,75.58,43088,32564,-10524,1302,1251,-51,79830,172000,172000,172000,4,0,2,6058,4770,0,4
133900,011390,172000,2,6000,3.61,75.63,43088,32589,-10499,1302,1253,-49,79855,172000,172000,172000,25,0,2,6060,4770,0,25
133900,011390,172000,2,6000,3.61,75.48,43192,32602,-10590,1305,1256,-49,79972,172000,172000,171500,142,3,5,6004,4636,104,38
134000,011390,172000,2,6000,3.61,75.41,43242,32607,-10635,1306,1259,-47,80027,171500,172000,171500,52,1,2,5954,4586,50,2
134000,011390,172000,2,6000,3.61,75.42,43242,32615,-10627,1306,1261,-45,80035,171500,172000,171500,60,1,4,5997,4591,50,10
134100,011390,171500,2,5500,3.31,75.32,43302,32615,-10687,1307,1261,-46,80095,171500,171500,171500,0,0,0,6046,4611,0,0
134100,011390,171500,2,5500,3.31,75.32,43302,32615,-10687,1307,1261,-46,80095,171500,171500,171500,0,0,0,6046,4611,0,0
134200,011390,171500,2,5500,3.31,75.11,43422,32615,-10807,1309,1261,-48,80215,171500,171500,171500,120,2,0,6048,4530,120,0
134200,011390,171500,2,5500,3.31,75.11,43422,32615,-10807,1309,1261,-48,80215,171500,171500,171500,120,2,0,6048,4530,120,0
134300,011390,171500,2,5500,3.31,75.03,43471,32616,-10855,1310,1262,-48,80265,172000,172000,171500,50,1,1,6196,4436,49,1
134300,011390,171500,2,5500,3.31,75.01,43480,32616,-10864,1311,1262,-49,80274,172000,172000,171500,59,2,1,6230,4387,58,1
134400,011390,171000,2,5000,3.01,73.71,44252,32616,-11636,1321,1262,-59,81046,171500,171500,171000,772,10,0,6171,3674,772,0
134500,011390,171000,2,5000,3.01,73.65,44290,32621,-11669,1324,1267,-57,81089,171000,171000,171000,0,0,0,6132,3694,0,0
134500,011390,171000,2,5000,3.01,73.65,44292,32621,-11671,1325,1267,-58,81091,171000,171000,171000,2,1,0,6132,3691,2,0
134600,011390,171000,2,5000,3.01,72.56,44959,32623,-12336,1327,1269,-58,81760,171000,171000,171000,0,0,0,4474,3162,0,0
134600,011390,171000,2,5000,3.01,72.87,44959,32763,-12196,1327,1277,-50,81900,171000,171000,171000,140,0,8,4497,3224,0,140
134700,011390,171000,2,5000,3.01,72.96,44971,32812,-12159,1330,1282,-48,81961,171000,171000,171000,30,0,1,4570,3225,0,30
134700,011390,171000,2,5000,3.01,73.2,44971,32921,-12050,1330,1286,-44,82070,171000,171000,171000,139,0,5,4438,3229,0,139
134800,011390,171000,2,5000,3.01,73.16,45002,32922,-12080,1334,1287,-47,82102,171000,171000,171000,0,0,0,6190,3127,0,0
134800,011390,171000,2,5000,3.01,73.09,45041,32922,-12119,1336,1287,-49,82141,171000,171000,171000,39,2,0,6190,3099,39,0
134900,011390,171000,2,5000,3.01,73.11,45041,32928,-12113,1336,1289,-47,82147,171000,171000,171000,5,0,1,4493,3291,0,5
134900,011390,171000,2,5000,3.01,73.12,45041,32932,-12109,1336,1290,-46,82151,171000,171000,171000,9,0,2,4504,3336,0,9
135000,011390,171000,2,5000,3.01,73.12,45046,32939,-12107,1337,1293,-44,82163,171000,171000,171000,2,0,1,4556,3331,0,2
135000,011390,171000,2,5000,3.01,73.13,45046,32941,-12105,1337,1294,-43,82165,171000,171000,171000,4,0,2,4550,3332,0,4
135100,011390,171000,2,5000,3.01,73.13,45046,32941,-12105,1337,1294,-43,82165,171000,171000,171000,0,0,0,4550,3332,0,0
135100,011390,170000,2,4000,2.41,72.05,45744,32960,-12784,1343,1295,-48,82882,170500,170500,170000,717,6,1,3785,2914,698,19
135200,011390,170000,2,4000,2.41,71.64,46013,32965,-13048,1347,1300,-47,83156,170000,170000,170000,190,2,0,3836,2794,190,0
135200,011390,170000,2,4000,2.41,71.64,46119,33038,-13081,1349,1305,-44,83335,170000,170000,169500,369,4,5,2728,2573,296,73
135300,011390,169500,2,3500,2.11,71.44,46320,33089,-13231,1353,1315,-38,83587,170000,170000,169500,126,3,1,3734,2419,101,25
135300,011390,169500,2,3500,2.11,71.41,46341,33090,-13251,1355,1316,-39,83609,170000,170500,169500,148,5,2,3731,2487,122,26
135400,011390,170000,2,4000,2.41,71.48,46343,33124,-13219,1357,1317,-40,83645,169500,170000,169500,35,1,1,2731,2911,1,34
135400,011390,170000,2,4000,2.41,71.38,46410,33127,-13283,1359,1320,-39,83715,169500,170500,169500,105,3,4,2694,2940,68,37
135500,011390,170000,2,4000,2.41,71.38,46411,33127,-13284,1360,1320,-40,83716,170000,170000,170000,1,1,0,3710,2931,1,0
135500,011390,170000,2,4000,2.41,71.33,46456,33137,-13319,1361,1321,-40,83771,170000,170500,170000,56,2,1,3689,2966,46,10
135600,011390,170000,2,4000,2.41,71.31,46467,33137,-13330,1363,1321,-42,83782,170000,170000,170000,11,2,0,3852,2947,11,0
135600,011390,170500,2,4500,2.71,71.33,46467,33144,-13323,1363,1323,-40,83789,170000,170500,170000,18,2,2,3877,2767,11,7
135700,011390,170500,2,4500,2.71,71.35,46467,33155,-13312,1363,1325,-38,83800,170500,170500,170500,11,0,2,3825,2908,0,11
135700,011390,170000,2,4000,2.41,71.45,46473,33204,-13269,1364,1326,-38,83855,170500,170500,170000,66,1,3,3776,3091,6,60
135800,011390,170500,2,4500,2.71,71.46,46473,33208,-13265,1364,1329,-35,83859,170500,170500,170500,4,0,3,3774,3118,0,4
135900,011390,170000,2,4000,2.41,71.18,46675,33221,-13454,1367,1334,-33,84074,170000,170000,170000,201,2,0,3864,2853,201,0
135900,011390,170500,2,4500,2.71,71.17,46681,33225,-13456,1368,1336,-32,84084,170000,170500,170000,211,3,2,3860,2964,207,4
140000,011390,170500,2,4500,2.71,71.18,46681,33227,-13454,1368,1338,-30,84086,170500,170500,170500,0,0,0,3809,3153,0,0
140000,011390,170500,2,4500,2.71,71.19,46681,33234,-13447,1368,1340,-28,84093,170500,170500,170500,7,0,2,3803,3212,0,7
140100,011390,170500,2,4500,2.71,71.2,46681,33237,-13444,1368,1342,-26,84096,170500,170500,170500,0,0,0,3808,3372,0,0
140100,011390,170000,2,4000,2.41,71.22,46731,33283,-13448,1369,1346,-23,84192,170500,170500,170000,96,1,4,3780,3462,50,46
140200,011390,170500,2,4500,2.71,71.32,46734,33333,-13401,1370,1347,-23,84245,170500,170500,170500,0,0,0,3790,3420,0,0
140200,011390,170500,2,4500,2.71,71.32,46734,33333,-13401,1370,1347,-23,84245,170500,170500,170500,0,0,0,3790,3420,0,0
140300,011390,170500,2,4500,2.71,71.36,46734,33349,-13385,1370,1349,-21,84261,170500,170500,170500,15,0,1,3821,3393,0,15
140300,011390,170500,2,4500,2.71,71.38,46734,33361,-13373,1370,1351,-19,84273,170500,170500,170500,27,0,3,3802,3413,0,27
140400,011390,170500,2,4500,2.71,71.36,46749,33361,-13388,1371,1351,-20,84288,170500,170500,170500,0,0,0,4359,3399,0,0
140400,011390,170500,2,4500,2.71,71.24,46848,33375,-13473,1375,1352,-23,84401,170500,170500,170500,113,4,1,3822,3286,99,14
140500,011390,170500,2,4500,2.71,71.27,46849,33388,-13461,1376,1353,-23,84415,170500,170500,170500,0,0,0,4359,3313,0,0
140500,011390,170500,2,4500,2.71,71.12,46949,33389,-13560,1377,1354,-23,84516,171000,171000,170500,101,1,1,4357,3464,100,1
140600,011390,170500,2,4500,2.71,70.96,47050,33389,-13661,1379,1354,-25,84617,170500,170500,170500,1,1,0,4357,3312,1,0
140600,011390,170500,2,4500,2.71,70.96,47050,33389,-13661,1379,1354,-25,84617,170500,170500,170500,1,1,0,4357,3312,1,0
140700,011390,171000,2,5000,3.01,70.97,47050,33391,-13659,1379,1356,-23,84619,171000,171000,171000,1,0,1,4398,3351,0,1
140700,011390,171000,2,5000,3.01,70.98,47050,33394,-13656,1379,1359,-20,84622,171000,171000,171000,4,0,4,4383,3395,0,4
140800,011390,171000,2,5000,3.01,70.98,47050,33395,-13655,1379,1360,-19,84623,171000,171000,171000,1,0,1,4482,3395,0,1
140800,011390,170500,2,4500,2.71,70.89,47106,33395,-13711,1382,1360,-22,84679,171000,171000,170500,57,3,1,4486,3394,56,1
140900,011390,171000,2,5000,3.01,70.9,47106,33396,-13710,1382,1361,-21,84680,171000,171000,171000,1,0,1,4441,3384,0,1
140900,011390,171000,2,5000,3.01,70.94,47106,33416,-13690,1382,1362,-20,84700,171000,171000,171000,21,0,2,4455,3684,0,21
141000,011390,171000,2,5000,3.01,70.95,47106,33424,-13682,1382,1363,-19,84708,171000,171000,171000,8,0,1,4445,3763,0,8
141000,011390,171000,2,5000,3.01,70.96,47106,33425,-13681,1382,1364,-18,84709,171000,171000,171000,9,0,2,4438,3687,0,9
141100,011390,170500,2,4500,2.71,70.94,47116,33425,-13691,1383,1364,-19,84719,170500,170500,170500,10,1,0,4413,3688,10,0
141100,011390,170500,2,4500,2.71,70.94,47116,33425,-13691,1383,1364,-19,84719,170500,170500,170500,10,1,0,4413,3688,10,0
141200,011390,170500,2,4500,2.71,70.93,47123,33425,-13698,1384,1364,-20,84726,170500,170500,170500,7,1,0,4417,3675,7,0
141300,011390,170500,2,4500,2.71,70.93,47123,33425,-13698,1384,1364,-20,84726,170500,170500,170500,0,0,0,4417,3675,0,0
141300,011390,170500,2,4500,2.71,70.93,47123,33425,-13698,1384,1364,-20,84726,170500,170500,170500,0,0,0,4452,3670,0,0
141400,011390,170500,2,4500,2.71,70.93,47123,33425,-13698,1384,1364,-20,84726,170500,170500,170500,0,0,0,4471,3643,0,0
141400,011390,170500,2,4500,2.71,70.93,47123,33425,-13698,1384,1364,-20,84726,170500,170500,170500,0,0,0,4471,3635,0,0
141500,011390,171000,2,5000,3.01,70.93,47123,33426,-13697,1384,1365,-19,84727,171000,171000,171000,0,0,0,4391,3566,0,0
141500,011390,171000,2,5000,3.01,70.95,47123,33436,-13687,1384,1366,-18,84737,171000,171000,171000,10,0,1,4390,3568,0,10
141600,011390,171000,2,5000,3.01,70.95,47123,33436,-13687,1384,1366,-18,84737,171000,171000,171000,0,0,0,4390,3568,0,0
141600,011390,171000,2,5000,3.01,71.03,47123,33473,-13650,1384,1369,-15,84774,171000,171000,171000,37,0,3,4352,3675,0,37
141700,011390,171500,2,5500,3.31,71.14,47123,33524,-13599,1384,1372,-12,84825,171000,171500,171000,50,0,2,4353,3765,0,50
141700,011390,170500,2,4500,2.71,71.13,47133,33524,-13609,1385,1372,-13,84835,171000,171500,170500,60,1,2,6064,3765,10,50
141800,011390,171000,2,5000,3.01,71.1,47151,33525,-13626,1386,1373,-13,84854,171000,171000,171000,1,0,1,4377,3711,0,1
141800,011390,171500,2,5500,3.31,71.47,47151,33701,-13450,1386,1376,-10,85030,171000,171500,171000,177,0,4,5988,3569,0,177
141900,011390,171500,2,5500,3.31,71.47,47151,33701,-13450,1386,1376,-10,85030,171500,171500,171500,0,0,0,5988,3569,0,0
141900,011390,171000,2,5000,3.01,71.47,47152,33701,-13451,1387,1376,-11,85031,171000,171000,171000,1,1,0,5882,3695,1,0
142000,011390,171000,2,5000,3.01,71.32,47253,33701,-13552,1389,1376,-13,85132,171000,171000,171000,1,1,0,5886,3604,1,0
142000,011390,171000,2,5000,3.01,71.31,47267,33706,-13561,1392,1377,-15,85151,171000,171000,171000,20,4,1,4175,3853,15,5
142100,011390,171000,2,5000,3.01,71.2,47367,33723,-13644,1393,1378,-15,85268,171000,171000,171000,0,0,0,4170,3753,0,0
142100,011390,171000,2,5000,3.01,71.2,47367,33723,-13644,1393,1378,-15,85268,171000,171000,171000,0,0,0,4170,3753,0,0
142200,011390,170500,2,4500,2.71,71.19,47368,33723,-13645,1394,1378,-16,85269,170500,170500,170500,0,0,0,4159,3807,0,0
142200,011390,170500,2,4500,2.71,71.19,47368,33723,-13645,1394,1378,-16,85269,170500,170500,170500,0,0,0,4159,3807,0,0
142300,011390,170500,2,4500,2.71,71.21,47372,33733,-13639,1397,1379,-18,85283,170500,170500,170500,3,2,0,4747,3848,3,0
142300,011390,170500,2,4500,2.71,71.14,47418,33733,-13685,1399,1379,-20,85329,170500,170500,170500,49,4,0,4766,3894,49,0
142400,011390,170500,2,4500,2.71,71.14,47421,33733,-13688,1400,1379,-21,85332,170500,170500,170500,3,1,0,4776,3805,3,0
142400,011390,170500,2,4500,2.71,71.06,47481,33738,-13743,1402,1380,-22,85397,170500,170500,170500,68,3,1,4349,3651,63,5
142500,011390,170500,2,4500,2.71,71.06,47481,33738,-13743,1402,1380,-22,85397,170500,170500,170500,0,0,0,4349,3651,0,0
142500,011390,170500,2,4500,2.71,71.06,47481,33739,-13742,1402,1381,-21,85398,170500,170500,170500,1,0,1,4301,3672,0,1
142600,011390,170500,2,4500,2.71,71.04,47492,33740,-13752,1404,1382,-22,85410,170000,170500,170000,12,2,1,4291,3728,11,1
142700,011390,170500,2,4500,2.71,71.05,47492,33741,-13751,1404,1383,-21,85411,170500,170500,170500,0,0,0,4254,3728,0,0
142700,011390,170500,2,4500,2.71,71.05,47492,33741,-13751,1404,1383,-21,85411,170500,170500,170500,0,0,0,4254,3728,0,0
142800,011390,170500,2,4500,2.71,71.05,47492,33741,-13751,1404,1383,-21,85411,170500,170500,170500,0,0,0,4754,3678,0,0
142800,011390,170000,2,4000,2.41,71.05,47531,33771,-13760,1405,1385,-20,85480,170500,170500,170000,69,1,2,4864,3679,39,30
142900,011390,170000,2,4000,2.41,71.05,47533,33771,-13762,1406,1385,-21,85482,170000,170000,170000,2,1,0,4825,3583,2,0
142900,011390,170000,2,4000,2.41,71.05,47533,33771,-13762,1406,1385,-21,85482,170000,170000,170000,2,1,0,4825,3583,2,0
143000,011390,170000,2,4000,2.41,70.99,47571,33771,-13800,1409,1385,-24,85520,170000,170000,170000,0,0,0,4902,3651,0,0
143000,011390,170000,2,4000,2.41,70.98,47581,33771,-13810,1410,1385,-25,85530,170000,170000,170000,10,1,0,4902,3646,10,0
143100,011390,170000,2,4000,2.41,70.97,47588,33771,-13817,1412,1385,-27,85537,170000,170000,170000,6,1,0,4840,3645,6,0
143100,011390,170000,2,4000,2.41,70.91,47626,33771,-13855,1415,1385,-30,85575,170000,170000,170000,44,4,0,4736,3602,44,0
143200,011390,170500,2,4500,2.71,70.86,47663,33772,-13891,1416,1386,-30,85613,170500,170500,170500,1,0,1,4736,3529,0,1
143200,011390,170000,2,4000,2.41,70.86,47665,33777,-13888,1417,1387,-30,85620,170500,170500,170000,8,1,2,4731,3479,2,6
143300,011390,170000,2,4000,2.41,70.64,47814,33777,-14037,1420,1387,-33,85769,170000,170000,170000,131,2,0,4731,3427,131,0
143300,011390,170500,2,4500,2.71,70.6,47864,33791,-14073,1421,1388,-33,85833,170000,170500,170000,195,3,1,4650,3346,181,14
143400,011390,170500,2,4500,2.71,70.72,47870,33856,-14014,1422,1390,-32,85904,170000,170500,170000,62,1,1,4656,3286,6,56
143400,011390,170000,2,4000,2.41,70.46,48053,33856,-14197,1423,1390,-33,86087,170000,170500,170000,245,2,1,4600,3286,189,56
143500,011390,170000,2,4000,2.41,70.38,48102,33856,-14246,1424,1390,-34,86136,170000,170000,170000,49,1,0,4050,3170,49,0
143500,011390,170000,2,4000,2.41,70.38,48102,33856,-14246,1424,1390,-34,86136,170000,170000,170000,49,1,0,4050,3170,49,0
143600,011390,170000,2,4000,2.41,70.38,48103,33856,-14247,1425,1390,-35,86137,170000,170000,170000,1,1,0,4176,3197,1,0
143600,011390,170000,2,4000,2.41,70.37,48109,33856,-14253,1426,1390,-36,86143,170000,170000,170000,7,2,0,4177,3196,7,0
143700,011390,170000,2,4000,2.41,70.36,48116,33856,-14260,1428,1390,-38,86150,170000,170000,170000,7,2,0,4224,3189,7,0
143700,011390,170000,2,4000,2.41,70.36,48116,33856,-14260,1428,1390,-38,86150,170000,170000,170000,7,2,0,4224,3189,7,0
143800,011390,170000,2,4000,2.41,70.28,48176,33857,-14319,1429,1391,-38,86211,170500,170500,170000,61,1,1,4223,3250,60,1
143800,011390,170000,2,4000,2.41,70.28,48176,33857,-14319,1429,1391,-38,86211,170500,170500,170000,61,1,1,4223,3250,60,1
143900,011390,170000,2,4000,2.41,70.28,48176,33857,-14319,1429,1391,-38,86211,170000,170000,170000,0,0,0,4223,3250,0,0
144000,011390,170000,2,4000,2.41,70.28,48176,33857,-14319,1429,1391,-38,86211,170000,170000,170000,0,0,0,4223,3116,0,0
144000,011390,170000,2,4000,2.41,70.23,48211,33857,-14354,1431,1391,-40,86246,170000,170000,170000,35,2,0,4238,3609,35,0
144100,011390,170000,2,4000,2.41,70.23,48211,33857,-14354,1431,1391,-40,86246,170000,170000,170000,0,0,0,4238,3609,0,0
144100,011390,170000,2,4000,2.41,70.23,48211,33857,-14354,1431,1391,-40,86246,170000,170000,170000,0,0,0,4412,3577,0,0
144200,011390,170500,2,4500,2.71,70.23,48211,33859,-14352,1431,1392,-39,86248,170500,170500,170500,0,0,0,4426,3585,0,0
144200,011390,170500,2,4500,2.71,70.23,48211,33859,-14352,1431,1392,-39,86248,170500,170500,170500,0,0,0,4426,3585,0,0
144300,011390,170500,2,4500,2.71,70.38,48211,33930,-14281,1431,1393,-38,86319,170500,170500,170500,0,0,0,4469,3631,0,0
144300,011390,170000,2,4000,2.41,70.46,48221,33976,-14245,1432,1396,-36,86375,170500,170500,170000,56,1,3,4353,3616,10,46
144400,011390,170500,2,4500,2.71,70.45,48230,33977,-14253,1434,1397,-37,86385,170000,170500,170000,10,2,1,4337,3623,9,1
144400,011390,170500,2,4500,2.71,70.5,48230,34004,-14226,1434,1399,-35,86412,170000,170500,170000,37,2,3,4309,3623,9,28
144500,011390,170500,2,4500,2.71,70.5,48230,34004,-14226,1434,1399,-35,86412,170500,170500,170500,0,0,0,4309,3623,0,0
144500,011390,170500,2,4500,2.71,70.5,48230,34004,-14226,1434,1399,-35,86412,170500,170500,170500,0,0,0,4310,3613,0,0
144600,011390,170500,2,4500,2.71,70.6,48231,34052,-14179,1435,1402,-33,86461,170500,170500,170500,48,0,3,4164,3643,0,48
144600,011390,170500,2,4500,2.71,70.61,48231,34054,-14177,1435,1403,-32,86463,170500,170500,170500,50,0,4,4187,3653,0,50
144700,011390,170500,2,4500,2.71,70.61,48231,34054,-14177,1435,1403,-32,86463,170500,170500,170500,0,0,0,4187,3653,0,0
144700,011390,170500,2,4500,2.71,70.62,48231,34059,-14172,1435,1404,-31,86468,170500,170500,170500,5,0,1,4697,3734,0,5
144800,011390,170500,2,4500,2.71,70.62,48231,34060,-14171,1435,1405,-30,86469,170500,170500,170500,0,0,0,4692,3734,0,0
144800,011390,170000,2,4000,2.41,70.61,48236,34060,-14176,1437,1405,-32,86474,170000,170000,170000,5,2,0,5292,3732,5,0
144900,011390,170500,2,4500,2.71,70.62,48236,34062,-14174,1437,1406,-31,86476,170500,170500,170500,0,0,0,5288,3735,0,0
144900,011390,170500,2,4500,2.71,70.62,48236,34063,-14173,1437,1407,-30,86477,170500,170500,170500,1,0,1,5209,3735,0,1
145000,011390,170000,2,4000,2.41,70.61,48243,34063,-14180,1439,1407,-32,86484,170000,170000,170000,5,1,0,5708,3763,5,0
145000,011390,170000,2,4000,2.41,70.61,48243,34063,-14180,1439,1407,-32,86484,170000,170000,170000,5,1,0,5708,3763,5,0
145100,011390,170000,2,4000,2.41,70.61,48243,34063,-14180,1439,1407,-32,86484,170000,170000,170000,0,0,0,5708,3763,0,0
145100,011390,170500,2,4500,2.71,70.48,48336,34067,-14269,1440,1408,-32,86581,170000,170500,170000,97,1,1,5711,3726,93,4
145200,011390,170500,2,4500,2.71,70.48,48336,34069,-14267,1440,1409,-31,86583,170500,170500,170500,2,0,1,5707,3716,0,2
145300,011390,170000,2,4000,2.41,70.46,48359,34076,-14283,1441,1411,-30,86613,170000,170000,170000,0,0,0,5698,3724,0,0
145300,011390,170500,2,4500,2.71,70.58,48376,34146,-14230,1442,1413,-29,86700,170000,170500,170000,87,1,2,5655,3704,17,70
145400,011390,170000,2,4000,2.41,70.58,48382,34146,-14236,1443,1413,-30,86706,170000,170000,170000,0,0,0,5610,3735,0,0
145400,011390,170000,2,4000,2.41,70.68,48405,34215,-14190,1445,1414,-31,86798,170500,170500,170000,92,2,1,5541,3728,23,69
145500,011390,170500,2,4500,2.71,70.69,48405,34216,-14189,1445,1415,-30,86799,170500,170500,170500,0,0,0,5541,3708,0,0
145500,011390,170000,2,4000,2.41,70.68,48407,34216,-14191,1446,1415,-31,86801,170000,170000,170000,2,1,0,5538,3707,2,0
145600,011390,170000,2,4000,2.41,70.68,48409,34216,-14193,1447,1415,-32,86803,170000,170000,170000,2,1,0,5538,3772,2,0
145600,011390,170500,2,4500,2.71,70.73,48409,34238,-14171,1447,1416,-31,86825,170000,170500,170000,24,1,1,5538,3770,2,22
145700,011390,170000,2,4000,2.41,70.72,48414,34238,-14176,1448,1416,-32,86830,170000,170000,170000,5,1,0,5515,3770,5,0
145700,011390,170500,2,4500,2.71,70.8,48419,34283,-14136,1449,1417,-32,86880,170000,170500,170000,55,2,1,5513,3760,10,45
145800,011390,170500,2,4500,2.71,70.8,48419,34283,-14136,1449,1417,-32,86880,170500,170500,170500,0,0,0,5513,3760,0,0
145800,011390,170500,2,4500,2.71,70.94,48419,34349,-14070,1449,1420,-29,86946,170500,170500,170500,66,0,3,5453,3767,0,66
145900,011390,170500,2,4500,2.71,70.94,48419,34349,-14070,1449,1420,-29,86946,170500,170500,170500,0,0,0,5453,3767,0,0
145900,011390,170500,2,4500,2.71,70.66,48754,34451,-14303,1452,1423,-29,87383,170500,170500,170000,437,3,3,5366,3411,335,102
150000,011390,171000,2,5000,3.01,70.67,48754,34454,-14300,1452,1425,-27,87386,171000,171000,171000,1,0,1,5820,3441,0,1
150000,011390,170500,2,4500,2.71,70.62,48787,34454,-14333,1453,1425,-28,87419,171000,171000,170500,34,1,1,5798,3489,33,1
150100,011390,170500,2,4500,2.71,70.62,48788,34455,-14333,1454,1426,-28,87421,170500,170500,170500,1,1,0,5296,3460,1,0
150100,011390,170500,2,4500,2.71,70.62,48789,34455,-14334,1455,1426,-29,87422,170500,170500,170500,2,2,0,5296,3495,2,0
150200,011390,171000,2,5000,3.01,70.62,48799,34461,-14338,1456,1428,-28,87438,171000,171000,170500,16,1,2,5366,3643,10,6
150200,011390,171000,2,5000,3.01,70.62,48799,34462,-14337,1456,1429,-27,87439,171000,171000,170500,17,1,3,5364,3644,10,7
150300,011390,170500,2,4500,2.71,70.4,48949,34462,-14487,1457,1429,-28,87589,170500,170500,170500,0,0,0,5363,3681,0,0
150300,011390,171000,2,5000,3.01,70.34,48992,34463,-14529,1458,1430,-28,87633,170500,171000,170500,44,1,1,5430,3398,43,1
150400,011390,171000,2,5000,3.01,70.35,48992,34464,-14528,1458,1431,-27,87634,171000,171000,171000,1,0,1,5428,3568,0,1
150500,011390,170500,2,4500,2.71,70.36,49002,34480,-14522,1460,1434,-26,87660,170500,170500,170500,0,0,0,5385,3685,0,0
150500,011390,170500,2,4500,2.71,70.34,49021,34480,-14541,1463,1434,-29,87679,170500,170500,170500,19,3,0,5375,3716,19,0
150600,011390,171000,2,5000,3.01,70.33,49026,34481,-14545,1464,1435,-29,87685,171000,171000,171000,0,0,0,5371,3655,0,0
150600,011390,171000,2,5000,3.01,70.35,49026,34491,-14535,1464,1436,-28,87695,171000,171000,171000,10,0,1,5370,3666,0,10
150700,011390,171000,2,5000,3.01,70.36,49026,34496,-14530,1464,1437,-27,87700,171000,171000,171000,0,0,0,5370,3667,0,0
150700,011390,171000,2,5000,3.01,70.36,49027,34497,-14530,1465,1438,-27,87702,170500,171000,170500,2,1,1,5364,3666,1,1
150800,011390,171000,2,5000,3.01,70.74,49027,34680,-14347,1465,1440,-25,87885,171000,171000,171000,83,0,1,5232,3735,0,83
150800,011390,171000,2,5000,3.01,70.74,49027,34680,-14347,1465,1440,-25,87885,171000,171000,171000,83,0,1,5232,3735,0,83
150900,011390,171000,2,5000,3.01,70.74,49027,34680,-14347,1465,1440,-25,87885,171000,171000,171000,0,0,0,5232,3735,0,0
150900,011390,171000,2,5000,3.01,70.74,49027,34680,-14347,1465,1440,-25,87885,171000,171000,171000,0,0,0,5239,3738,0,0
151000,011390,170000,2,4000,2.41,70.01,49535,34680,-14855,1470,1440,-30,88393,170500,170500,170000,445,4,0,5246,3522,445,0
151000,011390,170000,2,4000,2.41,70.01,49535,34680,-14855,1470,1440,-30,88393,170500,170500,170000,445,4,0,5246,3522,445,0
151100,011390,170500,2,4500,2.71,70.04,49536,34696,-14840,1471,1441,-30,88410,170500,170500,170500,1,1,0,5259,3509,1,0
151100,011390,171000,2,5000,3.01,70.11,49544,34736,-14808,1473,1442,-31,88458,170500,171000,170500,49,3,1,5271,3568,9,40
151200,011390,171000,2,5000,3.01,70.12,49544,34742,-14802,1473,1444,-29,88464,171000,171000,171000,5,0,1,5280,3577,0,5
151200,011390,171000,2,5000,3.01,70.13,49544,34743,-14801,1473,1445,-28,88465,171000,171000,171000,6,0,2,5318,3618,0,6
151300,011390,171000,2,5000,3.01,70.13,49544,34743,-14801,1473,1445,-28,88465,171000,171000,171000,0,0,0,5318,3618,0,0
151300,011390,170500,2,4500,2.71,70.24,49615,34850,-14765,1475,1448,-27,88643,171000,171000,170500,178,2,3,5132,3551,71,107
151400,011390,170500,2,4500,2.71,70.24,49615,34850,-14765,1475,1448,-27,88643,170500,170500,170500,0,0,0,5132,3551,0,0
151400,011390,171000,2,5000,3.01,70.24,49615,34851,-14764,1475,1449,-26,88644,171000,171000,171000,1,0,1,5129,3463,0,1
151500,011390,170500,2,4500,2.71,70.24,49616,34851,-14765,1476,1449,-27,88645,170500,170500,170500,1,1,0,5123,3945,1,0
151600,011390,170500,2,4500,2.71,70.23,49626,34851,-14775,1478,1449,-29,88655,170500,170500,170500,1,1,0,5041,4015,1,0
151600,011390,170500,2,4500,2.71,70.22,49633,34851,-14782,1479,1449,-30,88662,170500,170500,170500,8,2,0,5044,4014,8,0
151700,011390,170500,2,4500,2.71,70.22,49635,34853,-14782,1481,1451,-30,88666,170500,170500,170500,0,0,0,5040,4036,0,0
151700,011390,170500,2,4500,2.71,70.14,49689,34853,-14836,1484,1451,-33,88720,170500,170500,170500,54,3,0,5041,4065,54,0
151800,011390,171000,2,5000,3.01,70.35,49706,34968,-14738,1486,1454,-32,88852,171000,171000,171000,15,0,2,4934,4265,0,15
151800,011390,171000,2,5000,3.01,70.36,49707,34973,-14734,1487,1458,-29,88858,171000,171000,170500,21,1,6,5089,3988,1,20
151900,011390,171000,2,5000,3.01,70.42,49707,35005,-14702,1487,1460,-27,88890,171000,171000,171000,1,0,1,5126,3989,0,1
151900,011390,170500,2,4500,2.71,70.58,49753,35117,-14636,1489,1463,-26,89048,171000,171000,170500,159,2,4,5024,4002,46,113
152000,011390,171000,2,5000,3.01,70.6,49753,35125,-14628,1489,1465,-24,89056,171000,171000,171000,1,0,1,5014,3967,0,1
152000,011390,171000,2,5000,3.01,70.58,49822,35162,-14660,1495,1472,-23,89162,171000,171000,170500,107,6,8,4955,3570,69,38
152000,011390,170500,2,4500,2.71,70.57,49826,35162,-14664,1497,1472,-25,89166,171000,171000,170500,111,8,8,4925,3556,73,38
152000,011390,170500,2,4500,2.71,70.57,49826,35162,-14664,1497,1472,-25,89166,171000,171000,170500,111,8,8,4925,3556,73,38
152000,011390,170500,2,4500,2.71,70.57,49826,35162,-14664,1497,1472,-25,89166,171000,171000,170500,111,8,8,4925,3556,73,38
152000,011390,170500,2,4500,2.71,70.57,49826,35162,-14664,1497,1472,-25,89166,171000,171000,170500,111,8,8,4925,3556,73,38
152000,011390,170500,2,4500,2.71,70.57,49826,35162,-14664,1497,1472,-25,89166,171000,171000,170500,111,8,8,4925,3556,73,38
152000,011390,170500,2,4500,2.71,70.57,49826,35162,-14664,1497,1472,-25,89166,171000,171000,170500,111,8,8,4925,3556,73,38
152000,011390,170500,2,4500,2.71,70.57,49826,35162,-14664,1497,1472,-25,89166,171000,171000,170500,111,8,8,4925,3556,73,38
152000,011390,170500,2,4500,2.71,70.57,49826,35162,-14664,1497,1472,-25,89166,171000,171000,170500,111,8,8,4925,3556,73,38
152000,011390,170500,2,4500,2.71,70.57,49826,35162,-14664,1497,1472,-25,89166,171000,171000,170500,111,8,8,4925,3556,73,38
152000,011390,170500,2,4500,2.71,70.57,49826,35162,-14664,1497,1472,-25,89166,171000,171000,170500,111,8,8,4925,3556,73,38
152000,011390,170500,2,4500,2.71,70.57,49826,35162,-14664,1497,1472,-25,89166,171000,171000,170500,111,8,8,4925,3556,73,38
152000,011390,170500,2,4500,2.71,70.57,49826,35162,-14664,1497,1472,-25,89166,171000,171000,170500,111,8,8,4925,3556,73,38
152000,011390,170500,2,4500,2.71,70.57,49826,35162,-14664,1497,1472,-25,89166,171000,171000,170500,111,8,8,4925,3556,73,38
152000,011390,170500,2,4500,2.71,70.57,49826,35162,-14664,1497,1472,-25,89166,171000,171000,170500,111,8,8,4925,3556,73,38
152000,011390,170500,2,4500,2.71,70.57,49826,35162,-14664,1497,1472,-25,89166,171000,171000,170500,111,8,8,4925,3556,73,38
152000,011390,170500,2,4500,2.71,70.57,49826,35162,-14664,1497,1472,-25,89166,171000,171000,170500,111,8,8,4925,3556,73,38
152000,011390,170500,2,4500,2.71,70.57,49826,35162,-14664,1497,1472,-25,89166,171000,171000,170500,111,8,8,4925,3556,73,38
152000,011390,170500,2,4500,2.71,70.57,49826,35162,-14664,1497,1472,-25,89166,171000,171000,170500,111,8,8,4925,3556,73,38
152000,011390,170500,2,4500,2.71,70.57,49826,35162,-14664,1497,1472,-25,89166,171000,171000,170500,111,8,8,4925,3556,73,38
153000,011390,170500,2,4500,2.71,70.57,49826,35162,-14664,1497,1472,-25,89166,170500,170500,170500,0,0,0,4923,3554,0,0
153000,011390,171500,2,5500,3.31,70.57,49826,35162,-14664,1497,1472,-25,91385,171500,171500,171500,2219,0,0,4923,3554,0,0
