090200,229640,8000,2,170,2.17,207.24,18592,38530,19938,178,261,83,74194,7960,8020,7960,25785,138,201,17842,16143,6315,19470
090300,229640,8060,2,230,2.94,232.77,23799,55397,31598,291,436,145,96268,8050,8070,8020,6337,61,87,27362,20122,3606,2731
090300,229640,8110,2,280,3.58,243.87,34180,83356,49176,399,657,258,134608,8050,8120,8020,44677,169,308,27437,22293,13987,30690
090400,229640,8090,2,260,3.32,202.8,46554,94410,47856,461,720,259,158036,8110,8120,8080,21726,51,55,34839,46609,11836,9890
090500,229640,8090,2,260,3.32,184.29,56404,103946,47542,490,755,265,177422,8090,8100,8080,7921,17,11,33653,35405,3752,4169
090500,229640,8070,2,240,3.07,134.12,80135,107474,27339,540,774,234,204681,8090,8100,8070,35180,67,30,33053,14102,27483,7697
090600,229640,8000,2,170,2.17,116.12,94800,110085,15285,594,810,216,221957,8050,8060,8000,12391,47,34,24075,9403,9937,2454
090700,229640,7950,2,120,1.53,104.5,106312,111093,4781,641,829,188,234477,7970,7970,7950,7445,27,12,14117,13440,6951,494
090800,229640,7930,2,100,1.28,99.46,116419,115788,-631,678,849,171,249319,7910,7930,7910,551,4,5,11369,26714,308,243
090800,229640,8020,2,190,2.43,104.69,117924,123459,5535,691,873,182,258495,7910,8030,7910,9727,17,29,18942,18339,1813,7914
090900,229640,7980,2,150,1.92,109.21,119032,129992,10960,701,892,191,266136,7970,8020,7970,2865,3,10,7478,31255,601,2264
091000,229640,8000,2,170,2.17,108.36,120592,130677,10085,706,901,195,268381,8000,8000,8000,18,0,1,12245,22212,0,18
091000,229640,8010,2,180,2.3,107.31,124032,133094,9062,725,910,185,274238,8000,8010,8000,5875,19,10,11034,22878,3440,2435
091100,229640,8030,2,200,2.55,111.21,124112,138024,13912,728,927,199,279248,8020,8030,8020,1005,2,7,27284,11244,50,955
091100,229640,8020,2,190,2.43,114.14,125462,143200,17738,743,959,216,285774,8020,8040,8010,7531,17,39,30722,15256,1400,6131
091200,229640,8060,2,230,2.94,118.12,125555,148304,22749,746,975,229,290971,8030,8060,8030,4548,1,14,37224,17892,40,4508
091300,229640,8100,2,270,3.45,131.56,126313,166178,39865,752,1018,266,309604,8090,8100,8070,3182,1,7,30706,16195,5,3177
091300,229640,8100,2,270,3.45,136.37,127413,173748,46335,760,1101,341,318274,8090,8100,8070,11852,9,90,36314,8650,1105,10747
091400,229640,8140,2,310,3.96,154.02,128813,198392,69579,776,1181,405,344318,8130,8140,8120,1877,5,41,23110,15602,115,1762
091500,229640,8250,2,420,5.36,174.66,133613,233366,99753,837,1350,513,384092,8180,8250,8170,24627,44,112,29457,20640,2808,21819
091600,229640,8260,2,430,5.49,173.07,140525,243209,102684,892,1425,533,401069,8270,8270,8240,6141,20,39,31611,20181,2690,3451
091600,229640,8210,2,380,4.85,158.36,156512,247858,91346,948,1455,507,421705,8270,8270,8210,26777,76,69,71240,14473,18677,8100
091700,229640,8200,2,370,4.73,153.23,165033,252874,87841,996,1502,506,435242,8200,8210,8170,7902,38,45,57808,19463,3953,3949
091800,229640,8210,2,380,4.85,148.69,176012,261715,85703,1038,1546,508,455062,8190,8210,8190,15498,24,30,61242,18105,7521,7977
091900,229640,8210,2,380,4.85,151.57,180759,273976,93217,1069,1609,540,472070,8200,8230,8200,10193,27,43,57008,22897,1353,8840
091900,229640,8240,2,410,5.24,158.89,182228,289541,107313,1155,1831,676,489104,8200,8250,8200,27227,113,265,40476,25760,2822,24405
092000,229640,8230,2,400,5.11,156.34,188358,294484,106126,1213,1913,700,500177,8250,8250,8230,10019,46,60,51878,26945,5699,4320
092100,229640,8210,2,380,4.85,153.73,194212,298566,104354,1235,1922,687,510113,8220,8230,8210,1069,4,2,54910,23529,848,221
092100,229640,8200,2,370,4.73,149.18,200365,298906,98541,1275,1929,654,516606,8220,8230,8200,7562,44,9,52098,20949,7001,561
092200,229640,8210,2,380,4.85,148.7,202857,301643,98786,1281,1956,675,521835,8210,8210,8200,3960,4,25,44831,30983,1324,2636
092300,229640,8200,2,370,4.73,148.26,205290,304356,99066,1290,1981,691,526981,8210,8210,8200,1130,1,2,52668,25401,1000,130
092300,229640,8200,2,370,4.73,142.45,217698,310100,92402,1325,1989,664,545133,8210,8210,8190,19282,36,10,44755,22580,13408,5874
092400,229640,8180,2,350,4.47,139.5,222730,310712,87982,1350,2002,652,550777,8180,8200,8160,3305,11,6,20717,19651,2818,487
092500,229640,8160,2,330,4.21,138.84,224575,311795,87220,1366,2014,648,553705,8160,8160,8160,61,1,0,30932,20669,61,0
092500,229640,8160,2,330,4.21,137.62,227481,313048,85567,1384,2017,633,557864,8160,8180,8160,4220,19,3,25059,20377,2967,1253
092600,229640,8170,2,340,4.34,136.94,228978,313553,84575,1396,2023,627,560016,8170,8180,8170,956,6,1,35827,22116,954,2
092600,229640,8140,2,310,3.96,132.24,237265,313753,76488,1412,2025,613,568503,8170,8180,8140,9443,22,3,27507,20802,9241,202
092700,229640,8170,2,340,4.34,132.11,238385,314930,76545,1419,2033,614,570800,8160,8170,8140,2027,7,7,26502,19114,1120,907
092800,229640,8190,2,360,4.6,131.91,240583,317347,76764,1431,2038,607,575415,8170,8190,8160,4093,11,2,61630,17646,2174,1919
092900,229640,8170,2,340,4.34,131.57,241413,317628,76215,1440,2043,603,576526,8170,8180,8170,532,2,2,48163,19198,402,130
092900,229640,8200,2,370,4.73,133.73,242473,324249,81776,1457,2076,619,584207,8170,8200,8170,8213,19,35,59744,21730,1462,6751
093000,229640,8220,2,390,4.98,135.17,242667,328018,85351,1575,2332,757,588170,8190,8220,8190,3204,92,198,59504,13195,119,3085
093100,229640,8230,2,400,5.11,138.6,243571,337580,94009,1710,2650,940,598636,8240,8240,8230,706,20,48,55984,10692,20,686
093100,229640,8250,2,420,5.36,139.53,246596,344078,97482,1843,2932,1089,608159,8240,8250,8230,10229,153,330,52243,10272,3045,7184
093200,229640,8250,2,420,5.36,141.21,251370,354959,103589,1998,3290,1292,623816,8260,8260,8240,9475,106,243,63419,9270,4285,5190
093300,229640,8250,2,420,5.36,140.34,257361,361179,103818,2153,3591,1438,636027,8240,8260,8230,4228,72,122,57838,8655,2358,1870
093300,229640,8220,2,390,4.98,139.14,260366,362279,101913,2180,3611,1431,640132,8240,8260,8210,8333,99,142,60966,11218,5363,2970
093400,229640,8220,2,390,4.98,139.53,261629,365048,103419,2193,3631,1438,644164,8220,8230,8210,4021,12,19,54219,13399,1253,2768
093500,229640,8180,2,350,4.47,137.53,265929,365740,99811,2212,3635,1423,649156,8200,8200,8180,3543,12,2,42626,23538,3272,271
093500,229640,8180,2,350,4.47,135.63,270392,366741,96349,2227,3643,1416,654620,8200,8200,8170,9007,27,10,26110,22959,7735,1272
093600,229640,8170,2,340,4.34,135.07,271980,367360,95380,2243,3650,1407,656827,8170,8180,8160,2207,16,7,53631,23753,1588,619
093700,229640,8150,2,320,4.09,133.39,275692,367735,92043,2259,3653,1394,660914,8150,8150,8150,596,3,0,36704,23064,596,0
093700,229640,8140,2,310,3.96,131.91,279193,368281,89088,2284,3657,1373,664961,8150,8160,8140,4643,28,4,23652,24939,4097,546
093800,229640,8180,2,350,4.47,131.16,281183,368786,87603,2293,3664,1371,667456,8140,8180,8130,1178,6,4,34437,22395,1157,21
093900,229640,8160,2,330,4.21,131.32,281287,369382,88095,2297,3673,1376,668177,8180,8180,8160,90,1,1,30008,22580,40,50
093900,229640,8150,2,320,4.09,130.85,282303,369395,87092,2307,3674,1367,669206,8180,8180,8150,1119,11,2,16258,23005,1056,63
094000,229640,8140,2,310,3.96,129.6,285064,369430,84366,2319,3676,1357,672002,8150,8150,8140,2613,9,0,11401,26122,2613,0
094000,229640,8150,2,320,4.09,128.95,286682,369681,82999,2332,3680,1348,673871,8150,8150,8140,4482,22,4,10215,25385,4231,251
094100,229640,8130,2,300,3.83,128.78,287085,369700,82615,2337,3681,1344,674293,8130,8140,8130,403,5,0,12873,23105,403,0
094200,229640,8140,2,310,3.96,128.69,287991,370607,82616,2345,3690,1345,676106,8140,8140,8130,648,2,4,12645,23044,184,464
094200,229640,8130,2,300,3.83,127.18,291703,371000,79297,2360,3694,1334,680211,8140,8140,8130,4753,17,8,11204,21341,3896,857
094300,229640,8130,2,300,3.83,126.89,292368,371000,78632,2366,3694,1328,680876,8130,8130,8130,265,3,0,9399,19820,265,0
094300,229640,8110,2,280,3.58,125.92,294791,371192,76401,2379,3696,1317,683491,8130,8130,8110,2880,16,2,6615,20360,2688,192
094400,229640,8120,2,290,3.7,125.85,296275,372870,76595,2388,3704,1316,686653,8110,8120,8110,3162,9,8,7057,18954,1484,1678
094500,229640,8150,2,320,4.09,126.48,297499,376286,78787,2425,3759,1334,691293,8130,8150,8120,949,18,23,10616,20593,614,335
094500,229640,8160,2,330,4.21,126.17,299169,377471,78302,2495,3835,1340,694148,8130,8160,8120,3804,88,99,17319,17078,2284,1520
094600,229640,8190,2,360,4.6,126.7,299845,379901,80056,2563,3915,1352,697254,8170,8200,8170,1796,37,45,43897,11896,146,1650
094600,229640,8220,2,390,4.98,127.16,301984,383998,82014,2622,3989,1367,703491,8170,8230,8170,8033,96,119,62507,3904,2285,5747
094700,229640,8200,2,370,4.73,127.05,303464,385558,82094,2629,4000,1371,706531,8210,8220,8200,2988,7,8,60990,8603,1480,1508
094800,229640,8180,2,350,4.47,127.29,304525,387625,83100,2640,4003,1363,709659,8190,8190,8180,207,2,0,53666,13330,207,0
094800,229640,8170,2,340,4.34,127.22,304922,387915,82993,2645,4007,1362,710346,8190,8190,8170,894,7,4,34866,16224,604,290
094900,229640,8170,2,340,4.34,127.17,305201,388114,82913,2646,4011,1365,710824,8170,8170,8170,20,0,1,44686,16884,0,20
094900,229640,8170,2,340,4.34,124.74,311154,388126,76972,2656,4015,1359,716789,8170,8170,8110,5985,10,5,47955,22048,5953,32
095000,229640,8160,2,330,4.21,124.78,311497,388671,77174,2664,4019,1355,717677,8150,8160,8150,130,5,1,36124,22268,129,1
095000,229640,8150,2,320,4.09,124.57,312036,388712,76676,2668,4024,1356,718257,8150,8160,8130,710,9,6,23239,26816,668,42
095100,229640,8140,2,310,3.96,124.09,313670,389218,75548,2674,4031,1357,720397,8150,8150,8130,2140,6,7,16888,26633,1634,506
095200,229640,8140,2,310,3.96,124.76,313691,391355,77664,2675,4038,1363,722555,8150,8150,8140,34,1,2,15291,27177,21,13
095200,229640,8140,2,310,3.96,124.55,314206,391356,77150,2680,4039,1359,723071,8150,8150,8140,550,6,3,16326,26093,536,14
095300,229640,8140,2,310,3.96,124.42,315828,392956,77128,2689,4040,1351,726293,8140,8140,8140,80,4,0,19110,24218,80,0
095300,229640,8150,2,320,4.09,124.47,316358,393758,77400,2752,4114,1362,727625,8140,8160,8140,1412,67,74,26395,21398,610,802
095400,229640,8160,2,330,4.21,124.98,316503,395572,79069,2876,4248,1372,729584,8150,8170,8150,1835,112,121,38290,26141,133,1702
095500,229640,8190,2,360,4.6,125.34,318156,398781,80625,3001,4396,1395,734446,8190,8200,8190,204,25,27,58044,26178,25,179
095500,229640,8200,2,370,4.73,125.8,318462,400630,82168,3076,4487,1411,736601,8190,8210,8190,2359,100,118,58737,25872,331,2028
095600,229640,8190,2,360,4.6,125.34,320625,401865,81240,3088,4488,1400,739999,8190,8190,8190,913,5,0,57559,21459,913,0
095600,229640,8190,2,360,4.6,125.03,322273,402927,80654,3096,4490,1394,742709,8190,8190,8190,3623,13,2,56988,22200,2561,1062
095700,229640,8190,2,360,4.6,124.57,323910,403510,79600,3104,4492,1388,744929,8190,8200,8190,250,5,1,56976,24404,238,12
095800,229640,8190,2,360,4.6,123.62,326399,403510,77111,3115,4492,1377,747418,8190,8190,8190,900,1,0,57774,24297,900,0
095800,229640,8180,2,350,4.47,122.82,328553,403524,74971,3127,4494,1367,749586,8190,8200,8180,3068,13,2,55575,24160,3054,14
095900,229640,8200,2,370,4.73,122.87,328614,403758,75144,3128,4500,1372,749881,8180,8200,8180,234,0,6,55478,22753,0,234
100000,229640,8150,2,320,4.09,122.08,330891,403958,73067,3136,4501,1365,752358,8150,8150,8150,0,0,0,56357,23023,0,0
100000,229640,8200,2,370,4.73,122.43,330996,405252,74256,3137,4518,1381,753757,8190,8200,8180,1399,1,17,60065,24778,105,1294
100100,229640,8200,2,370,4.73,121.97,332550,405606,73056,3142,4523,1381,755665,8190,8200,8190,125,0,2,61112,25176,0,125
100100,229640,8190,2,360,4.6,122.0,332675,405848,73173,3146,4534,1388,756032,8190,8200,8170,492,4,13,56694,26630,125,367
100200,229640,8190,2,360,4.6,122.11,333171,406836,73665,3148,4538,1390,757516,8190,8190,8180,1484,2,4,63726,25663,496,988
100300,229640,8190,2,360,4.6,122.09,333344,406973,73629,3151,4546,1395,757826,8200,8200,8190,88,2,5,59328,27317,83,5
100300,229640,8180,2,350,4.47,122.04,333482,406989,73507,3154,4548,1394,757980,8200,8200,8180,242,5,7,58770,27386,221,21
100400,229640,8180,2,350,4.47,121.93,333814,407016,73202,3158,4551,1393,758339,8180,8180,8180,340,4,2,55099,28597,332,8
100500,229640,8170,2,340,4.34,121.55,334919,407086,72167,3162,4552,1390,759519,8170,8170,8170,0,0,0,53979,28450,0,0
100500,229640,8170,2,340,4.34,121.5,335066,407099,72033,3167,4554,1387,759679,8170,8180,8170,160,5,2,43785,28831,147,13
100600,229640,8170,2,340,4.34,121.56,335229,407509,72280,3171,4563,1392,760252,8170,8170,8160,149,3,8,42403,28479,39,110
100600,229640,8170,2,340,4.34,121.54,335334,407566,72232,3172,4573,1401,760414,8170,8170,8160,311,4,18,43589,28202,144,167
100700,229640,8170,2,340,4.34,121.63,335349,407888,72539,3174,4585,1411,760751,8170,8170,8160,30,1,9,44129,28078,10,20
100800,229640,8160,2,330,4.21,121.4,335995,407907,71912,3176,4587,1411,761416,8160,8160,8160,0,0,0,30905,27701,0,0
100800,229640,8140,2,310,3.96,119.99,340039,407997,67958,3181,4588,1407,766636,8150,8160,8140,5220,5,1,33373,29568,4044,90
100900,229640,8160,2,330,4.21,119.57,341239,408017,66778,3183,4591,1408,767856,8140,8160,8140,202,1,1,34437,28900,200,2
100900,229640,8160,2,330,4.21,119.21,342288,408029,65741,3186,4595,1409,768917,8140,8160,8140,1263,4,5,33437,29272,1249,14
101000,229640,8180,2,350,4.47,119.85,342378,410328,67950,3187,4601,1414,771306,8160,8180,8160,2389,1,6,59182,24252,90,2299
101100,229640,8190,2,360,4.6,120.05,342381,411040,68659,3188,4611,1423,772021,8190,8190,8190,0,0,0,65695,26256,0,0
101100,229640,8160,2,330,4.21,119.96,342833,411262,68429,3190,4618,1428,772695,8180,8180,8160,674,2,7,60810,26608,452,222
101200,229640,8180,2,350,4.47,119.93,343058,411441,68383,3194,4624,1430,773099,8180,8180,8180,81,0,3,63060,27189,0,81
101200,229640,8190,2,360,4.6,119.94,343058,411459,68401,3194,4627,1433,773117,8180,8190,8180,99,0,6,70603,27218,0,99
101300,229640,8180,2,350,4.47,119.95,343058,411497,68439,3194,4633,1439,773155,8180,8180,8180,12,0,2,64590,25746,0,12
101300,229640,8180,2,350,4.47,120.38,343079,413009,69930,3196,4638,1442,774688,8180,8180,8170,1545,2,7,65241,25713,21,1524
101400,229640,8180,2,350,4.47,120.38,343151,413074,69923,3198,4644,1446,774825,8180,8180,8170,135,2,4,65601,26695,72,63
101500,229640,8170,2,340,4.34,120.35,343380,413243,69863,3200,4647,1447,775223,8170,8170,8170,0,0,0,51699,28082,0,0
101500,229640,8150,2,320,4.09,120.16,343974,413331,69357,3202,4653,1451,775905,8170,8170,8150,682,2,6,39451,27961,594,88
101600,229640,8150,2,320,4.09,120.22,344558,414234,69676,3207,4656,1449,777392,8150,8150,8150,504,2,0,53735,28461,504,0
101600,229640,8140,2,310,3.96,119.53,347354,415200,67846,3212,4659,1447,781154,8150,8160,8140,4266,7,3,39690,28612,3300,966
101700,229640,8130,2,300,3.83,119.02,349301,415752,66451,3216,4664,1448,783653,8140,8140,8130,1406,2,2,55005,28218,947,459
101700,229640,8140,2,310,3.96,118.99,349401,415752,66351,3217,4664,1447,783753,8140,8140,8130,1506,3,2,54936,26633,1047,459
101800,229640,8140,2,310,3.96,118.14,351912,415757,63845,3224,4665,1441,786269,8140,8140,8130,1470,4,1,38697,25254,1465,5
101900,229640,8140,2,310,3.96,117.67,353336,415779,62443,3228,4666,1438,787715,8140,8140,8140,0,0,0,30985,25106,0,0
101900,229640,8140,2,310,3.96,117.32,354837,416292,61455,3233,4670,1437,789729,8140,8140,8130,2014,5,4,26816,25570,1501,513
102000,229640,8130,2,300,3.83,117.29,354939,416292,61353,3235,4670,1435,789831,8130,8130,8130,0,0,0,26514,26482,0,0
102000,229640,8130,2,300,3.83,116.59,357293,416579,59286,3240,4673,1433,792472,8130,8130,8130,2641,5,3,21209,26935,2354,287
102100,229640,8130,2,300,3.83,116.56,357472,416682,59210,3244,4674,1430,792754,8120,8130,8120,105,1,1,18328,27200,2,103
102100,229640,8120,2,290,3.7,115.2,362003,417020,55017,3248,4679,1431,797623,8120,8130,8120,4974,5,6,17697,22879,4533,441
102200,229640,8130,2,300,3.83,115.18,362262,417241,54979,3250,4685,1435,798103,8130,8130,8120,480,2,6,22786,21137,259,221
102300,229640,8130,2,300,3.83,114.83,363344,417241,53897,3254,4685,1431,799185,8130,8130,8130,0,0,0,22758,21992,0,0
102300,229640,8140,2,310,3.96,114.83,363360,417252,53892,3257,4686,1429,799212,8130,8140,8130,27,3,1,22738,22460,16,11
102400,229640,8140,2,310,3.96,114.83,363360,417252,53892,3257,4686,1429,799212,8140,8140,8140,0,0,0,22738,22460,0,0
102400,229640,8130,2,300,3.83,114.75,363643,417273,53630,3260,4687,1427,799516,8140,8140,8130,304,3,1,24780,22022,283,21
102500,229640,8130,2,300,3.83,114.46,364784,417525,52741,3267,4689,1422,800909,8130,8130,8130,1265,3,2,19423,22103,1013,252
102500,229640,8120,2,290,3.7,114.05,366262,417725,51463,3270,4690,1420,802587,8130,8130,8120,2943,6,3,19236,21756,2491,452
102600,229640,8120,2,290,3.7,113.59,368741,418843,50102,3275,4696,1421,806184,8120,8130,8110,3597,5,6,14973,19230,2479,1118
102700,229640,8110,2,280,3.58,113.23,370353,419343,48990,3279,4703,1424,808296,8110,8110,8110,50,1,0,13625,18195,50,0
102700,229640,8110,2,280,3.58,112.47,373197,419727,46530,3288,4706,1418,811524,8110,8110,8110,3278,10,3,11953,19066,2894,384
102800,229640,8100,2,270,3.45,111.56,376286,419785,43499,3294,4708,1414,814671,8110,8110,8100,753,3,0,13873,15498,753,0
102800,229640,8090,2,260,3.32,109.87,382947,420738,37791,3302,4720,1418,822285,8110,8110,8070,8367,11,12,9679,22607,7414,953
102900,229640,8090,2,260,3.32,109.13,385537,420739,35202,3309,4721,1412,824876,8090,8100,8090,2316,4,1,11080,19632,2315,1
103000,229640,8090,2,260,3.32,109.38,385580,421740,36160,3310,4723,1413,825920,8090,8090,8090,0,0,0,12209,18720,0,0
103000,229640,8090,2,260,3.32,109.25,386060,421760,35700,3314,4725,1411,826420,8090,8090,8070,500,4,2,11528,21261,480,20
103100,229640,8070,2,240,3.07,109.29,386067,421929,35862,3315,4729,1414,826596,8090,8090,8070,145,1,2,11779,21345,7,138
103100,229640,8070,2,240,3.07,108.88,387599,422029,34430,3326,4730,1404,828228,8090,8090,8060,1777,12,3,13379,20904,1539,238
103200,229640,8090,2,260,3.32,108.39,389447,422139,32692,3329,4732,1403,830186,8090,8090,8090,195,2,2,11195,17442,85,110
103200,229640,8100,2,270,3.45,108.38,389526,422162,32636,3331,4737,1406,830288,8090,8100,8090,297,4,7,14359,15570,164,133
103300,229640,8090,2,260,3.32,108.26,389965,422162,32197,3335,4737,1402,830727,8090,8090,8090,432,3,0,14556,17673,432,0
103400,229640,8090,2,260,3.32,108.26,389965,422165,32200,3335,4739,1404,830730,8090,8090,8090,0,0,0,12881,19021,0,0
103400,229640,8080,2,250,3.19,108.15,390366,422172,31806,3337,4741,1404,831138,8090,8090,8080,408,2,2,13028,21372,401,7
103500,229640,8080,2,250,3.19,108.11,390647,422328,31681,3339,4743,1404,831979,8080,8080,8080,102,1,0,14611,21343,102,0
103500,229640,8080,2,250,3.19,107.71,392090,422339,30249,3340,4746,1406,833433,8080,8080,8080,1556,2,3,11571,23947,1545,11
103600,229640,8080,2,250,3.19,107.45,393076,422344,29268,3346,4748,1402,834424,8070,8080,8070,375,3,1,11718,23805,371,4
103600,229640,8100,2,270,3.45,107.51,393277,422830,29553,3350,4753,1403,835111,8070,8100,8070,1062,7,6,16123,18745,572,490
103700,229640,8100,2,270,3.45,107.68,393282,423475,30193,3351,4754,1403,835761,8100,8100,8100,650,1,1,19753,14151,5,645
103800,229640,8100,2,270,3.45,107.58,394047,423897,29850,3353,4757,1404,836948,8100,8100,8100,35,0,1,16448,18989,0,35
103800,229640,8090,2,260,3.32,107.54,394277,424002,29725,3357,4759,1402,837283,8100,8100,8090,370,4,3,16134,19100,230,140
103900,229640,8070,2,240,3.07,107.23,395411,424002,28591,3362,4759,1397,838417,8080,8080,8070,703,2,0,16134,20729,703,0
103900,229640,8100,2,270,3.45,106.65,397567,424004,26437,3367,4760,1393,840575,8080,8100,8060,2861,7,1,16134,25073,2859,2
104000,229640,8100,2,270,3.45,106.8,397871,424930,27059,3368,4764,1396,841805,8100,8100,8100,6,0,2,19055,23007,0,6
104100,229640,8080,2,250,3.19,106.73,398785,425637,26852,3372,4770,1398,843426,8080,8080,8080,0,0,0,17195,22193,0,0
104100,229640,8080,2,250,3.19,106.66,399592,426192,26600,3377,4778,1401,844788,8080,8080,8070,1362,5,8,18025,21961,807,555
104200,229640,8070,2,240,3.07,106.52,400093,426192,26099,3379,4778,1399,845289,8070,8070,8070,0,0,0,18025,25503,0,0
104200,229640,8070,2,240,3.07,106.52,400133,426213,26080,3381,4780,1399,845350,8070,8090,8070,61,2,2,18026,26048,40,21
104300,229640,8090,2,260,3.32,106.42,400996,426749,25753,3383,4782,1399,846749,8070,8090,8070,1399,2,2,16826,24991,863,536
104400,229640,8080,2,250,3.19,106.4,401098,426749,25651,3384,4782,1398,846851,8080,8080,8080,0,0,0,19247,21636,0,0
104400,229640,8070,2,240,3.07,106.03,402461,426749,24288,3387,4782,1395,848214,8080,8080,8070,1363,3,0,19231,24368,1363,0
104500,229640,8070,2,240,3.07,106.03,402471,426749,24278,3388,4782,1394,848224,8070,8070,8070,10,1,0,19403,25827,10,0
104500,229640,8090,2,260,3.32,106.0,402730,426874,24144,3389,4786,1397,848608,8070,8090,8070,394,2,4,17051,23330,269,125
104600,229640,8100,2,270,3.45,106.14,402731,427476,24745,3390,4788,1398,849211,8100,8100,8090,603,1,2,15803,18696,1,602
104700,229640,8110,2,280,3.58,106.82,402732,430206,27474,3391,4794,1403,851942,8110,8110,8110,2,0,1,20097,14005,0,2
104700,229640,8120,2,290,3.7,107.12,402768,431447,28679,3394,4798,1404,853219,8110,8120,8100,1279,3,5,20743,13227,36,1243
104800,229640,8130,2,300,3.83,107.51,402858,433121,30263,3396,4802,1406,854983,8130,8130,8120,344,1,3,20747,12198,70,274
104900,229640,8130,2,300,3.83,107.75,402967,434193,31226,3399,4807,1408,856164,8130,8130,8130,3,1,0,25052,9322,3,0
104900,229640,8140,2,310,3.96,107.79,402967,434354,31387,3399,4811,1412,856325,8130,8140,8130,164,1,4,25025,10153,3,161
105000,229640,8140,2,310,3.96,107.95,402967,435011,32044,3399,4815,1416,856982,8140,8140,8140,641,0,1,24039,10110,0,641
105000,229640,8140,2,310,3.96,108.18,402967,435943,32976,3399,4818,1419,857914,8140,8140,8140,1573,0,4,22698,10096,0,1573
105100,229640,8150,2,320,4.09,108.09,403492,436145,32653,3402,4822,1420,858641,8140,8150,8140,425,2,4,29148,8775,223,202
105200,229640,8140,2,310,3.96,108.07,403641,436196,32555,3404,4824,1420,858841,8140,8140,8130,101,1,2,23630,8566,50,51
105200,229640,8120,2,290,3.7,107.94,404101,436197,32096,3407,4825,1418,859302,8140,8140,8120,562,4,3,23668,9913,510,52
105300,229640,8130,2,300,3.83,107.94,404118,436197,32079,3408,4825,1417,859319,8130,8130,8130,17,1,0,23378,8301,17,0
105300,229640,8130,2,300,3.83,107.93,404180,436225,32045,3409,4826,1417,859409,8130,8130,8130,107,2,1,18299,11481,79,28
105400,229640,8140,2,310,3.96,107.93,404180,436228,32048,3409,4828,1419,859412,8140,8140,8140,1,0,1,23701,11647,0,1
105500,229640,8140,2,310,3.96,108.18,404244,437297,33053,3410,4832,1422,860545,8140,8140,8140,1,0,1,23797,11025,0,1
105500,229640,8140,2,310,3.96,108.07,405242,437930,32688,3411,4834,1423,862176,8140,8140,8140,1632,1,3,30191,8765,998,634
105600,229640,8120,2,290,3.7,108.07,405244,437930,32686,3412,4834,1422,862178,8120,8120,8120,0,0,0,26865,9553,0,0
105600,229640,8070,2,240,3.07,107.74,406822,438293,31471,3419,4835,1416,864119,8130,8130,8070,1941,7,1,21229,9625,1578,363
105700,229640,8100,2,270,3.45,107.73,406835,438297,31462,3421,4837,1416,864136,8100,8100,8100,15,2,1,19006,15522,13,2
105700,229640,8070,2,240,3.07,106.76,411687,439504,27817,3426,4838,1412,870195,8100,8100,8070,6074,7,2,21807,17605,4865,1209
105800,229640,8120,2,290,3.7,106.75,411748,439556,27808,3428,4840,1412,870308,8070,8120,8070,112,1,2,19530,21782,60,52
105800,229640,8070,2,240,3.07,106.75,411749,439560,27811,3429,4841,1412,870313,8070,8120,8070,117,2,3,20089,23367,61,56
105900,229640,8070,2,240,3.07,106.58,412429,439560,27131,3431,4841,1410,870993,8080,8080,8070,680,2,0,18679,19419,680,0
110000,229640,8100,2,270,3.45,106.58,412429,439563,27134,3431,4843,1412,870996,8100,8100,8100,0,0,0,15349,19701,0,0
110000,229640,8120,2,290,3.7,106.98,412429,441233,28804,3431,4848,1417,872666,8100,8120,8100,1670,0,5,19855,31344,0,1670
110100,229640,8120,2,290,3.7,106.98,412429,441233,28804,3431,4848,1417,872666,8120,8120,8120,0,0,0,19855,31344,0,0
110100,229640,8130,2,300,3.83,106.89,412948,441380,28432,3434,4850,1416,873332,8130,8130,8120,666,3,2,22028,22466,519,147
110200,229640,8120,2,290,3.7,106.88,413054,441479,28425,3435,4851,1416,873537,8130,8130,8120,205,1,1,22387,22997,106,99
110200,229640,8130,2,300,3.83,107.09,413696,443015,29319,3441,4856,1415,875715,8130,8130,8120,2383,7,6,26242,21146,748,1635
110300,229640,8130,2,300,3.83,106.96,414406,443244,28838,3445,4857,1412,876654,8130,8130,8130,939,4,1,21607,23628,710,229
110400,229640,8130,2,300,3.83,107.87,414784,447439,32655,3449,4865,1416,881227,8130,8130,8130,2,1,0,29264,23086,2,0
110400,229640,8130,2,300,3.83,107.84,414906,447439,32533,3452,4865,1413,881349,8130,8130,8130,124,4,0,29264,22164,124,0
110500,229640,8150,2,320,4.09,107.84,414906,447454,32548,3452,4867,1415,881364,8150,8150,8150,5,0,1,29966,22188,0,5
110500,229640,8150,2,320,4.09,107.85,414906,447471,32565,3452,4871,1419,881381,8150,8150,8150,22,0,5,31572,21279,0,22
110600,229640,8140,2,310,3.96,107.78,415194,447481,32287,3453,4872,1419,881679,8150,8150,8140,298,1,1,32123,21325,288,10
110600,229640,8140,2,310,3.96,107.79,415194,447535,32341,3453,4874,1421,881733,8150,8150,8140,352,1,3,26186,22680,288,64
110700,229640,8130,2,300,3.83,107.63,415873,447612,31739,3455,4875,1420,882489,8140,8140,8130,97,1,1,25410,22092,20,77
110800,229640,8140,2,310,3.96,106.91,418773,447708,28935,3461,4878,1417,885485,8140,8140,8140,0,0,0,25302,26123,0,0
110800,229640,8140,2,310,3.96,106.91,418773,447711,28938,3461,4880,1419,885488,8140,8140,8140,3,0,2,25536,24609,0,3
110900,229640,8120,2,290,3.7,106.87,418963,447748,28785,3464,4882,1418,885715,8140,8140,8120,197,3,1,32104,20759,190,7
110900,229640,8150,2,320,4.09,106.87,418963,447750,28787,3464,4884,1420,885717,8140,8150,8120,199,3,3,32103,22594,190,9
111000,229640,8140,2,310,3.96,106.87,418963,447751,28788,3464,4885,1421,885718,8140,8140,8140,1,0,1,26188,24576,0,1
111000,229640,8140,2,310,3.96,106.87,418963,447751,28788,3464,4885,1421,885718,8140,8140,8140,1,0,1,26188,24576,0,1
111100,229640,8140,2,310,3.96,106.69,419687,447764,28077,3466,4888,1422,886483,8140,8140,8110,765,2,3,26293,26532,724,13
111200,229640,8130,2,300,3.83,106.54,420309,447809,27500,3469,4891,1422,887155,8130,8130,8130,0,0,0,20554,28406,0,0
111200,229640,8110,2,280,3.58,106.54,420339,447810,27471,3470,4892,1422,887186,8130,8130,8110,31,1,1,20763,26434,30,1
111300,229640,8110,2,280,3.58,106.58,420634,448314,27680,3472,4893,1421,887985,8110,8110,8110,761,1,1,17839,28776,257,504
111300,229640,8120,2,290,3.7,106.58,420660,448327,27667,3473,4897,1424,888024,8110,8120,8110,800,2,5,19789,27057,283,517
111400,229640,8100,2,270,3.45,106.46,421138,448329,27191,3477,4898,1421,888504,8110,8110,8100,473,3,0,19786,29107,473,0
111400,229640,8100,2,270,3.45,106.09,422743,448502,25759,3478,4899,1421,890282,8110,8110,8100,2251,4,1,15387,32182,2078,173
111500,229640,8080,2,250,3.19,105.32,425843,448502,22659,3483,4899,1416,895737,8100,8100,8080,5455,5,0,20514,31052,3100,0
111600,229640,8090,2,260,3.32,105.32,425844,448502,22658,3484,4899,1415,895738,8090,8090,8090,0,0,0,15731,29566,0,0
111600,229640,8110,2,280,3.58,105.3,425909,448503,22594,3486,4900,1414,895804,8090,8110,8090,66,2,1,16261,29662,65,1
111700,229640,8100,2,270,3.45,105.32,425986,448652,22666,3487,4904,1417,896030,8100,8100,8100,77,1,0,16258,26570,77,0
111700,229640,8090,2,260,3.32,105.27,426555,449033,22478,3489,4905,1416,896980,8100,8100,8090,1027,3,1,15772,26778,646,381
111800,229640,8100,2,270,3.45,105.37,426593,449519,22926,3490,4908,1418,897504,8100,8100,8100,486,0,3,13284,31026,0,486
111800,229640,8090,2,260,3.32,105.35,426693,449519,22826,3491,4908,1417,897604,8100,8100,8090,586,1,3,15922,31226,100,486
111900,229640,8100,2,270,3.45,105.45,426695,449948,23253,3492,4910,1418,898035,8090,8100,8090,431,1,2,13076,31302,2,429
112000,229640,8100,2,270,3.45,105.46,426695,449979,23284,3492,4912,1420,898066,8100,8100,8100,0,0,0,13074,31666,0,0
112000,229640,8100,2,270,3.45,105.42,426869,450005,23136,3493,4913,1420,898266,8100,8100,8100,200,1,1,13071,31608,174,26
112100,229640,8100,2,270,3.45,105.38,427065,450028,22963,3494,4914,1420,898485,8100,8100,8100,23,0,1,13307,31636,0,23
112100,229640,8100,2,270,3.45,105.07,428575,450323,21748,3497,4917,1420,900290,8100,8100,8090,1828,3,4,14417,30685,1510,318
112200,229640,8090,2,260,3.32,105.07,428576,450326,21750,3498,4918,1420,900294,8100,8100,8090,4,1,1,14358,31250,1,3
112200,229640,8100,2,270,3.45,105.01,428986,450467,21481,3499,4921,1422,900845,8100,8100,8090,555,2,4,14355,30791,411,144
112300,229640,8090,2,260,3.32,104.93,429286,450467,21181,3502,4921,1419,901145,8090,8090,8090,300,3,0,14622,30638,300,0
112300,229640,8100,2,270,3.45,104.42,431455,450522,19067,3506,4923,1417,903369,8090,8100,8080,2524,7,2,12895,29528,2469,55
112400,229640,8090,2,260,3.32,103.98,433432,450667,17235,3508,4927,1419,905491,8090,8090,8080,2122,2,4,10534,28063,1977,145
112500,229640,8100,2,270,3.45,103.54,435478,450882,15404,3509,4930,1421,907752,8100,8100,8100,0,0,0,12991,26411,0,0
112500,229640,8100,2,270,3.45,103.54,435478,450885,15407,3509,4932,1423,907755,8100,8100,8100,3,0,2,13291,26420,0,3
112600,229640,8090,2,260,3.32,103.32,436376,450885,14509,3514,4932,1418,908653,8090,8090,8090,0,0,0,13310,25944,0,0
112600,229640,8090,2,260,3.32,103.32,436376,450885,14509,3514,4932,1418,908653,8090,8090,8090,0,0,0,13310,25944,0,0
112700,229640,8090,2,260,3.32,103.27,436629,450885,14256,3515,4932,1417,908906,8090,8090,8090,253,1,0,13760,25787,253,0
112700,229640,8100,2,270,3.45,103.32,436730,451242,14512,3517,4935,1418,909364,8090,8100,8090,711,3,3,13792,25435,354,357
112800,229640,8100,2,270,3.45,103.32,436730,451245,14515,3517,4937,1420,909367,8100,8100,8100,3,0,2,13802,25761,0,3
112900,229640,8090,2,260,3.32,103.22,437153,451245,14092,3520,4937,1417,909790,8090,8090,8090,0,0,0,13301,25652,0,0
112900,229640,8080,2,250,3.19,102.44,440478,451247,10769,3522,4938,1416,913117,8090,8090,8080,3327,2,1,10294,26336,3325,2
113000,229640,8080,2,250,3.19,102.07,442393,451564,9171,3524,4943,1419,915349,8080,8080,8080,16,0,2,9929,24704,0,16
113000,229640,8070,2,240,3.07,102.01,442817,451738,8921,3526,4947,1421,915947,8080,8080,8070,614,2,6,10210,24657,424,190
113100,229640,8090,2,260,3.32,102.06,442914,452027,9113,3528,4953,1425,916333,8080,8090,8080,289,0,6,12800,24992,0,289
113100,229640,8090,2,260,3.32,102.06,442914,452037,9123,3528,4954,1426,916343,8080,8090,8080,299,0,7,12798,21808,0,299
113200,229640,8080,2,250,3.19,102.04,443069,452110,9041,3529,4956,1427,916571,8090,8090,8080,228,1,2,10119,25020,155,73
113200,229640,8080,2,250,3.19,102.04,443069,452111,9042,3529,4957,1428,916572,8090,8090,8080,229,1,3,10047,25184,155,74
113300,229640,8070,2,240,3.07,101.82,444011,452111,8100,3535,4957,1422,917514,8070,8070,8070,942,6,0,9648,24478,942,0
113400,229640,8060,2,230,2.94,101.54,445484,452360,6876,3540,4959,1419,919236,8060,8060,8060,25,1,0,8232,25979,25,0
113400,229640,8080,2,250,3.19,100.43,450648,452593,1945,3553,4965,1412,924663,8060,8080,8040,5452,14,6,9105,23496,5189,233
113500,229640,8070,2,240,3.07,100.43,450693,452610,1917,3554,4966,1412,924725,8070,8070,8070,17,0,1,6883,20443,0,17
113500,229640,8050,2,220,2.81,100.03,452477,452610,133,3563,4966,1403,926509,8070,8070,8040,1801,9,1,7466,22380,1784,17
113600,229640,8050,2,220,2.81,100.03,452492,452610,118,3565,4966,1401,926524,8050,8050,8050,5,1,0,7506,21788,5,0
113600,229640,8050,2,220,2.81,100.0,452614,452612,-2,3567,4967,1400,926648,8050,8070,8050,129,3,1,7827,21664,127,2
113700,229640,8020,2,190,2.43,99.21,456198,452612,-3586,3581,4967,1386,930232,8050,8050,8020,3584,14,0,6777,26873,3584,0
113800,229640,8020,2,190,2.43,99.1,456824,452718,-4106,3583,4969,1386,930964,8020,8020,8020,0,0,0,7765,27913,0,0
113800,229640,8030,2,200,2.55,99.07,456960,452719,-4241,3585,4970,1385,931101,8040,8040,8030,137,2,1,6255,26155,136,1
113900,229640,8030,2,200,2.55,98.95,457501,452719,-4782,3588,4970,1382,931642,8030,8030,8030,3,1,0,6280,27600,3,0
113900,229640,8040,2,210,2.68,98.88,457919,452809,-5110,3590,4974,1384,932150,8030,8040,8030,511,3,4,6227,28424,421,90
114000,229640,8040,2,210,2.68,98.89,457919,452819,-5100,3590,4975,1385,932160,8040,8040,8040,0,0,0,6275,28434,0,0
114000,229640,8030,2,200,2.55,98.54,459536,452819,-6717,3594,4975,1381,933777,8030,8030,8030,1617,4,0,6275,26961,1617,0
114100,229640,8040,2,210,2.68,98.53,459641,452877,-6764,3596,4976,1380,933940,8030,8040,8030,163,2,1,6338,26885,105,58
114200,229640,8040,2,210,2.68,98.4,460259,452887,-7372,3598,4979,1381,934568,8040,8040,8040,0,0,0,6301,26914,0,0
114200,229640,8040,2,210,2.68,98.38,460669,453193,-7476,3599,4984,1385,935284,8030,8040,8030,716,1,5,6118,26956,410,306
114300,229640,8040,2,210,2.68,98.3,461019,453200,-7819,3601,4985,1384,935641,8040,8040,8040,0,0,0,7635,21736,0,0
114300,229640,8050,2,220,2.81,98.21,461480,453201,-8279,3603,4986,1383,936103,8040,8050,8040,462,2,1,6430,28115,461,1
114400,229640,8060,2,230,2.94,98.22,461480,453280,-8200,3603,4991,1388,936182,8060,8060,8060,21,0,2,7896,22353,0,21
114400,229640,8050,2,220,2.81,98.21,461576,453291,-8285,3604,4993,1389,936289,8060,8060,8050,128,1,4,6253,27884,96,32
114500,229640,8040,2,210,2.68,97.97,462673,453291,-9382,3609,4993,1384,937386,8040,8040,8040,557,3,0,5929,26929,557,0
114500,229640,8040,2,210,2.68,97.93,462855,453295,-9560,3611,4996,1385,937572,8040,8050,8040,743,5,3,4896,27784,739,4
114600,229640,8040,2,210,2.68,97.98,462856,453486,-9370,3612,4999,1387,937764,8030,8040,8030,192,1,3,5225,28774,1,191
114700,229640,8020,2,190,2.43,97.88,463344,453498,-9846,3615,5001,1386,938264,8020,8020,8020,6,1,0,3435,29461,6,0
114700,229640,8020,2,190,2.43,97.75,463960,453498,-10462,3617,5001,1384,938880,8020,8020,8020,622,3,0,3435,29453,622,0
114800,229640,8040,2,210,2.68,97.74,464110,453636,-10474,3618,5005,1387,939168,8040,8040,8040,62,0,1,5160,29291,0,62
114800,229640,8030,2,200,2.55,97.78,464130,453838,-10292,3619,5007,1388,939390,8040,8040,8030,284,1,3,4895,28434,20,264
114900,229640,8030,2,200,2.55,97.85,464220,454228,-9992,3620,5010,1390,939870,8030,8030,8030,90,0,2,3094,26249,0,90
114900,229640,8030,2,200,2.55,97.81,464418,454228,-10190,3623,5010,1387,940068,8030,8030,8030,288,3,2,5198,26011,198,90
115000,229640,8040,2,210,2.68,97.76,464829,454401,-10428,3624,5013,1389,940652,8040,8040,8030,584,1,3,5036,27715,411,173
115100,229640,8040,2,210,2.68,97.82,464829,454691,-10138,3624,5014,1390,940942,8040,8040,8040,0,0,0,5215,25715,0,0
115100,229640,8060,2,230,2.94,97.77,465330,454939,-10391,3627,5020,1393,941691,8050,8060,8030,749,3,6,5926,25481,501,248
115200,229640,8050,2,220,2.81,97.77,465336,454939,-10397,3628,5020,1392,941697,8050,8050,8050,0,0,0,7412,19145,0,0
115200,229640,8050,2,220,2.81,97.86,465336,455376,-9960,3628,5023,1395,942134,8050,8050,8050,437,0,3,6054,24841,0,437
115300,229640,8050,2,220,2.81,97.87,465336,455408,-9928,3628,5024,1396,942234,8050,8050,8050,0,0,0,7422,24673,0,0
115300,229640,8050,2,220,2.81,97.87,465336,455411,-9925,3628,5025,1397,942237,8050,8050,8050,3,0,1,6367,25144,0,3
115400,229640,8050,2,220,2.81,97.9,465336,455552,-9784,3628,5028,1400,942378,8050,8050,8050,139,0,2,6347,25127,0,139
115400,229640,8050,2,220,2.81,97.9,465343,455572,-9771,3629,5030,1401,942405,8050,8050,8040,166,1,4,6196,25133,7,159
115500,229640,8040,2,210,2.68,97.81,465753,455573,-10180,3630,5031,1401,942816,8050,8050,8040,411,1,1,6195,25141,410,1
115600,229640,8050,2,220,2.81,97.83,465753,455635,-10118,3630,5032,1402,942878,8050,8050,8050,0,0,0,6195,24857,0,0
115600,229640,8040,2,210,2.68,97.83,465754,455635,-10119,3631,5032,1401,942879,8040,8040,8040,1,1,0,6136,24878,1,0
115700,229640,8030,2,200,2.55,97.67,466563,455699,-10864,3634,5034,1400,943752,8040,8040,8030,103,1,1,6479,26239,41,62
115700,229640,8040,2,210,2.68,97.33,468209,455702,-12507,3636,5035,1399,945401,8040,8040,8030,1752,3,2,4923,24759,1687,65
115800,229640,8040,2,210,2.68,97.3,468508,455839,-12669,3638,5038,1400,945837,8040,8040,8040,299,2,0,6166,23687,299,0
115800,229640,8030,2,200,2.55,97.22,468917,455901,-13016,3640,5040,1400,946308,8040,8040,8030,770,4,2,5664,24394,708,62
115900,229640,8030,2,200,2.55,97.23,468968,455963,-13005,3641,5041,1400,946421,8020,8030,8020,113,1,1,3902,27509,51,62
120000,229640,8030,2,200,2.55,97.1,469668,456071,-13597,3642,5044,1402,947229,8030,8030,8030,0,0,0,4270,27565,0,0
120000,229640,8030,2,200,2.55,97.03,471158,457181,-13977,3645,5048,1403,949829,8030,8030,8020,2600,3,4,4588,27869,1490,1110
120100,229640,8020,2,190,2.43,96.83,472215,457250,-14965,3655,5056,1401,950955,8030,8040,8020,1064,10,7,6456,27480,1057,7
120100,229640,8050,2,220,2.81,97.02,472276,458203,-14073,3716,5124,1408,951969,8030,8050,8020,2078,71,75,6719,26216,1118,960
120200,229640,8040,2,210,2.68,97.11,472661,458980,-13681,3782,5191,1409,953131,8050,8060,8040,330,35,33,8081,26470,198,132
120200,229640,8050,2,220,2.81,97.06,472930,459044,-13886,3846,5254,1408,953464,8050,8060,8040,663,99,96,8498,19913,467,196
120300,229640,8050,2,220,2.81,97.0,473327,459116,-14211,3911,5320,1409,953933,8050,8060,8040,221,49,50,8519,21513,165,56
120300,229640,8050,2,220,2.81,96.77,474662,459307,-15355,3923,5340,1417,955459,8050,8060,8040,1747,61,70,7323,26627,1500,247
120400,229640,8050,2,220,2.81,96.76,474707,459307,-15400,3924,5340,1416,955504,8050,8050,8050,45,1,0,8911,21710,45,0
120500,229640,8050,2,220,2.81,96.66,475215,459327,-15888,3926,5341,1415,956032,8050,8050,8050,500,1,0,8891,21152,500,0
120500,229640,8050,2,220,2.81,96.63,475424,459379,-16045,3927,5343,1416,956293,8050,8050,8050,761,2,2,7433,26248,709,52
120600,229640,8040,2,210,2.68,96.59,475580,459379,-16201,3928,5343,1415,956449,8040,8040,8040,156,1,0,7137,26511,156,0
120600,229640,8040,2,210,2.68,96.5,476065,459380,-16685,3930,5344,1414,956935,8040,8050,8040,642,3,1,7136,26302,641,1
120700,229640,8040,2,210,2.68,96.5,476065,459380,-16685,3930,5344,1414,956935,8040,8040,8040,0,0,0,7136,26302,0,0
120700,229640,8040,2,210,2.68,96.5,476065,459380,-16685,3930,5344,1414,956935,8040,8040,8040,0,0,0,7136,26302,0,0
120800,229640,8040,2,210,2.68,96.43,476430,459432,-16998,3933,5346,1413,957352,8040,8050,8040,417,3,2,7267,26117,365,52
120900,229640,8030,2,200,2.55,96.35,476870,459482,-17388,3936,5347,1411,957842,8030,8030,8030,0,0,0,6458,27516,0,0
120900,229640,8040,2,210,2.68,95.3,482147,459510,-22637,3940,5348,1408,963149,8030,8040,8010,5307,4,1,6458,26341,5277,28
121000,229640,8010,2,180,2.3,95.29,482254,459528,-22726,3943,5349,1406,963274,8030,8030,8010,107,3,0,3697,26828,107,0
121000,229640,7990,2,160,2.04,93.56,491151,459528,-31623,3952,5349,1397,972171,8030,8030,7990,9004,12,0,4880,37838,9004,0
121100,229640,7980,2,150,1.92,93.22,493517,460054,-33463,3957,5353,1396,975063,7980,7990,7980,2036,2,3,3173,37971,1652,384
121100,229640,7970,2,140,1.79,92.85,495500,460054,-35446,3966,5353,1387,977046,7980,7990,7970,4019,11,3,3336,35816,3635,384
121200,229640,7960,2,130,1.66,92.28,498698,460174,-38524,3977,5354,1377,980364,7980,7980,7960,3318,11,1,2714,34257,3198,120
121300,229640,7960,2,130,1.66,92.01,500855,460839,-40016,3985,5357,1372,983186,7960,7960,7960,807,3,1,1503,34541,757,50
121300,229640,7970,2,140,1.79,91.99,501567,461369,-40198,3990,5369,1379,984428,7960,7970,7950,2049,8,13,1024,36063,1469,580
121400,229640,7980,2,150,1.92,92.03,501568,461613,-39955,3991,5375,1384,984673,7980,7980,7980,11,1,2,1124,34775,1,10
121400,229640,7960,2,130,1.66,91.46,505082,461968,-43114,3996,5381,1385,988542,7980,7980,7960,3880,6,8,5352,35479,3515,365
121500,229640,7950,2,120,1.53,91.36,505659,461978,-43681,4000,5382,1382,989129,7960,7960,7950,467,3,1,4582,35807,457,10
121500,229640,7960,2,130,1.66,91.32,505980,462069,-43911,4003,5387,1384,989541,7960,7960,7950,879,6,6,4530,36509,778,101
121600,229640,7960,2,130,1.66,91.44,505980,462647,-43333,4003,5396,1393,990119,7960,7960,7960,578,0,9,5856,38705,0,578
121700,229640,7960,2,130,1.66,91.36,506577,462807,-43770,4005,5401,1396,990876,7960,7960,7960,10,0,1,742,38442,0,10
121700,229640,7960,2,130,1.66,91.39,506587,462962,-43625,4006,5407,1401,991041,7960,7960,7950,175,1,7,579,38442,10,165
121800,229640,7990,2,160,2.04,91.4,506607,463046,-43561,4007,5413,1406,991145,7970,7990,7970,24,1,3,1300,36667,20,4
121800,229640,7990,2,160,2.04,91.47,506700,463495,-43205,4009,5420,1411,991687,7970,7990,7970,566,3,10,3466,35431,113,453
121900,229640,8000,2,170,2.17,91.47,506718,463497,-43221,4010,5422,1412,991707,7990,8000,7990,2,0,2,3748,34090,0,2
121900,229640,7990,2,160,2.04,91.48,506914,463735,-43179,4011,5425,1414,992141,7990,8000,7990,436,1,5,4137,34059,196,240
122000,229640,8000,2,170,2.17,91.78,506914,465260,-41654,4011,5432,1421,993666,7990,8000,7990,1525,0,7,2916,34129,0,1525
122100,229640,7990,2,160,2.04,91.74,507297,465370,-41927,4013,5434,1421,994159,7990,7990,7990,283,1,0,2212,34588,283,0
122100,229640,7990,2,160,2.04,92.03,507972,467510,-40462,4016,5439,1423,996974,7990,8000,7990,3098,4,5,5923,37133,958,2140
122200,229640,7990,2,160,2.04,92.05,507972,467605,-40367,4016,5449,1433,997069,7990,7990,7990,3,0,2,6129,37198,0,3
122200,229640,7990,2,160,2.04,92.12,508103,468055,-40048,4017,5458,1441,997650,7990,7990,7990,584,1,11,5965,37243,131,453
122300,229640,7990,2,160,2.04,92.03,508635,468077,-40558,4019,5461,1442,998204,8000,8000,7990,390,1,2,6235,36553,381,9
122300,229640,7990,2,160,2.04,91.98,508982,468165,-40817,4020,5463,1443,998639,8000,8000,7990,825,2,4,5591,37447,728,97
122400,229640,7980,2,150,1.92,91.99,509043,468247,-40796,4023,5466,1443,998782,7980,7990,7980,133,3,2,5582,37951,61,72
122500,229640,7980,2,150,1.92,91.8,510122,468305,-41817,4028,5469,1441,999919,7980,7980,7980,0,0,0,5591,39183,0,0
122500,229640,7980,2,150,1.92,91.58,511622,468530,-43092,4030,5473,1443,1001644,7980,7990,7970,1725,2,4,5451,38924,1500,225
122600,229640,7960,2,130,1.66,91.29,513282,468580,-44702,4034,5474,1440,1003354,7970,7970,7960,1010,3,1,5714,37802,960,50
122600,229640,7960,2,130,1.66,91.23,513651,468624,-45027,4036,5476,1440,1003767,7970,7970,7960,1423,5,3,5393,40135,1329,94
122700,229640,7970,2,140,1.79,91.23,513702,468666,-45036,4038,5481,1443,1003860,7970,7970,7970,78,1,4,5756,39865,40,38
122700,229640,7970,2,140,1.79,91.22,513802,468697,-45105,4039,5484,1445,1003991,7970,7970,7960,209,2,7,5725,39748,140,69
122800,229640,7970,2,140,1.79,90.45,518382,468893,-49489,4043,5487,1444,1008767,7960,7970,7960,155,2,1,1365,35870,153,2
122900,229640,7970,2,140,1.79,90.41,518616,468896,-49720,4044,5490,1446,1009004,7970,7970,7970,0,0,0,1613,35891,0,0
122900,229640,7970,2,140,1.79,90.45,518616,469106,-49510,4044,5497,1453,1009214,7970,7970,7970,210,0,7,1694,36154,0,210
123000,229640,7990,2,160,2.04,90.73,518697,470628,-48069,4045,5506,1461,1010817,7990,7990,7990,330,0,4,865,35458,0,330
123000,229640,7990,2,160,2.04,90.73,518697,470628,-48069,4045,5506,1461,1010817,7990,7990,7990,330,0,4,865,35458,0,330
123100,229640,8000,2,170,2.17,90.73,518697,470630,-48067,4045,5507,1462,1010819,8000,8000,8000,2,0,1,1461,33505,0,2
123100,229640,7980,2,150,1.92,90.63,519280,470631,-48649,4048,5508,1460,1011403,8000,8000,7980,586,3,2,2191,34059,583,3
123200,229640,7980,2,150,1.92,90.63,519298,470631,-48667,4049,5508,1459,1011421,7980,7980,7980,18,1,0,2319,34569,18,0
123300,229640,7960,2,130,1.66,90.55,519728,470631,-49097,4055,5508,1453,1011851,7960,7960,7960,0,0,0,2301,34481,0,0
123300,229640,7970,2,140,1.79,90.55,520216,471043,-49173,4056,5511,1455,1012751,7970,7970,7960,900,1,3,2158,36989,488,412
123400,229640,7950,2,120,1.53,90.72,521589,473175,-48414,4062,5516,1454,1016256,7980,7980,7950,1001,4,1,2018,35584,1000,1
123400,229640,7950,2,120,1.53,90.7,521689,473175,-48514,4063,5516,1453,1016356,7980,7980,7950,1101,5,1,2166,37804,1100,1
123500,229640,7950,2,120,1.53,90.6,522289,473175,-49114,4064,5516,1452,1016956,7950,7950,7950,600,1,0,2483,38626,600,0
123500,229640,7940,2,110,1.4,90.15,524915,473208,-51707,4070,5518,1448,1019615,7950,7950,7940,3259,7,2,2394,36767,3226,33
123600,229640,7950,2,120,1.53,90.15,524915,473221,-51694,4070,5519,1449,1019628,7950,7950,7950,13,0,1,2843,36930,0,13
123600,229640,7960,2,130,1.66,90.19,525169,473639,-51530,4072,5523,1451,1020300,7950,7960,7940,685,2,5,3900,37172,254,431
123700,229640,7950,2,120,1.53,90.14,525448,473639,-51809,4074,5523,1449,1020579,7950,7950,7950,279,2,0,4063,39636,279,0
123800,229640,7960,2,130,1.66,90.27,525448,474300,-51148,4074,5526,1452,1021240,7960,7960,7960,0,0,0,4063,41404,0,0
123800,229640,7960,2,130,1.66,90.2,525860,474301,-51559,4076,5527,1451,1021653,7950,7960,7950,413,2,1,3703,40236,412,1
123900,229640,7970,2,140,1.79,90.23,525862,474501,-51361,4078,5529,1451,1021855,7960,7970,7960,101,1,1,3724,43198,1,100
123900,229640,7970,2,140,1.79,90.29,525913,474838,-51075,4080,5532,1452,1022243,7960,7970,7960,489,3,4,3315,42337,52,437
124000,229640,7960,2,130,1.66,90.37,525914,475244,-50670,4081,5534,1453,1022650,7970,7970,7960,407,1,2,3300,44583,1,406
124000,229640,7970,2,140,1.79,90.43,525915,475568,-50347,4082,5541,1459,1022975,7970,7970,7960,732,2,9,4090,41765,2,730
124100,229640,7970,2,140,1.79,90.4,526375,475853,-50522,4084,5543,1459,1023720,7980,7980,7970,695,1,2,2808,43063,410,285
124200,229640,7980,2,150,1.92,90.5,526377,476377,-50000,4086,5554,1468,1024246,7990,7990,7980,51,1,1,2143,39712,1,50
124200,229640,7990,2,160,2.04,90.5,526377,476379,-49998,4086,5555,1469,1024248,7990,7990,7980,53,1,2,2248,39682,1,52
124300,229640,7980,2,150,1.92,90.51,526444,476509,-49935,4088,5557,1469,1024445,7980,7980,7980,196,1,2,2624,41666,66,130
124300,229640,7990,2,160,2.04,90.57,526444,476777,-49667,4088,5568,1480,1024713,7980,7990,7980,464,1,13,2287,40310,66,398
124400,229640,7990,2,160,2.04,90.6,526444,476944,-49500,4088,5572,1484,1024880,7990,7990,7990,161,0,2,2418,38412,0,161
124400,229640,8000,2,170,2.17,90.54,526855,477032,-49823,4089,5577,1488,1025379,7990,8000,7990,660,1,7,2487,37548,411,249
124500,229640,7990,2,160,2.04,90.44,527435,477034,-50401,4099,5578,1479,1025961,7990,7990,7990,483,9,1,2554,38432,481,2
124600,229640,7990,2,160,2.04,90.47,527561,477303,-50258,4102,5580,1478,1026356,7990,7990,7990,8,1,0,2723,37146,8,0
124600,229640,7990,2,160,2.04,90.41,527926,477304,-50622,4104,5581,1477,1026722,7990,8000,7990,374,3,1,2732,37546,373,1
124700,229640,8000,2,170,2.17,90.56,527926,478079,-49847,4104,5584,1480,1027497,8000,8000,8000,0,0,0,2145,38814,0,0
124700,229640,8000,2,170,2.17,90.6,527928,478280,-49648,4105,5586,1481,1027700,8000,8000,7980,203,1,2,2279,38701,2,201
124800,229640,8000,2,170,2.17,90.56,528332,478451,-49881,4107,5592,1485,1028275,7980,8000,7980,491,1,5,2332,41046,354,137
124800,229640,8000,2,170,2.17,90.58,528332,478562,-49770,4107,5595,1488,1028386,7980,8000,7980,602,1,8,2220,38221,354,248
124900,229640,8000,2,170,2.17,90.72,528332,479329,-49003,4107,5599,1492,1029153,8000,8000,8000,767,0,4,1596,38474,0,767
125000,229640,7990,2,160,2.04,90.72,528410,479373,-49037,4109,5600,1491,1029275,7990,7990,7990,0,0,0,1697,39737,0,0
125000,229640,7970,2,140,1.79,90.53,529510,479373,-50137,4111,5600,1489,1030375,7980,7980,7970,1100,2,0,2368,39771,1100,0
125100,229640,7980,2,150,1.92,90.53,529543,479373,-50170,4113,5600,1487,1030408,7980,7980,7980,0,0,0,2497,39466,0,0
125100,229640,7990,2,160,2.04,90.46,529954,479386,-50568,4114,5603,1489,1030832,7980,7990,7970,424,1,3,2509,39826,411,13
125200,229640,7990,2,160,2.04,90.45,529983,479388,-50595,4115,5605,1490,1030863,7990,7990,7990,1,0,1,2508,38791,0,1
125200,229640,7990,2,160,2.04,90.43,530147,479389,-50758,4116,5606,1490,1031028,7990,7990,7980,166,1,2,2507,39048,164,2
125300,229640,7980,2,150,1.92,90.54,530147,479995,-50152,4116,5622,1506,1031634,7980,7980,7980,126,0,12,2253,40521,0,126
125400,229640,7990,2,160,2.04,90.54,530168,480001,-50167,4118,5627,1509,1031661,7990,7990,7990,0,0,0,2309,40503,0,0
125400,229640,7990,2,160,2.04,90.56,530168,480116,-50052,4118,5632,1514,1031776,7990,7990,7990,115,0,5,1774,38969,0,115
125500,229640,7980,2,150,1.92,90.54,530417,480254,-50163,4120,5637,1517,1032163,7980,7980,7980,0,0,0,1656,40663,0,0
125500,229640,7970,2,140,1.79,90.51,530583,480257,-50326,4122,5639,1517,1032332,7980,7980,7970,169,2,2,3203,42328,166,3
125600,229640,7980,2,150,1.92,90.37,531434,480271,-51163,4125,5645,1520,1033197,7980,7980,7970,864,3,5,8207,41411,851,13
125700,229640,7980,2,150,1.92,90.42,531434,480539,-50895,4125,5652,1527,1033465,7980,7980,7980,0,0,0,7995,41723,0,0
125700,229640,7980,2,150,1.92,90.42,531456,480545,-50911,4126,5654,1528,1033493,7970,7980,7970,28,1,2,8070,42081,22,6
125800,229640,7980,2,150,1.92,90.39,532062,480947,-51115,4129,5661,1532,1034501,7970,7980,7970,6,1,1,7804,41760,4,2
125900,229640,7980,2,150,1.92,90.55,532062,481789,-50273,4129,5665,1536,1035343,7980,7980,7980,0,0,0,7741,42764,0,0
125900,229640,7980,2,150,1.92,90.62,532110,482211,-49899,4130,5674,1544,1035813,7980,7980,7980,470,1,9,7512,42721,48,422
130000,229640,7990,2,160,2.04,90.67,532213,482575,-49638,4131,5678,1547,1036280,7980,7990,7980,104,1,1,7910,42024,103,1
130000,229640,7980,2,150,1.92,90.63,532472,482580,-49892,4134,5680,1546,1036544,7980,7990,7980,368,4,3,8271,42453,362,6
130100,229640,7990,2,160,2.04,90.72,532882,483423,-49459,4135,5685,1550,1037797,7980,7990,7980,1253,1,5,8333,42616,410,843
130200,229640,8000,2,170,2.17,90.75,532882,483574,-49308,4135,5690,1555,1037948,8000,8000,8000,1,0,1,8239,41693,0,1
130200,229640,7990,2,160,2.04,90.83,532912,484028,-48884,4136,5695,1559,1038432,8000,8000,7990,485,1,6,8266,42670,30,455
130300,229640,8000,2,170,2.17,90.79,533142,484030,-49112,4137,5697,1560,1038664,8000,8000,8000,2,0,2,8061,41681,0,2
130400,229640,8000,2,170,2.17,90.81,533142,484155,-48987,4137,5699,1562,1038789,8000,8000,8000,0,0,0,8404,41889,0,0
130400,229640,7980,2,150,1.92,90.72,533764,484232,-49532,4139,5702,1563,1039488,8000,8000,7980,699,2,3,8348,42987,622,77
130500,229640,7980,2,150,1.92,90.61,534402,484232,-50170,4140,5702,1562,1040126,7980,7980,7980,638,1,0,9061,43805,638,0
130600,229640,7990,2,160,2.04,90.59,534866,484534,-50332,4141,5704,1563,1040892,7990,7990,7990,300,0,1,9359,43588,0,300
130600,229640,7980,2,150,1.92,90.43,535839,484534,-51305,4145,5704,1559,1041865,7990,7990,7980,1273,4,1,9136,42362,973,300
130700,229640,7980,2,150,1.92,90.42,535871,484534,-51337,4146,5704,1558,1041897,7980,7980,7980,0,0,0,9136,42337,0,0
130700,229640,7970,2,140,1.79,90.24,537074,484629,-52445,4151,5705,1554,1043195,7980,7980,7970,1298,5,1,9197,44262,1203,95
130800,229640,7980,2,150,1.92,90.24,537077,484662,-52415,4152,5707,1555,1043231,7970,7980,7970,36,1,2,9150,44733,3,33
130900,229640,7970,2,140,1.79,90.09,537959,484662,-53297,4154,5707,1553,1044113,7970,7970,7970,0,0,0,8295,43245,0,0
130900,229640,7980,2,150,1.92,89.91,539033,484663,-54370,4159,5708,1549,1045188,7970,7980,7970,1075,5,1,10134,43482,1074,1
131000,229640,7970,2,140,1.79,89.85,539388,484663,-54725,4162,5708,1546,1045543,7970,7970,7970,354,2,0,10333,43114,354,0
131000,229640,7970,2,140,1.79,89.86,539390,484704,-54686,4163,5713,1550,1045586,7970,7970,7970,397,3,5,10306,45880,356,41
131100,229640,7970,2,140,1.79,89.74,540265,484830,-55435,4165,5718,1553,1046587,7970,7970,7960,422,1,4,10152,45115,411,11
131200,229640,7970,2,140,1.79,90.03,540265,486410,-53855,4165,5720,1555,1048167,7970,7970,7970,0,0,0,8949,43564,0,0
131200,229640,7960,2,130,1.66,89.96,540715,486410,-54305,4167,5720,1553,1048617,7970,7970,7960,450,2,0,9442,44594,450,0
131300,229640,7960,2,130,1.66,89.92,540960,486410,-54550,4168,5720,1552,1048862,7960,7960,7960,0,0,0,8787,44251,0,0
131400,229640,7970,2,140,1.79,89.92,540960,486412,-54548,4168,5721,1553,1048864,7970,7970,7970,2,0,1,8787,43975,0,2
131400,229640,7960,2,130,1.66,89.78,541855,486474,-55381,4171,5722,1551,1049821,7970,7970,7960,959,3,2,9843,43842,895,64
131500,229640,7970,2,140,1.79,90.03,541855,487848,-54007,4171,5725,1554,1051195,7970,7970,7970,76,0,2,8496,44249,0,76
131500,229640,7970,2,140,1.79,90.07,541855,488029,-53826,4171,5726,1555,1051376,7970,7970,7970,257,0,3,8542,44418,0,257
131600,229640,7970,2,140,1.79,90.02,542381,488234,-54147,4174,5729,1555,1052107,7970,7970,7960,731,3,3,8553,44154,526,205
131700,229640,7970,2,140,1.79,90.02,542381,488237,-54144,4174,5731,1557,1052110,7970,7970,7970,0,0,0,8548,44156,0,0
131700,229640,7960,2,130,1.66,89.93,542931,488240,-54691,4176,5732,1556,1052663,7970,7970,7960,553,2,1,10473,43873,550,3
131800,229640,7970,2,140,1.79,90.02,542931,488759,-54172,4176,5739,1563,1053182,7960,7970,7960,383,0,6,10607,45087,0,383
131900,229640,7970,2,140,1.79,90.03,542931,488819,-54112,4176,5741,1565,1053242,7970,7970,7970,0,0,0,10416,45002,0,0
131900,229640,7960,2,130,1.66,89.95,543464,488864,-54600,4178,5744,1566,1053820,7970,7970,7960,578,2,3,4903,45443,533,45
132000,229640,7970,2,140,1.79,89.96,543464,488913,-54551,4178,5750,1572,1053869,7970,7970,7970,1,0,1,10708,45645,0,1
132000,229640,7970,2,140,1.79,90.04,543464,489336,-54128,4178,5754,1576,1054292,7970,7980,7970,424,0,5,10750,45778,0,424
132100,229640,7970,2,140,1.79,90.0,544061,489665,-54396,4181,5757,1576,1055218,7960,7970,7950,926,3,3,10764,47504,597,329
132200,229640,7970,2,140,1.79,90.08,544088,490129,-53959,4182,5758,1576,1055709,7970,7970,7970,0,0,0,10763,47477,0,0
132200,229640,7960,2,130,1.66,89.93,544995,490139,-54856,4186,5761,1575,1056626,7980,7980,7960,917,4,3,10405,47495,907,10
132300,229640,7970,2,140,1.79,89.47,547917,490199,-57718,4190,5763,1573,1059608,7970,7970,7970,0,0,0,10407,43082,0,0
132400,229640,7970,2,140,1.79,89.44,548075,490202,-57873,4191,5764,1573,1059769,7970,7970,7970,0,0,0,10433,44211,0,0
132400,229640,7960,2,130,1.66,89.36,548561,490210,-58351,4193,5766,1573,1060263,7970,7970,7960,494,2,2,4962,44774,486,8
132500,229640,7960,2,130,1.66,89.25,549332,490271,-59061,4194,5769,1575,1061095,7960,7960,7960,58,0,2,4951,44195,0,58
132500,229640,7960,2,130,1.66,89.3,549335,490577,-58758,4195,5773,1578,1061404,7960,7960,7950,367,1,6,5541,44195,3,364
132600,229640,7960,2,130,1.66,89.21,550213,490832,-59381,4198,5779,1581,1062537,7950,7960,7950,671,2,4,5395,43460,467,204
132700,229640,7960,2,130,1.66,89.18,550393,490832,-59561,4199,5779,1580,1062717,7960,7960,7960,0,0,0,11233,44222,0,0
132700,229640,7960,2,130,1.66,88.93,552180,491062,-61118,4206,5781,1575,1064734,7970,7970,7960,2017,7,2,11289,43410,1787,230
132800,229640,7950,2,120,1.53,88.79,553062,491076,-61986,4275,5784,1509,1065630,7960,7960,7950,888,65,3,6507,42231,874,14
132900,229640,7950,2,120,1.53,88.76,553241,491076,-62165,4291,5784,1493,1065809,7950,7950,7950,18,5,0,6206,42452,18,0
132900,229640,7950,2,120,1.53,88.53,554951,491281,-63670,4321,5790,1469,1067724,7950,7960,7950,1933,35,6,5355,40548,1728,205
133000,229640,7940,2,110,1.4,88.41,555709,491286,-64423,4341,5791,1450,1068487,7950,7950,7940,62,15,1,5425,41053,57,5
133000,229640,7940,2,110,1.4,88.38,556192,491581,-64611,4366,5795,1429,1069265,7950,7950,7940,840,40,5,5443,41702,540,300
133100,229640,7920,2,90,1.15,82.57,595791,491946,-103845,4419,5798,1379,1109229,7940,7940,7870,39956,49,3,3101,25378,39591,365
133200,229640,7870,2,40,0.51,82.27,597943,491956,-105987,4431,5800,1369,1111391,7870,7870,7870,1,1,0,6287,28078,1,0
133200,229640,7900,2,70,0.89,82.32,598099,492378,-105721,4463,5809,1346,1111969,7870,7900,7870,579,33,9,6079,27340,157,422
133300,229640,7930,2,100,1.28,82.47,598255,493404,-104851,4484,5845,1361,1113151,7900,7950,7900,646,14,29,6283,7274,130,516
133300,229640,7910,2,80,1.02,82.62,598530,494529,-104001,4514,5852,1338,1114551,7900,7950,7900,2046,44,36,7390,20008,405,1641
133400,229640,7870,2,40,0.51,82.43,599998,494573,-105425,4536,5854,1318,1116063,7920,7920,7870,1512,22,2,9020,33512,1468,44
133500,229640,7850,2,20,0.26,81.87,604155,494605,-109550,4581,5858,1277,1120252,7860,7870,7850,2117,21,1,11316,32309,2096,21
133600,229640,7870,2,40,0.51,81.96,605655,496400,-109255,4609,5867,1258,1123547,7870,7870,7870,0,0,0,9351,30281,0,0
133600,229640,7860,2,30,0.38,81.68,608269,496819,-111450,4617,5870,1253,1126580,7870,7870,7850,3033,8,3,3614,29879,2614,419
133700,229640,7860,2,30,0.38,81.63,608642,496855,-111787,4653,5875,1222,1126995,7850,7860,7850,59,12,2,4059,31870,40,19
133700,229640,7860,2,30,0.38,81.59,609223,497090,-112133,4681,5883,1202,1127811,7850,7870,7850,875,40,10,3699,31840,621,254
133800,229640,7860,2,30,0.38,81.61,609321,497261,-112060,4708,5900,1192,1128080,7850,7860,7850,230,20,16,2737,32120,69,161
133900,229640,7860,2,30,0.38,81.59,609664,497414,-112250,4717,5904,1187,1128576,7870,7870,7860,300,2,0,3488,30916,300,0
133900,229640,7840,2,10,0.13,80.16,620553,497434,-123119,4772,5906,1134,1139485,7870,7870,7830,11209,57,2,5180,23206,11189,20
134000,229640,7830,3,0,0.0,80.13,620750,497437,-123313,4794,5908,1114,1139685,7840,7840,7830,171,9,0,3881,25381,171,0
134000,229640,7840,2,10,0.13,80.07,621465,497627,-123838,4822,5911,1089,1140590,7840,7840,7830,1076,37,3,3251,26418,886,190
134100,229640,7840,2,10,0.13,80.05,621824,497793,-124031,4851,5921,1070,1141115,7840,7840,7830,525,29,10,3342,27336,359,166
134200,229640,7840,2,10,0.13,80.07,623608,499348,-124260,4872,5929,1057,1144454,7840,7840,7840,1214,1,1,3741,27514,111,1103
134200,229640,7860,2,30,0.38,80.41,623701,501546,-122155,4899,5938,1039,1146745,7840,7860,7840,3505,28,10,3073,30434,204,3301
134300,229640,7880,2,50,0.64,80.37,624444,501869,-122575,4915,5947,1032,1147811,7860,7900,7860,463,7,5,5717,27744,160,303
134400,229640,7880,2,50,0.64,80.35,624766,501984,-122782,4960,5953,993,1148248,7890,7890,7880,10,3,1,6401,29224,9,1
134400,229640,7860,2,30,0.38,80.23,625996,502238,-123758,4980,5959,979,1149732,7890,7890,7860,1494,23,7,3696,32580,1239,255
134500,229640,7860,2,30,0.38,80.29,626085,502709,-123376,5003,5965,962,1150292,7860,7870,7860,76,14,2,4948,32850,72,4
134500,229640,7860,2,30,0.38,80.25,626677,502891,-123786,5024,5967,943,1151066,7860,7880,7860,850,35,4,4788,32385,664,186
134600,229640,7860,2,30,0.38,80.18,627239,502893,-124346,5059,5969,910,1151630,7860,7870,7860,564,35,2,4672,31891,562,2
134700,229640,7860,2,30,0.38,80.14,627829,503169,-124660,5084,5978,894,1152496,7870,7870,7860,256,3,1,5899,31479,6,250
134700,229640,7860,2,30,0.38,80.04,628686,503176,-125510,5104,5979,875,1153360,7870,7870,7860,1120,23,2,5896,31491,863,257
134800,229640,7860,2,30,0.38,80.02,629078,503397,-125681,5143,5980,837,1153973,7850,7860,7850,265,14,1,7008,32596,44,221
134800,229640,7860,2,30,0.38,80.0,629247,503399,-125848,5169,5981,812,1154144,7850,7870,7850,436,40,2,7007,32595,213,223
134900,229640,7860,2,30,0.38,80.2,629444,504809,-124635,5193,5985,792,1155751,7870,7870,7860,1607,24,4,6871,33443,197,1410
135000,229640,7860,2,30,0.38,80.12,630182,504887,-125295,5204,5987,783,1156567,7860,7860,7860,22,6,0,6945,32832,22,0
135000,229640,7860,2,30,0.38,80.3,630515,506279,-124236,5262,5989,727,1158292,7860,7870,7860,1747,64,2,4927,33326,355,1392
135100,229640,7860,2,30,0.38,80.24,631015,506339,-124676,5276,5994,718,1158852,7870,7870,7860,557,13,5,7967,32287,497,60
135200,229640,7870,2,40,0.51,80.23,631433,506611,-124822,5306,5999,693,1159542,7860,7870,7860,57,4,3,7699,32053,9,48
135200,229640,7850,2,20,0.26,80.08,632756,506731,-126025,5326,6002,676,1160985,7860,7870,7850,1500,24,6,9599,31637,1332,168
135300,229640,7850,2,20,0.26,79.99,633503,506761,-126742,5358,6003,645,1161762,7850,7850,7850,204,13,0,9588,30960,204,0
135300,229640,7830,3,0,0.0,79.03,641340,506836,-134504,5380,6006,626,1169674,7850,7860,7830,8116,35,3,6749,29361,8041,75
135400,229640,7830,3,0,0.0,79.01,641502,506845,-134657,5399,6009,610,1169845,7850,7850,7830,171,19,3,5072,25292,162,9
135500,229640,7830,3,0,0.0,78.94,642086,506845,-135241,5437,6009,572,1170429,7830,7830,7830,46,12,0,5157,24990,46,0
135500,229640,7820,5,10,-0.13,78.37,647888,507727,-140161,5474,6014,540,1177113,7830,7840,7810,6730,49,5,3912,22481,5848,882
135600,229640,7830,3,0,0.0,78.35,648569,508144,-140425,5495,6019,524,1178211,7820,7830,7820,881,17,2,3267,23157,676,205
135700,229640,7820,5,10,-0.13,78.33,648881,508250,-140631,5522,6022,500,1178629,7820,7820,7820,0,0,0,2648,22903,0,0
135700,229640,7820,5,10,-0.13,78.25,649516,508251,-141265,5560,6023,463,1179265,7820,7830,7820,636,38,1,2537,22944,635,1
135800,229640,7820,5,10,-0.13,78.02,652547,509093,-143454,5587,6032,445,1183138,7820,7830,7810,3051,17,1,17454,22347,2999,52
135800,229640,7840,2,10,0.13,77.97,653608,509631,-143977,5604,6037,433,1184737,7820,7850,7810,4650,34,6,17079,19193,4060,590
135900,229640,7810,5,20,-0.26,77.34,659830,510314,-149516,5656,6041,385,1191642,7830,7830,7800,6728,49,4,1680,18023,6045,683
140000,229640,7800,5,30,-0.38,77.07,662481,510544,-151937,5688,6048,360,1194523,7800,7810,7800,2378,13,2,16281,17257,2237,141
140000,229640,7800,5,30,-0.38,77.0,664691,511806,-152885,5716,6053,337,1197995,7800,7810,7790,5850,41,7,2500,24139,4447,1403
140100,229640,7790,5,40,-0.51,77.09,665026,512646,-152380,5737,6064,327,1199170,7800,7810,7790,919,19,5,1356,26032,328,591
140200,229640,7830,3,0,0.0,77.14,665172,513089,-152083,5776,6095,319,1199759,7810,7830,7810,167,11,13,2160,17958,59,108
140200,229640,7820,5,10,-0.13,77.06,666083,513258,-152825,5805,6120,315,1200840,7810,7840,7810,1248,40,38,2636,18563,970,277
140300,229640,7810,5,20,-0.26,76.92,667346,513291,-154055,5825,6124,299,1202136,7820,7820,7800,1283,14,4,6609,20620,1250,33
140400,229640,7800,5,30,-0.38,76.8,668751,513631,-155120,5856,6129,273,1203881,7800,7800,7800,12,5,0,8226,20737,12,0
140400,229640,7790,5,40,-0.51,76.67,670044,513751,-156293,5885,6131,246,1205294,7800,7810,7790,1425,34,2,4019,28557,1305,120
140500,229640,7820,5,10,-0.13,76.56,671673,514212,-157461,5917,6143,226,1207384,7790,7820,7790,814,9,5,6423,28118,620,194
140500,229640,7800,5,30,-0.38,76.61,671807,514655,-157152,5933,6151,218,1207961,7790,7820,7790,1391,25,13,2298,33824,754,637
140600,229640,7800,5,30,-0.38,76.71,672425,515796,-156629,5957,6161,204,1209720,7790,7830,7790,1403,21,8,2652,22286,317,1086
140700,229640,7800,5,30,-0.38,76.46,674772,515908,-158864,5975,6166,191,1212179,7800,7800,7800,2298,2,0,1952,21735,2298,0
140700,229640,7790,5,40,-0.51,75.87,680064,515991,-164073,6001,6172,171,1217554,7800,7800,7790,7673,28,6,2168,29863,7590,83
140800,229640,7790,5,40,-0.51,75.73,681362,516009,-165353,6038,6176,138,1218870,7790,7800,7790,1263,22,3,2603,31661,1246,17
140900,229640,7790,5,40,-0.51,75.63,682284,516011,-166273,6074,6177,103,1219794,7790,7790,7790,247,10,0,17943,31286,247,0
140900,229640,7800,5,30,-0.38,78.04,683086,533062,-150024,6099,6183,84,1237647,7790,7800,7780,18100,35,6,2040,31225,1049,17051
141000,229640,7790,5,40,-0.51,77.91,684525,533291,-151234,6130,6186,56,1239315,7790,7800,7790,1021,23,1,2386,41136,919,102
141000,229640,7790,5,40,-0.51,77.85,686840,534711,-152129,6159,6192,33,1243050,7790,7820,7780,4756,52,7,2095,26811,3234,1522
141100,229640,7800,5,30,-0.38,77.81,687248,534736,-152512,6189,6197,8,1243483,7790,7800,7790,433,30,5,2092,42439,408,25
141200,229640,7810,5,20,-0.26,77.79,688015,535174,-152841,6199,6205,6,1244688,7810,7810,7800,818,2,5,2656,28727,750,68
141200,229640,7800,5,30,-0.38,77.53,690323,535189,-155134,6236,6208,-28,1247011,7810,7810,7790,3141,39,8,2691,27327,3058,83
141300,229640,7790,5,40,-0.51,77.54,690504,535405,-155099,6269,6212,-57,1247408,7800,7800,7790,382,29,3,3109,44554,167,215
141400,229640,7800,5,30,-0.38,77.46,691262,535441,-155821,6297,6220,-77,1248202,7790,7800,7790,21,7,1,3173,43583,19,2
141400,229640,7800,5,30,-0.38,77.53,691337,535961,-155376,6321,6230,-91,1248797,7790,7800,7790,616,31,11,3268,44934,94,522
141500,229640,7780,5,50,-0.64,76.88,697141,535978,-161163,6349,6234,-115,1254618,7800,7800,7780,5321,20,2,3898,39458,5315,6
141600,229640,7780,5,50,-0.64,75.36,711257,536008,-175249,6376,6240,-136,1268764,7780,7780,7780,111,5,1,3691,27149,110,1
141600,229640,7790,5,40,-0.51,75.33,711988,536357,-175631,6396,6252,-144,1269844,7780,7790,7770,1191,25,13,4140,22954,841,350
141700,229640,7790,5,40,-0.51,75.22,713028,536362,-176666,6421,6256,-165,1270889,7790,7800,7790,955,7,1,4277,23754,954,1
141700,229640,7780,5,50,-0.64,75.2,713226,536373,-176853,6465,6258,-207,1271098,7790,7800,7780,1164,51,3,3742,27477,1152,12
141800,229640,7780,5,50,-0.64,75.03,714921,536374,-178547,6480,6259,-221,1272794,7780,7790,7780,1690,13,1,3583,26081,1689,1
141900,229640,7780,5,50,-0.64,74.89,716255,536389,-179866,6512,6262,-250,1274143,7780,7780,7780,35,12,0,3506,26120,35,0
141900,229640,7780,5,50,-0.64,74.86,716570,536414,-180156,6531,6263,-268,1274483,7780,7790,7780,375,31,1,4693,27327,350,25
142000,229640,7780,5,50,-0.64,74.82,717171,536577,-180594,6571,6266,-305,1275247,7780,7780,7780,86,24,0,4340,28752,86,0
142000,229640,7790,5,40,-0.51,74.74,718060,536652,-181408,6591,6270,-321,1276211,7780,7790,7780,1050,44,4,4280,30054,975,75
142100,229640,7790,5,40,-0.51,74.66,718833,536663,-182170,6620,6272,-348,1276995,7780,7790,7780,784,29,2,4266,29845,773,11
142200,229640,7780,5,50,-0.64,74.61,719352,536685,-182667,6649,6275,-374,1277536,7780,7780,7780,436,7,0,4241,30859,436,0
142200,229640,7780,5,50,-0.64,74.56,719835,536687,-183148,6678,6276,-402,1278021,7780,7790,7780,921,36,1,4326,32444,919,2
142300,229640,7770,5,60,-0.77,73.6,729200,536687,-192513,6718,6276,-442,1287386,7780,7780,7770,9330,32,0,31057,32818,9330,0
142400,229640,7740,5,90,-1.15,72.78,737400,536706,-200694,6749,6277,-472,1295605,7770,7770,7740,3403,6,0,31966,29913,3403,0
142400,229640,7760,5,70,-0.89,72.76,737689,536766,-200923,6798,6281,-517,1295954,7770,7770,7740,3752,55,4,31311,25149,3692,60
142500,229640,7770,5,60,-0.77,72.76,738602,537432,-201170,6811,6294,-517,1297533,7780,7790,7770,741,8,6,2848,27281,428,313
142600,229640,7750,5,80,-1.02,72.71,741007,538778,-202229,6847,6299,-548,1301284,7750,7750,7750,0,0,0,28213,26031,0,0
142600,229640,7760,5,70,-0.89,72.78,741387,539615,-201772,6869,6309,-560,1302501,7750,7770,7740,1217,22,10,28498,27555,380,837
142700,229640,7760,5,70,-0.89,72.8,742297,540359,-201938,6899,6320,-579,1304155,7760,7760,7750,479,14,3,28112,27141,342,137
142700,229640,7740,5,90,-1.15,72.73,743055,540449,-202606,6928,6322,-606,1305003,7760,7760,7740,1327,43,5,28457,35003,1100,227
142800,229640,7770,5,60,-0.77,76.24,743986,567196,-176790,6943,6344,-599,1332681,7750,7770,7750,27266,12,20,6936,29155,921,26345
142900,229640,7770,5,60,-0.77,76.26,744483,567735,-176748,6982,6357,-625,1333717,7770,7770,7770,16,8,0,2996,28572,16,0
142900,229640,7790,5,40,-0.51,76.28,744510,567888,-176622,6990,6365,-625,1333897,7770,7800,7770,196,16,8,2878,28124,43,153
143000,229640,7790,5,40,-0.51,76.42,744766,569126,-175640,7031,6373,-658,1335391,7790,7800,7790,516,38,3,2038,27249,250,266
143100,229640,7790,5,40,-0.51,76.39,745229,569275,-175954,7050,6379,-671,1336003,7790,7790,7790,10,4,0,1895,32120,10,0
143100,229640,7800,5,30,-0.38,76.5,745627,570387,-175240,7075,6392,-683,1337513,7790,7810,7790,1520,29,13,5330,17631,408,1112
143200,229640,7830,3,0,0.0,76.47,746136,570589,-175547,7103,6402,-701,1338224,7810,7830,7810,87,18,2,6306,7381,53,34
143200,229640,7840,2,10,0.13,76.46,746519,570767,-175752,7122,6410,-712,1338785,7810,7860,7810,648,37,10,3188,8629,436,212
143300,229640,7850,2,20,0.26,76.46,747000,571180,-175820,7153,6417,-736,1339679,7840,7850,7830,859,27,7,7036,8620,446,413
143400,229640,7850,2,20,0.26,76.48,747291,571498,-175793,7164,6422,-742,1340288,7850,7850,7850,2,0,1,4427,9242,0,2
143400,229640,7860,2,30,0.38,76.57,747396,572251,-175145,7191,6435,-756,1341146,7850,7860,7840,860,27,14,3821,7016,105,755
143500,229640,7860,2,30,0.38,76.72,747790,573677,-174113,7219,6444,-775,1342966,7860,7860,7850,1590,18,6,4912,7494,330,1260
143600,229640,7850,2,20,0.26,76.63,749208,574109,-175099,7255,6454,-801,1344816,7850,7850,7850,0,0,0,6405,7004,0,0
143600,229640,7870,2,40,0.51,76.66,749375,574500,-174875,7274,6459,-815,1345374,7860,7870,7850,558,19,5,6933,8843,167,391
143700,229640,7840,2,10,0.13,76.61,750026,574594,-175432,7307,6463,-844,1346119,7840,7850,7840,96,16,1,9516,12148,50,46
143700,229640,7830,3,0,0.0,76.39,752815,575096,-177719,7340,6470,-870,1349410,7840,7850,7820,3387,49,8,9143,10833,2839,548
143800,229640,7820,5,10,-0.13,76.32,753759,575266,-178493,7362,6474,-888,1350524,7830,7840,7820,1100,19,4,7706,12909,930,170
143900,229640,7830,3,0,0.0,76.34,753846,575449,-178397,7386,6478,-908,1350794,7830,7830,7830,14,5,0,8821,12650,14,0
143900,229640,7770,5,60,-0.77,75.96,757891,575668,-182223,7414,6482,-932,1355058,7830,7840,7770,4278,33,4,8690,12174,4059,219
144000,229640,7790,5,40,-0.51,75.99,758245,576192,-182053,7442,6489,-953,1355936,7830,7830,7790,835,18,5,3074,28883,321,514
144100,229640,7810,5,20,-0.26,76.0,758276,576302,-181974,7452,6495,-957,1356077,7800,7820,7800,80,2,2,3860,14803,2,78
144100,229640,7820,5,10,-0.13,75.99,758525,576430,-182095,7495,6499,-996,1356454,7800,7830,7800,457,45,6,3745,15247,251,206
144200,229640,7820,5,10,-0.13,76.05,759066,577252,-181814,7506,6504,-1002,1357817,7820,7820,7810,819,6,4,4082,14978,42,777
144200,229640,7820,5,10,-0.13,76.12,759330,577991,-181339,7535,6516,-1019,1358820,7820,7840,7810,1822,35,16,3445,12695,306,1516
144300,229640,7820,5,10,-0.13,76.03,760650,578346,-182304,7559,6526,-1033,1360495,7830,7840,7810,1622,21,9,2392,20318,1312,310
144400,229640,7830,3,0,0.0,76.06,760705,578586,-182119,7583,6534,-1049,1360790,7840,7840,7830,47,2,1,5043,12868,2,45
144400,229640,7830,3,0,0.0,76.06,760844,578668,-182176,7621,6537,-1084,1361011,7840,7840,7830,268,40,4,5130,13382,141,127
144500,229640,7830,3,0,0.0,75.94,762903,579366,-183537,7645,6544,-1101,1363768,7840,7840,7820,2425,17,3,2938,12939,1911,514
144500,229640,7790,5,40,-0.51,75.66,766008,579530,-186478,7681,6549,-1132,1367037,7840,7850,7770,5694,53,8,5030,28924,5016,678
144600,229640,7850,2,20,0.26,75.69,766037,579842,-186195,7692,6551,-1141,1367378,7800,7850,7800,341,11,2,6535,12346,29,312
144700,229640,7840,2,10,0.13,75.75,766497,580639,-185858,7738,6557,-1181,1368635,7840,7840,7840,55,9,0,6433,15062,55,0
144700,229640,7860,2,30,0.38,76.16,766667,583931,-182736,7760,6578,-1182,1372097,7840,7870,7830,3517,31,21,7863,7591,225,3292
144800,229640,7930,2,100,1.28,76.01,771072,586067,-185005,7789,6592,-1197,1378638,7870,7940,7840,6521,20,14,14020,8339,4385,2136
144900,229640,7880,2,50,0.64,76.02,771216,586247,-184969,7809,6596,-1213,1378962,7880,7880,7880,76,6,0,7761,6478,76,0
144900,229640,7900,2,70,0.89,76.08,771304,586843,-184461,7827,6602,-1225,1379646,7880,7900,7880,760,24,6,9507,5456,164,596
145000,229640,7860,2,30,0.38,76.06,772224,587352,-184872,7864,6607,-1257,1381075,7890,7890,7860,1041,17,4,10513,10145,577,464
145000,229640,7900,2,70,0.89,76.12,772313,587886,-184427,7885,6613,-1272,1381698,7890,7900,7850,1664,38,10,13963,5408,666,998
145100,229640,7890,2,60,0.77,76.12,772398,587923,-184475,7909,6619,-1290,1381820,7900,7910,7880,122,24,6,9723,5700,85,37
145200,229640,7880,2,50,0.64,76.32,772869,589858,-183011,7928,6627,-1301,1384226,7880,7880,7870,621,6,2,10485,9268,112,509
145200,229640,7860,2,30,0.38,76.29,773596,590187,-183409,7969,6631,-1338,1385282,7880,7880,7860,1677,47,6,8967,12416,839,838
145300,229640,7860,2,30,0.38,76.41,774774,592020,-182754,7995,6639,-1356,1388293,7880,7890,7860,2846,24,6,8089,10879,1171,1675
145400,229640,7870,2,40,0.51,76.41,775933,592926,-183007,8021,6655,-1366,1390358,7860,7880,7850,1519,13,5,8827,10511,1038,481
145400,229640,7880,2,50,0.64,76.42,776059,593068,-182991,8055,6659,-1396,1390626,7860,7890,7850,1787,47,9,10252,7271,1164,623
145500,229640,7880,2,50,0.64,76.42,776597,593453,-183144,8071,6673,-1398,1391549,7870,7890,7870,898,9,6,8885,9336,521,377
145600,229640,7860,2,30,0.38,76.43,776721,593615,-183106,8110,6676,-1434,1391835,7870,7870,7860,124,3,1,12834,11096,9,115
145600,229640,7870,2,40,0.51,76.57,776855,594801,-182054,8129,6761,-1368,1393155,7870,7870,7860,1444,22,86,12843,9041,143,1301
145700,229640,7870,2,40,0.51,76.52,777794,595177,-182617,8163,6768,-1395,1394470,7870,7870,7860,763,20,4,13564,8359,446,317
145800,229640,7880,2,50,0.64,76.81,778009,597616,-180393,8188,6774,-1414,1397124,7880,7880,7880,0,0,0,11052,8896,0,0
145800,229640,7870,2,40,0.51,76.73,779305,597944,-181361,8216,6778,-1438,1398748,7870,7880,7870,1624,28,4,11632,9232,1296,328
145900,229640,7860,2,30,0.38,76.74,779404,598150,-181254,8248,6781,-1467,1399053,7860,7870,7860,105,19,1,12901,9616,60,45
145900,229640,7860,2,30,0.38,76.75,780010,598656,-181354,8270,6786,-1484,1400165,7860,7870,7860,1217,41,6,12079,9153,666,551
150000,229640,7850,2,20,0.26,76.67,781048,598829,-182219,8301,6794,-1507,1401376,7860,7870,7840,1183,28,7,12123,12483,1031,152
150100,229640,7860,2,30,0.38,76.61,781743,598879,-182864,8320,6798,-1522,1402121,7860,7860,7860,66,8,0,13898,12303,66,0
150100,229640,7880,2,50,0.64,76.66,782919,600209,-182710,8345,6810,-1535,1404627,7860,7890,7850,2572,33,12,13474,12643,1242,1330
150200,229640,7890,2,60,0.77,76.64,783563,600500,-183063,8381,6817,-1564,1405562,7890,7890,7880,320,21,6,15301,11049,74,246
150200,229640,7910,2,80,1.02,76.72,783769,601317,-182452,8396,6847,-1549,1406585,7890,7910,7880,1343,36,36,19963,8290,280,1063
150300,229640,7900,2,70,0.89,76.7,784822,601935,-182887,8425,6860,-1565,1408256,7910,7910,7900,1670,29,12,19512,8003,1053,617
150400,229640,7900,2,70,0.89,76.74,784967,602408,-182559,8453,6866,-1587,1408874,7900,7900,7900,62,5,1,20508,9160,60,2
150400,229640,7910,2,80,1.02,76.78,785242,602947,-182295,8477,6872,-1605,1409688,7900,7910,7900,876,29,7,15897,7751,335,541
150500,229640,7890,2,60,0.77,76.71,786448,603258,-183190,8505,6874,-1631,1411205,7900,7900,7880,574,13,1,12251,8670,528,46
150600,229640,7880,2,50,0.64,76.64,787235,603342,-183893,8533,6880,-1653,1412076,7880,7880,7880,9,4,0,10507,11246,9,0
150600,229640,7890,2,60,0.77,76.89,787773,605745,-182028,8544,6935,-1609,1415017,7880,7900,7880,2950,15,55,12747,8979,547,2403
150700,229640,7890,2,60,0.77,76.87,788673,606248,-182425,8582,6947,-1635,1416420,7880,7890,7880,382,4,5,11295,11174,7,375
150700,229640,7900,2,70,0.89,77.04,788756,607625,-181131,8607,6961,-1646,1417880,7880,7900,7880,1842,29,19,12953,9378,90,1752
150800,229640,7890,2,60,0.77,76.97,790096,608169,-181927,8627,6974,-1653,1419764,7900,7910,7880,1539,15,9,12902,8556,1327,212
150900,229640,7870,2,40,0.51,76.91,790911,608308,-182603,8669,7006,-1663,1420718,7880,7880,7870,59,16,2,10983,13188,57,2
150900,229640,7880,2,50,0.64,76.93,791026,608560,-182466,8689,7012,-1677,1421085,7880,7890,7870,426,36,8,13329,10774,172,254
151000,229640,7870,2,40,0.51,76.89,791883,608891,-182992,8721,7057,-1664,1422273,7870,7880,7860,647,22,36,10467,14353,336,311
151100,229640,7880,2,50,0.64,77.05,791933,610173,-181760,8739,7077,-1662,1423605,7880,7880,7880,10,4,0,13213,10908,10,0
151100,229640,7870,2,40,0.51,77.05,792398,610574,-181824,8765,7092,-1673,1424472,7880,7890,7870,877,30,15,11455,14702,475,401
151200,229640,7880,2,50,0.64,77.1,792714,611191,-181523,8790,7114,-1676,1425405,7880,7890,7870,512,11,16,11432,14662,54,458
151300,229640,7900,2,70,0.89,77.22,792774,612167,-180607,8811,7127,-1684,1426441,7900,7900,7900,0,0,0,15796,13025,0,0
151300,229640,7890,2,60,0.77,77.11,794498,612669,-181829,8848,7134,-1714,1428667,7900,7900,7880,2226,37,7,14135,13520,1724,502
151400,229640,7900,2,70,0.89,77.23,794784,613774,-181010,8871,7143,-1728,1430058,7900,7900,7890,878,7,5,16048,11781,15,863
151400,229640,7890,2,60,0.77,77.27,795240,614464,-180776,8902,7149,-1753,1431204,7900,7910,7880,2024,38,11,13278,13291,471,1553
151500,229640,7890,2,60,0.77,77.1,797194,614616,-182578,8929,7154,-1775,1433310,7890,7910,7890,1879,23,5,17104,11827,1727,152
151600,229640,7890,2,60,0.77,77.24,797291,615824,-181467,8958,7168,-1790,1434615,7900,7900,7890,508,3,5,16347,13441,6,502
151600,229640,7900,2,70,0.89,77.24,797775,616224,-181551,8979,7177,-1802,1435499,7900,7900,7890,1392,24,14,16623,12806,490,902
151700,229640,7900,2,70,0.89,77.26,798402,616842,-181560,9010,7186,-1824,1436744,7890,7900,7880,900,20,5,16871,12765,596,304
151800,229640,7880,2,50,0.64,77.32,798805,617605,-181200,9051,7197,-1854,1437910,7880,7890,7880,377,23,1,14708,14351,78,299
151800,229640,7890,2,60,0.77,77.3,799682,618153,-181529,9065,7208,-1857,1439335,7880,7890,7880,1802,37,12,14035,17483,955,847
151900,229640,7900,2,70,0.89,77.32,799704,618300,-181404,9070,7213,-1857,1439504,7890,7900,7890,83,4,1,17960,15707,21,62
151900,229640,7900,2,70,0.89,77.35,800433,619117,-181316,9076,7225,-1851,1441050,7890,7900,7880,1629,10,13,17461,15866,750,879
152000,229640,7900,2,70,0.89,77.38,800963,619750,-181213,9078,7233,-1845,1442213,7890,7900,7890,1163,2,8,18177,15079,530,633
152000,229640,7910,2,80,1.02,77.58,801177,621518,-179659,9081,7250,-1831,1444195,7890,7910,7890,3145,5,25,21530,14543,744,2401
152000,229640,7910,2,80,1.02,77.58,801177,621518,-179659,9081,7250,-1831,1444195,7890,7910,7890,3145,5,25,21530,14543,744,2401
152000,229640,7910,2,80,1.02,77.58,801177,621518,-179659,9081,7250,-1831,1444195,7890,7910,7890,3145,5,25,21530,14543,744,2401
152000,229640,7910,2,80,1.02,77.58,801177,621518,-179659,9081,7250,-1831,1444195,7890,7910,7890,3145,5,25,21530,14543,744,2401
152000,229640,7910,2,80,1.02,77.58,801177,621518,-179659,9081,7250,-1831,1444195,7890,7910,7890,3145,5,25,21530,14543,744,2401
152000,229640,7910,2,80,1.02,77.58,801177,621518,-179659,9081,7250,-1831,1444195,7890,7910,7890,3145,5,25,21530,14543,744,2401
152000,229640,7910,2,80,1.02,77.58,801177,621518,-179659,9081,7250,-1831,1444195,7890,7910,7890,3145,5,25,21530,14543,744,2401
152000,229640,7910,2,80,1.02,77.58,801177,621518,-179659,9081,7250,-1831,1444195,7890,7910,7890,3145,5,25,21530,14543,744,2401
152000,229640,7910,2,80,1.02,77.58,801177,621518,-179659,9081,7250,-1831,1444195,7890,7910,7890,3145,5,25,21530,14543,744,2401
152000,229640,7910,2,80,1.02,77.58,801177,621518,-179659,9081,7250,-1831,1444195,7890,7910,7890,3145,5,25,21530,14543,744,2401
152000,229640,7910,2,80,1.02,77.58,801177,621518,-179659,9081,7250,-1831,1444195,7890,7910,7890,3145,5,25,21530,14543,744,2401
152000,229640,7910,2,80,1.02,77.58,801177,621518,-179659,9081,7250,-1831,1444195,7890,7910,7890,3145,5,25,21530,14543,744,2401
152000,229640,7910,2,80,1.02,77.58,801177,621518,-179659,9081,7250,-1831,1444195,7890,7910,7890,3145,5,25,21530,14543,744,2401
152000,229640,7910,2,80,1.02,77.58,801177,621518,-179659,9081,7250,-1831,1444195,7890,7910,7890,3145,5,25,21530,14543,744,2401
152000,229640,7910,2,80,1.02,77.58,801177,621518,-179659,9081,7250,-1831,1444195,7890,7910,7890,3145,5,25,21530,14543,744,2401
152000,229640,7910,2,80,1.02,77.58,801177,621518,-179659,9081,7250,-1831,1444195,7890,7910,7890,3145,5,25,21530,14543,744,2401
152000,229640,7910,2,80,1.02,77.58,801177,621518,-179659,9081,7250,-1831,1444195,7890,7910,7890,3145,5,25,21530,14543,744,2401
153000,229640,7900,2,70,0.89,77.58,801177,621518,-179659,9081,7250,-1831,1458894,7900,7900,7900,14699,0,0,21552,14596,0,0
153000,229640,7900,2,70,0.89,77.58,801177,621518,-179659,9081,7250,-1831,1458894,7900,7900,7900,14699,0,0,21552,14596,0,0
153000,229640,7900,2,70,0.89,77.58,801177,621518,-179659,9081,7250,-1831,1458894,7900,7900,7900,14699,0,0,21552,14596,0,0
