092800,013360,1365,2,55,4.2,112.96,355672,401770,46098,589,744,155,845513,1365,1365,1365,0,0,0,60651,137002,0,0
092800,013360,1365,2,55,4.2,112.96,355672,401770,46098,589,744,155,845513,1365,1365,1365,0,0,0,60651,137002,0,0
092900,013360,1365,2,55,4.2,113.13,356263,403041,46778,591,746,155,847375,1365,1365,1365,0,0,0,64857,119880,0,0
092900,013360,1365,2,55,4.2,112.64,357808,403052,45244,594,748,154,848931,1360,1365,1360,1556,3,2,62706,138224,1545,11
093000,013360,1365,2,55,4.2,112.65,357808,403088,45280,594,749,155,848967,1365,1365,1365,0,0,0,61799,138724,0,0
093000,013360,1365,2,55,4.2,112.65,357808,403088,45280,594,749,155,848967,1365,1365,1365,0,0,0,61799,138724,0,0
093100,013360,1365,2,55,4.2,112.82,357808,403670,45862,594,758,164,849549,1365,1365,1365,3,0,3,61407,140573,0,3
093100,013360,1365,2,55,4.2,112.8,357858,403671,45813,595,759,164,849600,1365,1370,1365,54,1,4,66019,126652,50,4
093200,013360,1370,2,60,4.58,112.84,357863,403816,45953,596,763,167,849750,1370,1370,1370,133,0,2,66474,130588,0,133
093200,013360,1370,2,60,4.58,112.81,358008,403881,45873,597,766,169,849960,1370,1370,1365,343,1,5,66119,130698,145,198
093300,013360,1370,2,60,4.58,112.74,358519,404192,45673,599,769,170,850782,1370,1370,1370,0,0,0,65848,130067,0,0
093300,013360,1365,2,55,4.2,112.77,358523,404292,45769,601,770,169,850886,1365,1370,1365,104,2,1,65898,130351,4,100
093400,013360,1370,2,60,4.58,112.54,359612,404692,45080,603,772,169,852375,1370,1370,1370,0,0,0,65566,129362,0,0
093400,013360,1360,2,50,3.82,110.4,366583,404693,38110,609,773,164,859347,1365,1370,1360,6972,6,1,65215,139501,6971,1
093500,013360,1370,2,60,4.58,110.4,366586,404697,38111,610,777,167,859354,1370,1370,1370,0,0,0,66248,139498,0,0
093500,013360,1360,2,50,3.82,110.45,366587,404897,38310,611,778,167,859555,1370,1370,1360,201,1,1,64549,136504,1,200
093600,013360,1365,2,55,4.2,108.67,372609,404919,32310,614,780,166,865599,1365,1365,1365,12,0,1,59563,136746,0,12
093600,013360,1365,2,55,4.2,108.93,372786,406069,33283,616,783,167,866926,1365,1365,1360,1339,2,4,59525,138690,177,1162
093700,013360,1370,2,60,4.58,109.01,372909,406509,33600,618,784,166,867489,1365,1370,1365,441,1,1,64616,122761,1,440
093700,013360,1370,2,60,4.58,109.01,372909,406509,33600,618,784,166,867489,1365,1370,1365,441,1,1,64616,122761,1,440
093800,013360,1365,2,55,4.2,109.01,372923,406519,33596,620,785,165,867513,1365,1365,1365,11,1,0,68513,125320,11,0
093800,013360,1370,2,60,4.58,109.54,373208,408806,35598,621,789,168,870085,1365,1375,1365,2583,2,4,77813,120965,296,2287
093900,013360,1365,2,55,4.2,109.54,373209,408807,35598,622,790,168,870087,1365,1365,1365,1,1,0,71541,125331,1,0
093900,013360,1370,2,60,4.58,109.54,373209,408812,35603,622,791,169,870092,1365,1370,1365,6,1,1,69129,125893,1,5
094000,013360,1370,2,60,4.58,109.54,373209,408812,35603,622,791,169,870092,1370,1370,1370,0,0,0,69129,125893,0,0
094000,013360,1370,2,60,4.58,109.67,373223,409302,36079,623,793,170,870596,1370,1375,1370,504,1,2,78094,128160,14,490
094100,013360,1375,2,65,4.96,109.71,376203,412718,36515,628,798,170,876992,1375,1375,1375,954,2,4,76276,128249,3,951
094100,013360,1370,2,60,4.58,109.5,376921,412718,35797,633,798,165,877710,1375,1375,1370,1672,7,4,77619,125586,721,951
094200,013360,1375,2,65,4.96,109.72,376921,413568,36647,633,799,166,878560,1375,1375,1375,0,0,0,77619,125533,0,0
094200,013360,1375,2,65,4.96,109.72,376921,413568,36647,633,799,166,878560,1375,1375,1375,0,0,0,77619,125533,0,0
094300,013360,1375,2,65,4.96,109.43,377945,413569,35624,637,800,163,879585,1370,1375,1370,101,1,1,78263,124115,100,1
094300,013360,1375,2,65,4.96,109.43,377945,413569,35624,637,800,163,879585,1370,1375,1370,101,1,1,78263,124115,100,1
094400,013360,1375,2,65,4.96,108.99,379447,413572,34125,641,802,161,881090,1370,1375,1365,1504,3,2,81973,125365,1501,3
094400,013360,1370,2,60,4.58,108.99,379447,413574,34127,641,804,163,881092,1370,1375,1365,1506,3,4,72145,125806,1501,5
094500,013360,1370,2,60,4.58,108.99,379447,413574,34127,641,804,163,881092,1370,1370,1370,0,0,0,72145,125806,0,0
094500,013360,1370,2,60,4.58,108.91,379730,413575,33845,643,805,162,881376,1370,1375,1370,284,2,1,82277,122912,283,1
094600,013360,1375,2,65,4.96,108.99,379758,413896,34138,645,806,161,881725,1370,1375,1370,324,1,1,82249,127861,3,321
094600,013360,1375,2,65,4.96,108.99,379759,413903,34144,646,808,162,881733,1370,1375,1370,332,2,3,80701,128160,4,328
094700,013360,1375,2,65,4.96,108.99,379759,413904,34145,646,809,163,881734,1375,1375,1375,1,0,1,82616,128161,0,1
094700,013360,1375,2,65,4.96,108.99,379759,413908,34149,646,813,167,881738,1375,1375,1375,5,0,5,82612,128595,0,5
094800,013360,1375,2,65,4.96,109.07,379759,414217,34458,646,814,168,882047,1375,1375,1375,0,0,0,82611,128789,0,0
094800,013360,1380,2,70,5.34,109.84,379760,417118,37358,647,816,169,884949,1375,1380,1375,2902,1,2,83932,112580,1,2901
094900,013360,1380,2,70,5.34,109.84,379760,417118,37358,647,816,169,884949,1380,1380,1380,0,0,0,83932,112580,0,0
094900,013360,1380,2,70,5.34,109.93,379762,417459,37697,648,820,172,885292,1380,1380,1375,343,1,4,81020,105803,2,341
095000,013360,1375,2,65,4.96,109.86,379991,417460,37469,649,821,172,885522,1380,1380,1375,230,1,1,80719,105744,229,1
095000,013360,1380,2,70,5.34,109.87,379992,417494,37502,650,825,175,885557,1380,1380,1375,265,2,5,81900,107558,230,35
095100,013360,1375,2,65,4.96,109.85,380063,417498,37435,651,828,177,885632,1380,1380,1375,74,1,2,82867,109527,71,3
095100,013360,1380,2,70,5.34,109.84,380082,417500,37418,653,830,177,885653,1380,1380,1375,95,3,4,82866,110715,90,5
095200,013360,1380,2,70,5.34,109.84,380092,417501,37409,654,831,177,885664,1375,1380,1375,11,1,1,83183,112175,10,1
095300,013360,1375,2,65,4.96,109.98,381032,419061,38029,658,837,179,888164,1375,1375,1375,318,1,0,81722,112081,318,0
095300,013360,1380,2,70,5.34,110.14,381032,419661,38629,658,839,181,888764,1375,1380,1375,918,1,2,80904,111763,318,600
095400,013360,1380,2,70,5.34,110.46,381035,420875,39840,659,845,186,889981,1380,1380,1380,0,0,0,79595,110670,0,0
095400,013360,1375,2,65,4.96,111.03,381036,423078,42042,660,851,191,892185,1380,1380,1375,2204,1,6,75363,110670,1,2203
095500,013360,1375,2,65,4.96,110.25,385058,424543,39485,663,856,193,897672,1375,1375,1375,3,1,0,79336,115456,3,0
095500,013360,1380,2,70,5.34,108.88,389926,424544,34618,665,857,192,902541,1375,1380,1375,4872,3,1,74468,137353,4871,1
095600,013360,1385,2,75,5.73,111.32,390026,434186,44160,666,862,196,912283,1385,1385,1385,0,0,0,67871,122026,0,0
095600,013360,1380,2,70,5.34,111.35,390126,434387,44261,668,865,197,915084,1385,1385,1380,2801,2,3,64744,125423,100,201
095700,013360,1380,2,70,5.34,111.35,390126,434387,44261,668,865,197,915084,1380,1380,1380,0,0,0,64744,125423,0,0
095700,013360,1380,2,70,5.34,111.34,390129,434389,44260,670,867,197,915089,1385,1385,1380,5,2,2,67801,122523,3,2
095800,013360,1390,2,80,6.11,115.2,390129,449433,59304,670,873,203,930133,1390,1390,1390,0,0,0,58798,123021,0,0
095800,013360,1390,2,80,6.11,115.98,390140,452470,62330,672,882,210,933181,1385,1390,1385,3048,2,9,60828,125889,11,3037
095900,013360,1390,2,80,6.11,115.7,391070,452471,61401,675,883,208,934112,1385,1390,1385,901,2,1,60427,131912,900,1
095900,013360,1390,2,80,6.11,116.67,391070,456244,65174,675,888,213,937885,1385,1390,1385,4674,2,6,58954,133179,900,3774
100000,013360,1390,2,80,6.11,118.78,391110,464570,73460,715,951,236,946251,1390,1390,1385,65,22,30,55151,135350,22,43
100000,013360,1390,2,80,6.11,119.42,391183,467157,75974,787,1053,266,948911,1390,1390,1385,2725,94,132,54164,138532,95,2630
100100,013360,1390,2,80,6.11,120.33,391662,471303,79641,859,1177,318,953536,1395,1395,1390,3081,26,36,52293,141378,35,3046
100100,013360,1395,2,85,6.49,119.95,393356,471850,78494,933,1269,336,955777,1395,1395,1390,5322,100,128,52704,139914,1729,3593
100200,013360,1390,2,80,6.11,118.82,397379,472166,74787,954,1297,343,960116,1390,1390,1390,72,0,2,54722,140490,0,72
100200,013360,1385,2,75,5.73,118.88,397542,472615,75073,965,1310,345,960728,1390,1390,1385,684,11,15,55640,141969,163,521
100300,013360,1390,2,80,6.11,119.08,397591,473459,75868,1014,1378,364,961621,1390,1390,1385,84,22,33,56588,147350,22,62
100300,013360,1385,2,75,5.73,119.09,397641,473541,75900,1064,1442,378,961753,1390,1390,1385,216,72,97,56562,144801,72,144
100400,013360,1395,2,85,6.49,121.31,399189,484252,85063,1114,1506,392,974012,1390,1395,1390,9346,26,32,48509,144449,1524,7822
100400,013360,1395,2,85,6.49,121.27,399418,484360,84942,1159,1558,399,974349,1390,1395,1390,9683,71,84,49087,144850,1753,7930
100500,013360,1390,2,80,6.11,121.92,399455,487025,87570,1196,1601,405,977051,1395,1395,1390,2656,20,24,46451,147046,20,2636
100500,013360,1405,2,95,7.25,124.5,399509,497396,97887,1242,1681,439,987476,1395,1405,1390,13081,66,104,73574,182734,74,13007
100600,013360,1410,2,100,7.63,125.54,400652,502960,102308,1287,1762,475,994183,1400,1410,1400,6633,27,52,73040,173485,1125,5508
100600,013360,1400,2,90,6.87,124.64,407265,507627,100362,1326,1805,479,1005463,1400,1410,1400,17913,66,95,71859,182083,7738,10175
100700,013360,1405,2,95,7.25,123.87,409915,507773,97858,1331,1817,486,1008259,1405,1405,1400,767,3,10,78551,185496,638,129
100700,013360,1410,2,100,7.63,123.97,412999,511975,98976,1333,1826,493,1015545,1405,1410,1400,8053,5,19,87354,192583,3722,4331
100800,013360,1410,2,100,7.63,124.21,413092,513105,100013,1336,1833,497,1016768,1400,1410,1400,1010,2,4,86408,192795,2,1008
100800,013360,1405,2,95,7.25,120.39,427321,514465,87144,1338,1837,499,1032357,1400,1410,1400,16599,4,8,84665,196383,14231,2368
100900,013360,1405,2,95,7.25,120.79,427351,516176,88825,1367,1892,525,1034098,1405,1405,1400,1668,29,53,83956,173365,30,1638
100900,013360,1405,2,95,7.25,121.05,427747,517772,90025,1446,2012,566,1036090,1405,1405,1395,3660,108,173,87999,173753,426,3234
101000,013360,1395,2,85,6.49,118.83,440075,522941,82866,1528,2116,588,1053587,1395,1400,1395,301,58,79,81180,191035,67,234
101000,013360,1400,2,90,6.87,116.4,451388,525401,74013,1602,2238,636,1067360,1395,1400,1395,14074,132,201,84456,180451,11380,2694
101100,013360,1395,2,85,6.49,108.98,482633,525950,43317,1679,2369,690,1099154,1400,1400,1390,25916,58,99,64010,161259,25526,390
101100,013360,1395,2,85,6.49,107.43,490119,526519,36400,1766,2492,726,1107209,1400,1400,1385,33971,145,222,64978,155738,33012,959
101200,013360,1395,2,85,6.49,107.46,490366,526951,36585,1840,2599,759,1107888,1390,1395,1390,521,63,86,68012,163226,236,285
101200,013360,1395,2,85,6.49,107.29,491344,527163,35819,1899,2694,795,1109078,1390,1395,1390,1711,122,181,67750,162561,1214,497
101300,013360,1395,2,85,6.49,107.22,492053,527566,35513,1947,2762,815,1110190,1395,1395,1390,1051,38,55,68947,165588,699,352
101300,013360,1390,2,80,6.11,107.55,492416,529598,37182,1949,2765,816,1112585,1395,1395,1390,3446,40,58,66919,168626,1062,2384
101400,013360,1395,2,85,6.49,107.82,493412,532005,38593,1950,2769,819,1115988,1395,1395,1395,3400,1,3,77431,156791,996,2404
101400,013360,1395,2,85,6.49,108.14,493412,533586,40174,1950,2773,823,1117569,1395,1395,1395,4981,1,7,64568,174536,996,3985
101500,013360,1395,2,85,6.49,108.37,494423,535782,41359,1953,2775,822,1120776,1395,1395,1395,3207,3,2,77926,158403,1011,2196
101600,013360,1390,2,80,6.11,108.16,495348,535782,40434,1956,2775,819,1121701,1390,1390,1390,0,0,0,67258,173253,0,0
101600,013360,1395,2,85,6.49,108.24,495639,536482,40843,1957,2779,822,1122692,1395,1395,1395,991,1,4,77102,158388,291,700
101700,013360,1395,2,85,6.49,108.24,495652,536509,40857,1959,2782,823,1122732,1395,1395,1395,2,1,0,77561,157878,2,0
101700,013360,1395,2,85,6.49,108.25,495674,536546,40872,1962,2784,822,1122791,1395,1400,1395,61,4,2,77524,158126,24,37
101800,013360,1395,2,85,6.49,108.58,495675,538212,42537,1963,2786,823,1124458,1395,1395,1395,0,0,0,76061,157113,0,0
101800,013360,1400,2,90,6.87,108.46,496254,538247,41993,1965,2787,822,1125072,1395,1400,1395,614,2,1,76061,122259,579,35
101900,013360,1400,2,90,6.87,108.83,496254,540088,43834,1965,2789,824,1126913,1400,1400,1400,1341,0,1,75526,123461,0,1341
101900,013360,1395,2,85,6.49,109.74,496269,544608,48339,1968,2793,825,1131448,1400,1405,1395,5876,3,5,98074,124357,15,5861
102000,013360,1405,2,95,7.25,109.74,496281,544610,48329,1971,2795,824,1131462,1405,1405,1405,0,0,0,98709,111569,0,0
102000,013360,1400,2,90,6.87,109.86,496292,545239,48947,1972,2798,826,1132102,1405,1405,1400,640,1,3,71090,124899,11,629
102100,013360,1395,2,85,6.49,109.87,496295,545256,48961,1973,2799,826,1132122,1395,1395,1395,3,1,0,71210,124472,3,0
102100,013360,1400,2,90,6.87,109.98,496296,545806,49510,1974,2801,827,1132673,1395,1400,1395,554,2,2,70953,124882,4,550
102200,013360,1400,2,90,6.87,109.92,496597,545838,49241,1976,2806,830,1133006,1400,1400,1400,0,0,0,70644,127977,0,0
102200,013360,1400,2,90,6.87,109.92,496597,545848,49251,1976,2807,831,1133016,1400,1400,1400,10,0,1,70671,123924,0,10
102300,013360,1400,2,90,6.87,109.92,496597,545866,49269,1976,2808,832,1133034,1400,1400,1400,18,0,1,71963,123278,0,18
102300,013360,1400,2,90,6.87,110.21,496597,547315,50718,1976,2814,838,1134485,1400,1405,1400,1469,0,7,71323,123083,0,1467
102400,013360,1400,2,90,6.87,109.97,497701,547327,49626,1979,2815,836,1135601,1400,1400,1400,1104,3,0,99098,109464,1104,0
102400,013360,1405,2,95,7.25,109.95,497816,547347,49531,1981,2817,836,1135736,1400,1405,1400,1239,5,2,99429,109615,1219,20
102500,013360,1405,2,95,7.25,109.86,498218,547348,49130,1983,2818,835,1136139,1400,1405,1400,403,2,1,99438,111861,402,1
102500,013360,1400,2,90,6.87,109.93,498225,547703,49478,1985,2819,834,1136501,1400,1405,1400,765,4,2,101280,114127,409,356
102600,013360,1400,2,90,6.87,108.82,503307,547703,44396,1987,2819,832,1141583,1400,1400,1400,5082,2,0,101133,114627,5082,0
102600,013360,1400,2,90,6.87,108.08,506758,547703,40945,1991,2819,828,1145034,1400,1400,1400,8533,6,0,98300,105725,8533,0
102700,013360,1400,2,90,6.87,108.08,506758,547703,40945,1991,2819,828,1145034,1400,1400,1400,0,0,0,98300,105725,0,0
102700,013360,1390,2,80,6.11,107.14,511193,547703,36510,1994,2819,825,1149469,1395,1395,1390,4435,3,0,57824,125016,4435,0
102800,013360,1400,2,90,6.87,107.21,511194,548029,36835,1995,2836,841,1149796,1395,1400,1395,262,0,6,71249,119476,0,262
102800,013360,1405,2,95,7.25,107.62,511194,550131,38937,1995,2841,846,1151898,1395,1405,1395,2364,0,11,98123,119476,0,2364
102900,013360,1405,2,95,7.25,107.62,511197,550146,38949,1996,2843,847,1151916,1405,1405,1405,15,0,2,98509,116618,0,15
102900,013360,1400,2,90,6.87,107.62,511197,550147,38950,1996,2844,848,1151917,1405,1405,1400,16,0,3,71015,116608,0,16
103000,013360,1405,2,95,7.25,107.53,512697,551322,38625,1997,2859,862,1154592,1400,1405,1400,1175,0,15,97261,100950,0,1175
103000,013360,1405,2,95,7.25,107.53,512697,551322,38625,1997,2859,862,1154592,1400,1405,1400,1175,0,15,97261,100950,0,1175
103100,013360,1395,2,85,6.49,106.97,515400,551322,35922,2001,2859,858,1157295,1400,1400,1395,2703,4,0,80870,112016,2703,0
103100,013360,1400,2,90,6.87,107.03,515400,551634,36234,2001,2864,863,1157607,1400,1400,1395,3015,4,5,81146,111314,2703,312
103200,013360,1400,2,90,6.87,107.03,515400,551634,36234,2001,2864,863,1157607,1400,1400,1400,0,0,0,81146,111314,0,0
103200,013360,1395,2,85,6.49,107.03,515410,551634,36224,2003,2864,861,1157617,1395,1395,1395,10,2,0,80857,112362,10,0
103300,013360,1395,2,85,6.49,107.09,515411,551961,36550,2004,2866,862,1157945,1400,1400,1395,328,1,2,79530,113062,1,327
103300,013360,1400,2,90,6.87,106.98,515960,551991,36031,2005,2874,869,1158524,1400,1400,1395,907,2,10,81101,114706,550,357
103400,013360,1400,2,90,6.87,108.03,516068,557489,41421,2061,2969,908,1164130,1400,1405,1395,5605,55,95,96051,101072,107,5498
103500,013360,1400,2,90,6.87,107.74,517954,558065,40111,2115,3062,947,1166592,1405,1405,1395,1836,2,2,71911,120201,1834,2
103500,013360,1405,2,95,7.25,107.48,521397,560388,38991,2166,3121,955,1172358,1405,1405,1395,7602,53,61,98409,105011,5277,2325
103600,013360,1400,2,90,6.87,107.22,522790,560511,37721,2198,3180,982,1173874,1400,1400,1400,14,0,5,71856,117360,0,14
103600,013360,1395,2,85,6.49,107.23,522808,560596,37788,2216,3220,1004,1173977,1400,1400,1395,117,18,45,71770,117938,18,99
103700,013360,1400,2,90,6.87,107.17,523408,560929,37521,2265,3278,1013,1174910,1400,1400,1395,194,7,9,84189,118711,7,187
103700,013360,1400,2,90,6.87,107.19,523459,561090,37631,2316,3340,1024,1175122,1400,1400,1395,406,58,71,85324,118819,58,348
103800,013360,1395,2,85,6.49,107.16,523762,561261,37499,2370,3403,1033,1175596,1395,1400,1395,279,11,10,85162,119117,260,19
103800,013360,1400,2,90,6.87,107.5,523815,563121,39306,2423,3473,1050,1177509,1395,1400,1395,2192,64,80,84533,119094,313,1879
103900,013360,1395,2,85,6.49,107.53,523868,563303,39435,2476,3535,1059,1177744,1395,1400,1395,65,13,16,84350,122811,13,52
103900,013360,1395,2,85,6.49,107.55,523932,563496,39564,2531,3602,1071,1178001,1395,1400,1395,322,68,83,84157,123974,77,245
104000,013360,1400,2,90,6.87,109.5,524076,573878,49802,2576,3657,1081,1188527,1395,1400,1395,10279,6,9,84023,124160,6,10273
104000,013360,1405,2,95,7.25,109.94,524127,576248,52121,2627,3756,1129,1190948,1395,1405,1395,12700,57,108,106607,124621,57,12643
104100,013360,1410,2,100,7.63,110.74,524191,580489,56298,2689,3872,1183,1195253,1410,1410,1405,113,21,28,118507,109828,22,91
104100,013360,1405,2,95,7.25,110.73,525497,581867,56370,2749,3975,1226,1197937,1410,1410,1400,2797,81,131,114214,119886,1328,1469
104200,013360,1405,2,95,7.25,111.43,526218,586384,60166,2809,4079,1270,1203175,1405,1410,1400,1231,25,43,113289,119876,686,545
104200,013360,1400,2,90,6.87,111.58,526277,587235,60958,2868,4175,1307,1204085,1405,1410,1400,2141,84,139,113458,117872,745,1396
104300,013360,1400,2,90,6.87,108.34,542720,587996,45276,2931,4269,1338,1221289,1400,1400,1395,251,27,44,81412,115670,36,215
104300,013360,1395,2,85,6.49,108.4,542767,588341,45574,2977,4340,1363,1221681,1400,1405,1395,643,73,115,109317,115148,83,560
104400,013360,1395,2,85,6.49,107.79,545888,588391,42503,2981,4341,1360,1224852,1395,1395,1395,601,2,0,93485,113632,601,0
104400,013360,1385,2,75,5.73,105.92,555613,588491,32878,2985,4343,1358,1234677,1395,1395,1385,10426,6,2,85934,115592,10326,100
104500,013360,1385,2,75,5.73,105.86,555893,588492,32599,2989,4344,1355,1234958,1390,1390,1385,222,1,1,90806,118504,221,1
104500,013360,1395,2,85,6.49,105.86,555893,588493,32600,2989,4345,1356,1234959,1390,1395,1385,223,1,2,90806,118283,221,2
104600,013360,1385,2,75,5.73,105.1,559932,588493,28561,2992,4345,1353,1238998,1385,1385,1385,4002,2,0,92264,119229,4002,0
104600,013360,1390,2,80,6.11,105.05,560187,588494,28307,2994,4346,1352,1239254,1385,1395,1385,4258,4,1,88047,112436,4257,1
104700,013360,1390,2,80,6.11,105.05,560187,588497,28310,2994,4348,1354,1239257,1390,1390,1390,0,0,0,69483,116742,0,0
104700,013360,1385,2,75,5.73,104.91,560967,588497,27530,2995,4348,1353,1240037,1385,1385,1385,780,1,0,69842,116942,780,0
104800,013360,1385,2,75,5.73,104.81,561514,588507,26993,2999,4349,1350,1240594,1385,1390,1385,267,2,1,69834,115077,257,10
104800,013360,1385,2,75,5.73,104.67,562240,588507,26267,3002,4349,1347,1241320,1385,1390,1385,993,5,1,69112,114821,983,10
104900,013360,1390,2,80,6.11,104.67,562245,588508,26263,3003,4350,1347,1241326,1385,1390,1385,6,1,1,70112,114094,5,1
104900,013360,1390,2,80,6.11,104.67,562245,588510,26265,3003,4351,1348,1241328,1385,1390,1385,8,1,2,70148,114094,5,3
105000,013360,1390,2,80,6.11,104.67,562245,588510,26265,3003,4351,1348,1241328,1390,1390,1390,0,0,0,70148,114094,0,0
105000,013360,1385,2,75,5.73,104.67,562246,588510,26264,3004,4351,1347,1241329,1385,1385,1385,1,1,0,71139,112005,1,0
105100,013360,1390,2,80,6.11,104.58,562746,588511,25765,3005,4352,1347,1241830,1385,1390,1385,501,1,1,71139,129343,500,1
105100,013360,1390,2,80,6.11,104.54,563746,589350,25604,3006,4353,1347,1243669,1385,1390,1385,2340,2,2,79872,110709,1500,840
105200,013360,1395,2,85,6.49,104.71,563791,590352,26561,3007,4356,1349,1244716,1395,1395,1390,1047,1,3,76716,109706,45,1002
105200,013360,1390,2,80,6.11,104.71,563794,590352,26558,3009,4356,1347,1244719,1395,1395,1390,1050,3,3,76715,109704,48,1002
105300,013360,1395,2,85,6.49,104.71,563794,590353,26559,3009,4357,1348,1244720,1395,1395,1395,1,0,1,77065,109703,0,1
105400,013360,1395,2,85,6.49,104.71,563794,590353,26559,3009,4357,1348,1244720,1395,1395,1395,0,0,0,77065,109703,0,0
105400,013360,1395,2,85,6.49,104.71,563794,590353,26559,3009,4357,1348,1244720,1395,1395,1395,0,0,0,82061,109703,0,0
105500,013360,1390,2,80,6.11,103.73,569101,590353,21252,3014,4357,1343,1250027,1390,1390,1390,0,0,0,82061,106963,0,0
105500,013360,1395,2,85,6.49,103.58,570015,590402,20387,3017,4366,1349,1250992,1390,1395,1385,965,3,9,82334,125922,914,49
105600,013360,1390,2,80,6.11,103.58,570025,590426,20401,3018,4369,1351,1251026,1390,1390,1390,0,0,0,82382,100443,0,0
105600,013360,1385,2,75,5.73,103.58,570028,590426,20398,3019,4369,1350,1251029,1385,1385,1385,3,1,0,82882,125252,3,0
105700,013360,1385,2,75,5.73,103.55,570160,590426,20266,3020,4369,1349,1251161,1385,1385,1385,0,0,0,73810,125249,0,0
105700,013360,1395,2,85,6.49,103.55,570170,590428,20258,3021,4371,1350,1251173,1385,1395,1385,12,1,2,73678,123850,10,2
105800,013360,1395,2,85,6.49,103.58,570170,590572,20402,3021,4373,1352,1251317,1395,1395,1395,143,0,1,82605,125117,0,143
105800,013360,1385,2,75,5.73,103.58,570171,590572,20401,3022,4373,1351,1251318,1395,1395,1385,144,1,1,77932,125653,1,143
105900,013360,1385,2,75,5.73,103.54,570371,590573,20202,3023,4374,1351,1251519,1385,1385,1385,200,1,0,79131,125676,200,0
105900,013360,1390,2,80,6.11,103.49,570671,590578,19907,3024,4376,1352,1251824,1385,1390,1385,505,2,2,74315,124683,500,5
110000,013360,1390,2,80,6.11,103.49,570671,590578,19907,3024,4376,1352,1251824,1390,1390,1390,0,0,0,74315,124683,0,0
110000,013360,1385,2,75,5.73,103.24,572029,590578,18549,3028,4376,1348,1253182,1385,1385,1385,1358,4,0,80254,125374,1358,0
110100,013360,1390,2,80,6.11,103.17,574348,592579,18231,3031,4378,1347,1257502,1390,1390,1390,2001,0,2,79314,122055,0,2001
110100,013360,1390,2,80,6.11,103.18,574348,592587,18239,3031,4380,1349,1257510,1390,1390,1390,2009,0,4,72368,123055,0,2009
110200,013360,1390,2,80,6.11,103.18,574348,592587,18239,3031,4380,1349,1257510,1390,1390,1390,0,0,0,72368,123055,0,0
110200,013360,1390,2,80,6.11,103.18,574349,592588,18239,3032,4381,1349,1257512,1385,1390,1385,2,1,1,72363,123468,1,1
110300,013360,1390,2,80,6.11,103.18,574349,592592,18243,3032,4382,1350,1257516,1390,1390,1390,4,0,1,72362,123475,0,4
110300,013360,1390,2,80,6.11,103.39,574349,593840,19491,3032,4384,1352,1258764,1390,1390,1390,1252,0,3,72171,123475,0,1252
110400,013360,1385,2,75,5.73,103.39,574389,593842,19453,3033,4385,1352,1258806,1390,1390,1385,42,1,1,71108,121975,40,2
110400,013360,1390,2,80,6.11,103.43,574393,594067,19674,3035,4388,1353,1259035,1390,1390,1385,271,3,4,70886,121672,44,227
110500,013360,1390,2,80,6.11,102.86,577807,594321,16514,3038,4390,1352,1262703,1390,1390,1390,1,0,1,70761,119211,0,1
110500,013360,1390,2,80,6.11,102.86,577807,594322,16515,3038,4391,1353,1262704,1390,1390,1390,2,0,2,70937,119211,0,2
110600,013360,1385,2,75,5.73,102.86,577808,594322,16514,3039,4391,1352,1262705,1385,1385,1385,1,1,0,75336,118270,1,0
110600,013360,1380,2,70,5.34,101.59,585033,594337,9304,3041,4393,1352,1269945,1385,1385,1380,7241,3,2,74051,118485,7226,15
110700,013360,1380,2,70,5.34,101.34,586479,594337,7858,3044,4393,1349,1271391,1380,1380,1380,1446,3,0,74051,109550,1446,0
110700,013360,1380,2,70,5.34,101.34,586479,594337,7858,3044,4393,1349,1271391,1380,1380,1380,1446,3,0,74051,109550,1446,0
110800,013360,1380,2,70,5.34,101.02,588361,594340,5979,3048,4394,1346,1273276,1375,1380,1375,1885,4,1,76218,116798,1882,3
110800,013360,1375,2,65,4.96,100.99,588531,594342,5811,3050,4395,1345,1273448,1375,1380,1375,2057,6,2,76213,116229,2052,5
110900,013360,1380,2,70,5.34,100.99,588531,594343,5812,3050,4396,1346,1273449,1380,1380,1380,1,0,1,77213,116095,0,1
110900,013360,1370,2,60,4.58,100.89,589087,594348,5261,3053,4397,1344,1274010,1380,1380,1370,562,3,2,73921,137829,556,6
111000,013360,1375,2,65,4.96,100.96,589138,594813,5675,3055,4400,1345,1274526,1375,1375,1370,516,2,3,74415,137278,51,465
111000,013360,1370,2,60,4.58,101.14,589451,596179,6728,3058,4402,1344,1276205,1375,1375,1370,2195,5,5,73081,139402,364,1831
111100,013360,1375,2,65,4.96,101.18,589451,596404,6953,3058,4404,1346,1276430,1375,1375,1375,225,0,2,78127,138972,0,225
111200,013360,1375,2,65,4.96,101.51,589751,598657,8906,3059,4408,1349,1278983,1375,1375,1375,0,0,0,76350,140622,0,0
111200,013360,1370,2,60,4.58,101.51,589755,598658,8903,3061,4409,1348,1278988,1370,1375,1370,5,2,1,71752,140627,4,1
111300,013360,1375,2,65,4.96,101.6,589755,599191,9436,3061,4411,1350,1279521,1375,1375,1375,0,0,0,75261,140631,0,0
111300,013360,1370,2,60,4.58,101.5,590360,599215,8855,3063,4413,1350,1280150,1375,1375,1370,629,2,2,74705,140626,605,24
111400,013360,1380,2,70,5.34,100.97,593569,599325,5756,3068,4415,1347,1283469,1375,1380,1375,2,1,1,77777,121160,1,1
111400,013360,1380,2,70,5.34,101.14,593569,600325,6756,3068,4416,1348,1284469,1375,1380,1375,1002,1,2,77776,121160,1,1001
111500,013360,1380,2,70,5.34,101.14,593569,600330,6761,3068,4417,1349,1284474,1380,1380,1380,0,0,0,76776,121163,0,0
111500,013360,1380,2,70,5.34,101.14,593569,600333,6764,3068,4418,1350,1284477,1380,1380,1380,3,0,1,76771,126163,0,3
111600,013360,1375,2,65,4.96,101.09,593870,600333,6463,3070,4418,1348,1284778,1375,1375,1375,0,0,0,73939,126684,0,0
111600,013360,1380,2,70,5.34,101.04,594172,600334,6162,3072,4419,1347,1285081,1375,1380,1375,303,2,1,73939,126381,302,1
111700,013360,1380,2,70,5.34,101.11,594172,600741,6569,3072,4423,1351,1285488,1380,1380,1380,3,0,2,76713,126384,0,3
111700,013360,1380,2,70,5.34,101.11,594172,600746,6574,3072,4424,1352,1285493,1380,1380,1380,8,0,3,76712,126384,0,8
111800,013360,1375,2,65,4.96,101.11,594176,600746,6570,3074,4424,1350,1285497,1375,1375,1375,0,0,0,76707,126503,0,0
111800,013360,1375,2,65,4.96,101.1,594183,600746,6563,3075,4424,1349,1285504,1375,1375,1375,7,1,0,76707,126502,7,0
111900,013360,1380,2,70,5.34,101.11,594183,600760,6577,3075,4429,1354,1285518,1380,1380,1380,2,0,1,76695,128502,0,2
111900,013360,1375,2,65,4.96,101.11,594184,600760,6576,3076,4429,1353,1285519,1380,1380,1375,3,1,1,76693,128497,1,2
112000,013360,1380,2,70,5.34,101.11,594187,600793,6606,3078,4436,1358,1285555,1380,1380,1375,14,1,2,76672,128516,2,12
112000,013360,1380,2,70,5.34,101.11,594187,600797,6610,3078,4437,1359,1285559,1380,1380,1375,18,1,3,72119,127979,2,16
112100,013360,1380,2,70,5.34,101.11,594187,600797,6610,3078,4437,1359,1285559,1380,1380,1380,0,0,0,72119,127979,0,0
112100,013360,1380,2,70,5.34,101.11,594187,600797,6610,3078,4437,1359,1285559,1380,1380,1380,0,0,0,77064,127979,0,0
112200,013360,1380,2,70,5.34,101.13,594439,601150,6711,3080,4440,1360,1286164,1380,1380,1380,353,0,3,77212,127734,0,353
112200,013360,1380,2,70,5.34,101.13,594439,601155,6716,3080,4441,1361,1286169,1380,1380,1380,358,0,4,77481,122734,0,358
112300,013360,1380,2,70,5.34,101.13,594439,601169,6730,3080,4442,1362,1286183,1380,1380,1380,14,0,1,76976,123238,0,14
112300,013360,1375,2,65,4.96,101.17,594440,601414,6974,3081,4450,1369,1286429,1380,1380,1375,260,1,9,76227,123341,1,259
112400,013360,1375,2,65,4.96,101.17,594443,601418,6975,3082,4451,1369,1286436,1375,1375,1375,3,1,0,76223,123340,3,0
112400,013360,1375,2,65,4.96,101.17,594443,601418,6975,3082,4451,1369,1286436,1375,1375,1375,3,1,0,76223,123340,3,0
112500,013360,1375,2,65,4.96,100.78,596750,601418,4668,3083,4451,1368,1288743,1375,1375,1375,0,0,0,75723,123337,0,0
112500,013360,1370,2,60,4.58,100.42,598889,601427,2538,3085,4453,1368,1290891,1375,1375,1370,2148,2,2,70379,134007,2139,9
112600,013360,1375,2,65,4.96,100.4,599970,602371,2401,3088,4464,1376,1292916,1375,1375,1375,1239,1,8,69808,130878,310,929
112600,013360,1375,2,65,4.96,100.38,600070,602371,2301,3089,4464,1375,1293016,1375,1375,1375,1339,2,8,76523,113783,410,929
112700,013360,1380,2,70,5.34,100.38,600120,602377,2257,3090,4466,1376,1293072,1380,1380,1380,4,0,1,76521,113516,0,4
112700,013360,1375,2,65,4.96,100.38,600121,602377,2256,3091,4466,1375,1293073,1380,1380,1375,5,1,1,71568,113516,1,4
112800,013360,1375,2,65,4.96,100.38,600123,602377,2254,3092,4466,1374,1293075,1375,1375,1375,0,0,0,71571,113515,0,0
112800,013360,1380,2,70,5.34,100.33,600383,602378,1995,3094,4467,1373,1293336,1375,1380,1375,261,2,1,73109,112765,260,1
112900,013360,1380,2,70,5.34,100.31,600533,602382,1849,3095,4469,1374,1293490,1380,1380,1375,154,1,2,73105,112615,150,4
112900,013360,1375,2,65,4.96,100.1,601800,602415,615,3097,4470,1373,1294790,1380,1380,1375,1454,3,3,73155,130270,1417,37
113000,013360,1370,2,60,4.58,100.1,601802,602415,613,3098,4470,1372,1294792,1370,1370,1370,2,1,0,73122,133272,2,0
113100,013360,1370,2,60,4.58,100.78,601802,606468,4666,3098,4477,1379,1298845,1370,1370,1370,10,0,1,64806,133552,0,10
113100,013360,1365,2,55,4.2,100.03,606303,606468,165,3100,4477,1377,1303346,1370,1370,1365,4511,2,1,64161,135841,4501,10
113200,013360,1375,2,65,4.96,98.93,616663,610051,-6612,3108,4486,1378,1317289,1375,1375,1375,0,0,0,59330,130901,0,0
113200,013360,1360,2,50,3.82,98.92,616735,610051,-6684,3109,4486,1377,1317361,1360,1360,1360,72,1,0,66074,130801,72,0
113300,013360,1360,2,50,3.82,98.84,617235,610051,-7184,3111,4486,1375,1317861,1360,1360,1360,0,0,0,66074,123824,0,0
113300,013360,1365,2,55,4.2,98.84,617236,610058,-7178,3112,4488,1376,1317869,1370,1370,1365,8,1,2,58213,123280,1,7
113400,013360,1365,2,55,4.2,98.84,617236,610058,-7178,3112,4488,1376,1317869,1365,1365,1365,0,0,0,58213,123280,0,0
113400,013360,1365,2,55,4.2,98.68,618238,610062,-8176,3114,4489,1375,1318875,1365,1370,1365,1006,2,1,59209,122978,1002,4
113500,013360,1365,2,55,4.2,98.84,618269,611095,-7174,3116,4493,1377,1319939,1365,1365,1365,1033,0,4,52055,148401,0,1033
113500,013360,1365,2,55,4.2,98.84,618270,611104,-7166,3117,4494,1377,1319949,1365,1365,1365,1043,1,5,57474,140830,1,1042
113600,013360,1370,2,60,4.58,98.84,618277,611115,-7162,3119,4498,1379,1319967,1370,1370,1370,8,0,2,57466,147122,0,8
113600,013360,1370,2,60,4.58,98.84,618277,611135,-7142,3119,4500,1381,1319987,1370,1370,1370,28,0,4,57653,145822,0,28
113700,013360,1370,2,60,4.58,98.84,618277,611135,-7142,3119,4500,1381,1319987,1370,1370,1370,0,0,0,57653,145822,0,0
113700,013360,1365,2,55,4.2,98.84,618278,611135,-7143,3120,4500,1380,1319988,1365,1365,1365,1,1,0,57643,147823,1,0
113800,013360,1370,2,60,4.58,98.85,618278,611139,-7139,3120,4501,1381,1319992,1370,1370,1370,0,0,0,57143,146622,0,0
113800,013360,1370,2,60,4.58,98.85,618278,611145,-7133,3120,4502,1382,1319998,1370,1370,1370,6,0,1,57639,148628,0,6
113900,013360,1370,2,60,4.58,98.85,618278,611145,-7133,3120,4502,1382,1319998,1370,1370,1370,0,0,0,57639,148628,0,0
113900,013360,1365,2,55,4.2,98.84,618302,611150,-7152,3123,4504,1381,1320027,1365,1370,1365,29,3,2,57897,148603,24,5
114000,013360,1365,2,55,4.2,98.84,618302,611150,-7152,3123,4504,1381,1320027,1365,1365,1365,0,0,0,57897,148603,0,0
114000,013360,1370,2,60,4.58,98.84,618302,611152,-7150,3123,4506,1383,1320029,1370,1370,1370,2,0,2,61805,148673,0,2
114100,013360,1370,2,60,4.58,98.84,618303,611157,-7146,3124,4508,1384,1320035,1365,1370,1365,6,1,2,63803,148602,1,5
114100,013360,1365,2,55,4.2,98.69,619303,611162,-8141,3125,4509,1384,1321040,1365,1370,1365,1011,2,3,63794,148973,1001,10
114200,013360,1370,2,60,4.58,98.69,619303,611163,-8140,3125,4510,1385,1321041,1370,1370,1370,1,0,1,63794,147973,0,1
114200,013360,1370,2,60,4.58,98.69,619303,611163,-8140,3125,4510,1385,1321041,1370,1370,1370,1,0,1,63794,147973,0,1
114300,013360,1365,2,55,4.2,98.69,619304,611166,-8138,3126,4511,1385,1321045,1365,1365,1365,1,1,0,63790,148638,1,0
114300,013360,1365,2,55,4.2,98.69,619306,611166,-8140,3127,4511,1384,1321047,1365,1365,1365,3,2,0,63790,148637,3,0
114400,013360,1370,2,60,4.58,98.69,619306,611167,-8139,3127,4512,1385,1321048,1370,1370,1370,0,0,0,64790,148640,0,0
114400,013360,1370,2,60,4.58,98.69,619306,611171,-8135,3127,4513,1386,1321052,1370,1370,1370,4,0,1,64789,148640,0,4
114500,013360,1365,2,55,4.2,98.69,619307,611171,-8136,3128,4513,1385,1321053,1365,1365,1365,1,1,0,64789,148147,1,0
114500,013360,1365,2,55,4.2,98.69,619307,611171,-8136,3128,4513,1385,1321053,1365,1365,1365,1,1,0,64789,148147,1,0
114600,013360,1370,2,60,4.58,98.85,619307,612176,-7131,3128,4517,1389,1322058,1370,1370,1370,5,0,3,63783,181446,0,5
114600,013360,1370,2,60,4.58,98.85,619307,612182,-7125,3128,4518,1390,1322064,1370,1370,1370,11,0,4,63780,181146,0,11
114700,013360,1365,2,55,4.2,98.78,619744,612182,-7562,3130,4518,1388,1322501,1365,1365,1365,437,2,0,63774,182177,437,0
114800,013360,1370,2,60,4.58,98.78,619752,612183,-7569,3132,4519,1387,1322510,1370,1370,1370,0,0,0,63774,188326,0,0
114800,013360,1370,2,60,4.58,98.78,619752,612187,-7565,3132,4520,1388,1322514,1370,1370,1370,4,0,1,63773,188332,0,4
114900,013360,1365,2,55,4.2,98.78,619753,612187,-7566,3133,4520,1387,1322515,1365,1365,1365,0,0,0,64069,188462,0,0
114900,013360,1370,2,60,4.58,98.86,619753,612692,-7061,3133,4522,1389,1323020,1370,1370,1370,505,0,2,63569,188261,0,505
115000,013360,1375,2,65,4.96,99.44,619753,616262,-3491,3133,4525,1392,1326590,1375,1375,1375,0,0,0,68929,187095,0,0
115000,013360,1370,2,60,4.58,100.07,619769,620214,445,3149,4548,1399,1330558,1375,1375,1370,3968,16,23,65670,190229,16,3952
115100,013360,1370,2,60,4.58,100.37,619821,622086,2265,3201,4604,1403,1332482,1380,1380,1370,102,13,14,66405,190378,13,89
115100,013360,1380,2,70,5.34,100.37,619872,622135,2263,3251,4653,1402,1332582,1380,1380,1370,202,63,63,66357,176894,64,138
115200,013360,1375,2,65,4.96,100.37,619921,622198,2277,3300,4704,1404,1332694,1375,1380,1375,29,15,14,66294,177026,15,14
115200,013360,1380,2,70,5.34,100.36,620068,622270,2202,3348,4756,1408,1332913,1375,1380,1375,248,63,66,66233,156972,162,86
115300,013360,1380,2,70,5.34,101.23,620123,627721,7598,3403,4814,1411,1338419,1380,1385,1380,337,19,19,71358,165163,19,318
115300,013360,1380,2,70,5.34,101.45,620174,629153,8979,3454,4869,1415,1339902,1380,1385,1380,1820,70,74,69926,176229,70,1750
115400,013360,1390,2,80,6.11,102.52,620220,635872,15652,3500,4918,1418,1346667,1385,1390,1380,6636,18,20,69372,170711,18,6618
115400,013360,1385,2,75,5.73,102.53,620268,635939,15671,3548,4966,1418,1346782,1385,1390,1380,6751,66,68,71605,166687,66,6685
115500,013360,1385,2,75,5.73,103.56,620390,642472,22082,3599,5019,1420,1353437,1385,1390,1385,6527,23,25,66572,170913,23,6504
115500,013360,1385,2,75,5.73,103.56,620444,642523,22079,3652,5070,1418,1353542,1385,1390,1385,6632,76,76,71484,172951,77,6555
115600,013360,1390,2,80,6.11,104.04,620604,645673,25069,3704,5122,1418,1356852,1385,1390,1385,3160,26,27,68340,173429,35,3125
115600,013360,1385,2,75,5.73,104.05,620703,645829,25126,3754,5170,1416,1357107,1385,1390,1385,3415,76,75,68213,174624,134,3281
115700,013360,1385,2,75,5.73,104.07,621035,646330,25295,3805,5224,1419,1357940,1385,1390,1385,786,30,30,67388,176798,311,475
115700,013360,1390,2,80,6.11,104.08,621279,646639,25360,3850,5271,1421,1358493,1385,1390,1385,1339,75,77,67185,180066,555,784
115800,013360,1390,2,80,6.11,104.06,621432,646682,25250,3895,5314,1419,1358689,1385,1390,1385,160,27,25,67789,183996,135,25
115800,013360,1395,2,85,6.49,104.82,621476,651457,29981,3939,5361,1422,1363508,1385,1395,1385,4979,71,72,72687,184770,179,4800
115900,013360,1390,2,80,6.11,105.34,621835,655025,33190,3988,5414,1426,1367435,1390,1395,1390,3788,33,36,69240,164680,343,3445
115900,013360,1390,2,80,6.11,105.51,621887,656122,34235,4038,5467,1429,1368584,1390,1395,1390,4937,83,89,68502,167792,395,4542
120000,013360,1395,2,85,6.49,105.73,621936,657547,35611,4087,5520,1433,1370058,1395,1400,1390,1345,34,38,80105,138601,34,1311
120000,013360,1395,2,85,6.49,105.54,623145,657684,34539,4140,5572,1432,1371404,1395,1400,1390,2691,87,90,80861,132981,1243,1448
120100,013360,1390,2,80,6.11,103.18,637425,657707,20282,4172,5595,1423,1385707,1400,1400,1390,12079,19,11,72672,147481,12068,11
120100,013360,1395,2,85,6.49,103.18,637425,657708,20283,4172,5596,1424,1385708,1400,1400,1390,12080,19,12,72681,146789,12068,12
120200,013360,1395,2,85,6.49,103.49,637426,659676,22250,4173,5598,1425,1387677,1395,1395,1390,1969,1,2,69996,141634,1,1968
120200,013360,1395,2,85,6.49,103.49,637427,659677,22250,4174,5599,1425,1387679,1395,1395,1390,1971,2,3,70703,140638,2,1969
120300,013360,1385,2,75,5.73,103.49,637439,659677,22238,4176,5599,1423,1387691,1390,1390,1385,12,2,0,70712,144885,12,0
120300,013360,1395,2,85,6.49,103.49,637439,659678,22239,4176,5600,1424,1387692,1390,1395,1385,13,2,1,70722,144893,12,1
120400,013360,1390,2,80,6.11,103.49,637442,659678,22236,4177,5600,1423,1387695,1390,1390,1390,3,1,0,70780,139295,3,0
120400,013360,1385,2,75,5.73,103.48,637496,659678,22182,4179,5600,1421,1387749,1390,1390,1385,57,3,0,61504,143566,57,0
120500,013360,1385,2,75,5.73,103.48,637496,659678,22182,4179,5600,1421,1387749,1385,1385,1385,0,0,0,61504,143566,0,0
120600,013360,1395,2,85,6.49,103.48,637510,659679,22169,4181,5601,1420,1387764,1395,1395,1395,0,0,0,66175,143498,0,0
120600,013360,1395,2,85,6.49,103.48,637510,659679,22169,4181,5601,1420,1387764,1395,1395,1395,0,0,0,66175,143498,0,0
120700,013360,1390,2,80,6.11,103.48,637511,659680,22169,4182,5602,1420,1387766,1390,1390,1390,0,0,0,58677,144341,0,0
120700,013360,1390,2,80,6.11,103.48,637514,659684,22170,4183,5604,1421,1387773,1390,1390,1385,7,1,2,58673,141777,3,4
120800,013360,1380,2,70,5.34,103.09,639910,659684,19774,4185,5604,1419,1390169,1380,1380,1380,0,0,0,58687,141784,0,0
120800,013360,1385,2,75,5.73,103.07,640048,659687,19639,4186,5606,1420,1390310,1380,1390,1380,141,1,2,52945,149235,138,3
120900,013360,1390,2,80,6.11,103.07,640048,659692,19644,4186,5608,1422,1390315,1390,1390,1390,4,0,1,58366,143155,0,4
120900,013360,1390,2,80,6.11,103.07,640048,659692,19644,4186,5608,1422,1390315,1390,1390,1390,4,0,1,58366,143155,0,4
121000,013360,1395,2,85,6.49,103.18,640342,660688,20346,4187,5611,1424,1391605,1395,1395,1395,1,0,1,66559,138940,0,1
121000,013360,1395,2,85,6.49,103.18,640343,660689,20346,4188,5612,1424,1391607,1395,1395,1390,3,1,2,66558,138942,1,2
121100,013360,1390,2,80,6.11,103.1,640854,660692,19838,4190,5613,1423,1392121,1390,1390,1390,461,1,0,71551,137054,461,0
121100,013360,1395,2,85,6.49,103.08,640978,660693,19715,4192,5614,1422,1392246,1390,1395,1390,586,3,1,71551,136469,585,1
121200,013360,1395,2,85,6.49,103.08,640978,660693,19715,4192,5614,1422,1392246,1395,1395,1395,0,0,0,71551,136469,0,0
121200,013360,1395,2,85,6.49,103.08,641079,660798,19719,4194,5617,1423,1392452,1390,1395,1390,206,2,3,72663,136368,101,105
121300,013360,1395,2,85,6.49,103.08,641079,660804,19725,4194,5618,1424,1392458,1395,1395,1395,6,0,1,77542,136368,0,6
121300,013360,1395,2,85,6.49,103.08,641079,660804,19725,4194,5618,1424,1392458,1395,1395,1395,6,0,1,77542,136368,0,6
121400,013360,1395,2,85,6.49,103.08,641080,660807,19727,4195,5619,1424,1392462,1390,1395,1390,4,1,1,77536,137473,1,3
121400,013360,1395,2,85,6.49,103.08,641080,660807,19727,4195,5619,1424,1392462,1390,1395,1390,4,1,1,77536,137473,1,3
121500,013360,1390,2,80,6.11,103.08,641083,660807,19724,4196,5619,1423,1392465,1390,1390,1390,3,1,0,72586,137114,3,0
121500,013360,1390,2,80,6.11,102.91,642211,660907,18696,4198,5620,1422,1393693,1390,1395,1390,1231,3,1,69486,136120,1131,100
121600,013360,1390,2,80,6.11,102.91,642212,660923,18711,4199,5624,1425,1393710,1385,1390,1385,2,1,1,59161,139246,1,1
121600,013360,1390,2,80,6.11,102.91,642212,660925,18713,4199,5625,1426,1393712,1385,1390,1385,4,1,2,59175,139246,1,3
121700,013360,1390,2,80,6.11,102.86,642576,660926,18350,4200,5626,1426,1394077,1385,1390,1385,365,1,1,61809,138889,364,1
121700,013360,1390,2,80,6.11,102.86,642576,660929,18353,4200,5627,1427,1394080,1385,1390,1385,368,1,2,61830,138889,364,4
121800,013360,1390,2,80,6.11,102.86,642582,660930,18348,4202,5628,1426,1394087,1385,1390,1385,2,1,1,61322,138883,1,1
121800,013360,1390,2,80,6.11,102.63,643995,660936,16941,4203,5630,1427,1395506,1385,1390,1385,1421,2,3,61331,137834,1414,7
121900,013360,1390,2,80,6.11,102.63,643997,660942,16945,4204,5633,1429,1395514,1385,1390,1385,8,1,3,61328,137832,2,6
121900,013360,1390,2,80,6.11,102.61,644104,660943,16839,4205,5634,1429,1395622,1385,1390,1385,116,2,4,61324,137725,109,7
122000,013360,1385,2,75,5.73,102.44,645201,660944,15743,4209,5635,1426,1396720,1385,1390,1385,1098,4,1,61398,137824,1097,1
122000,013360,1385,2,75,5.73,102.41,645393,660945,15552,4210,5636,1426,1396913,1385,1390,1385,1291,5,2,58984,146147,1289,2
122100,013360,1385,2,75,5.73,102.41,645393,660954,15561,4210,5638,1428,1396922,1385,1385,1385,9,0,2,63926,142773,0,9
122200,013360,1380,2,70,5.34,102.41,645401,660954,15553,4212,5638,1426,1396930,1380,1380,1380,0,0,0,58974,145646,0,0
122200,013360,1380,2,70,5.34,102.41,645401,660954,15553,4212,5638,1426,1396930,1380,1380,1380,0,0,0,58974,145646,0,0
122300,013360,1380,2,70,5.34,102.39,645512,660960,15448,4214,5641,1427,1397047,1380,1380,1380,2,1,0,58918,145575,2,0
122300,013360,1385,2,75,5.73,102.39,645512,660961,15449,4214,5642,1428,1397048,1380,1385,1380,3,1,1,58918,145573,2,1
122400,013360,1380,2,70,5.34,102.39,645514,660966,15452,4216,5643,1427,1397055,1380,1380,1380,0,0,0,59983,145534,0,0
122400,013360,1385,2,75,5.73,102.42,645514,661161,15647,4216,5644,1428,1397250,1385,1385,1385,195,0,1,59983,145533,0,195
122500,013360,1385,2,75,5.73,102.42,645514,661164,15650,4216,5645,1429,1397253,1385,1385,1385,0,0,0,59798,145563,0,0
122500,013360,1385,2,75,5.73,102.43,645514,661187,15673,4216,5646,1430,1397276,1385,1385,1385,23,0,1,61317,142189,0,23
122600,013360,1380,2,70,5.34,102.43,645515,661187,15672,4217,5646,1429,1397277,1380,1380,1380,0,0,0,61294,142292,0,0
122600,013360,1385,2,75,5.73,102.43,645515,661197,15682,4217,5648,1431,1397287,1385,1385,1385,10,0,2,61290,142321,0,10
122700,013360,1380,2,70,5.34,102.43,645518,661197,15679,4218,5648,1430,1397290,1380,1380,1380,0,0,0,61284,142321,0,0
122700,013360,1380,2,70,5.34,102.43,645518,661197,15679,4218,5648,1430,1397290,1380,1380,1380,0,0,0,61284,142321,0,0
122800,013360,1385,2,75,5.73,102.43,645519,661200,15681,4219,5649,1430,1397294,1385,1385,1385,3,0,1,59592,142324,0,3
122800,013360,1385,2,75,5.73,102.43,645519,661200,15681,4219,5649,1430,1397294,1385,1385,1385,3,0,1,59592,142324,0,3
122900,013360,1385,2,75,5.73,102.43,645519,661205,15686,4219,5650,1431,1397299,1385,1385,1385,5,0,1,59889,142324,0,5
122900,013360,1380,2,70,5.34,101.65,650459,661205,10746,4221,5650,1429,1402239,1385,1385,1380,4945,2,1,61624,138720,4940,5
123000,013360,1380,2,70,5.34,101.58,650900,661209,10309,4222,5651,1429,1402684,1380,1380,1380,441,1,0,61620,138719,441,0
123000,013360,1380,2,70,5.34,101.58,650900,661209,10309,4222,5651,1429,1402684,1380,1380,1380,441,1,0,61620,138719,441,0
123100,013360,1380,2,70,5.34,101.63,650903,661495,10592,4224,5652,1428,1402973,1375,1380,1375,287,1,1,57065,147468,1,286
123100,013360,1375,2,65,4.96,101.63,650904,661498,10594,4225,5653,1428,1402977,1375,1380,1375,291,2,2,56776,147468,2,289
123200,013360,1375,2,65,4.96,101.63,650904,661498,10594,4225,5653,1428,1402977,1375,1375,1375,0,0,0,56776,147468,0,0
123200,013360,1375,2,65,4.96,101.63,650904,661498,10594,4225,5653,1428,1402977,1375,1375,1375,0,0,0,56776,147468,0,0
123300,013360,1380,2,70,5.34,101.63,650904,661502,10598,4225,5654,1429,1402981,1380,1380,1380,4,0,1,56774,147898,0,4
123300,013360,1375,2,65,4.96,101.63,650905,661509,10604,4226,5655,1429,1402989,1380,1380,1375,12,1,2,56763,147904,1,11
123400,013360,1380,2,70,5.34,101.63,650905,661516,10611,4226,5657,1431,1402996,1380,1380,1380,7,0,2,56774,148198,0,7
123500,013360,1375,2,65,4.96,101.63,650912,661516,10604,4229,5657,1428,1403003,1375,1375,1375,0,0,0,58418,148193,0,0
123500,013360,1375,2,65,4.96,101.63,650913,661519,10606,4230,5658,1428,1403007,1380,1380,1375,4,1,1,59615,153192,1,3
123600,013360,1380,2,70,5.34,101.78,650920,662519,11599,4231,5659,1428,1404014,1380,1380,1380,1000,0,1,59622,153184,0,1000
123600,013360,1375,2,65,4.96,101.78,650925,662519,11594,4232,5659,1427,1404019,1380,1380,1375,1005,1,1,58622,153184,5,1000
123700,013360,1380,2,70,5.34,101.78,650925,662528,11603,4232,5661,1429,1404028,1380,1380,1380,5,0,1,58618,153186,0,5
123700,013360,1375,2,65,4.96,101.78,650926,662528,11602,4233,5661,1428,1404029,1380,1380,1375,6,1,1,59513,153686,1,5
123800,013360,1375,2,65,4.96,101.8,650932,662628,11696,4234,5662,1428,1404135,1375,1375,1375,6,1,0,59407,153985,6,0
123800,013360,1375,2,65,4.96,101.8,650934,662631,11697,4235,5663,1428,1404140,1375,1380,1375,11,2,1,59414,154579,8,3
123900,013360,1375,2,65,4.96,101.8,650935,662631,11696,4236,5663,1427,1404141,1375,1375,1375,1,1,0,59766,154537,1,0
123900,013360,1375,2,65,4.96,101.74,651287,662632,11345,4237,5664,1427,1404494,1375,1380,1375,354,2,1,59765,154536,353,1
124000,013360,1380,2,70,5.34,101.74,651287,662637,11350,4237,5666,1429,1404499,1380,1380,1380,5,0,2,59112,154197,0,5
124100,013360,1380,2,70,5.34,101.74,651287,662637,11350,4237,5666,1429,1404499,1380,1380,1380,0,0,0,59112,154197,0,0
124100,013360,1375,2,65,4.96,101.74,651288,662637,11349,4238,5666,1428,1404500,1375,1375,1375,1,1,0,59113,154113,1,0
124200,013360,1380,2,70,5.34,101.74,651288,662640,11352,4238,5667,1429,1404503,1380,1380,1380,0,0,0,59113,154372,0,0
124200,013360,1380,2,70,5.34,101.74,651288,662650,11362,4238,5669,1431,1404513,1380,1380,1380,10,0,2,59110,155861,0,10
124300,013360,1375,2,65,4.96,101.74,651304,662650,11346,4240,5669,1429,1404529,1375,1375,1375,0,0,0,59600,155853,0,0
124300,013360,1375,2,65,4.96,101.66,651805,662650,10845,4242,5669,1427,1405030,1375,1375,1375,501,2,0,59100,155340,501,0
124400,013360,1375,2,65,4.96,101.65,651905,662654,10749,4243,5670,1427,1405134,1375,1375,1375,100,1,0,59096,150345,100,0
124400,013360,1380,2,70,5.34,101.65,651905,662655,10750,4243,5671,1428,1405135,1375,1380,1375,101,1,1,58696,150245,100,1
124500,013360,1380,2,70,5.34,101.65,651905,662660,10755,4243,5672,1429,1405140,1380,1380,1380,5,0,1,62574,150245,0,5
124500,013360,1380,2,70,5.34,101.65,651906,662663,10757,4244,5673,1429,1405144,1380,1380,1375,9,1,2,62769,150244,1,8
124600,013360,1380,2,70,5.34,101.68,651906,662846,10940,4244,5674,1430,1405327,1380,1380,1380,0,0,0,62766,150244,0,0
124600,013360,1375,2,65,4.96,101.65,652108,662846,10738,4246,5674,1428,1405529,1375,1375,1375,202,2,0,62583,149549,202,0
124700,013360,1380,2,70,5.34,101.65,652109,662850,10741,4247,5675,1428,1405534,1375,1380,1375,5,1,1,62383,149385,1,4
124700,013360,1380,2,70,5.34,101.65,652109,662862,10753,4247,5677,1430,1405546,1375,1380,1375,17,1,3,62423,149385,1,16
124800,013360,1380,2,70,5.34,101.65,652109,662862,10753,4247,5677,1430,1405546,1380,1380,1380,0,0,0,62423,149385,0,0
124800,013360,1375,2,65,4.96,101.64,652176,662862,10686,4248,5677,1429,1405613,1375,1375,1375,67,1,0,62411,149379,67,0
124900,013360,1375,2,65,4.96,101.64,652177,662865,10688,4249,5678,1429,1405617,1375,1375,1375,1,1,0,62341,148812,1,0
124900,013360,1375,2,65,4.96,101.64,652177,662865,10688,4249,5678,1429,1405617,1375,1375,1375,1,1,0,62341,148812,1,0
125000,013360,1375,2,65,4.96,101.64,652177,662865,10688,4249,5678,1429,1405617,1375,1375,1375,0,0,0,62341,148812,0,0
125000,013360,1370,2,60,4.58,101.15,655897,663434,7537,4254,5679,1425,1409906,1375,1380,1370,4289,5,1,60068,147037,3720,569
125100,013360,1370,2,60,4.58,101.15,655897,663434,7537,4254,5679,1425,1409906,1370,1370,1370,0,0,0,60068,147037,0,0
125100,013360,1370,2,60,4.58,101.15,655897,663434,7537,4254,5679,1425,1409906,1370,1370,1370,0,0,0,60068,147037,0,0
125200,013360,1375,2,65,4.96,101.15,655897,663437,7540,4254,5680,1426,1409909,1375,1375,1375,3,0,1,56286,168822,0,3
125200,013360,1370,2,60,4.58,101.15,655898,663437,7539,4255,5680,1425,1409910,1375,1375,1370,4,1,1,56283,168813,1,3
125300,013360,1375,2,65,4.96,101.3,655898,664437,8539,4255,5681,1426,1410910,1375,1375,1375,1000,0,1,56283,168825,0,1000
125400,013360,1375,2,65,4.96,101.3,655898,664443,8545,4255,5682,1427,1410916,1375,1375,1375,0,0,0,55283,168825,0,0
125400,013360,1370,2,60,4.58,101.3,655900,664447,8547,4256,5683,1427,1410922,1375,1375,1370,6,1,1,55355,168825,2,4
125500,013360,1370,2,60,4.58,101.3,655901,664447,8546,4257,5683,1426,1410923,1370,1370,1370,0,0,0,55355,168823,0,0
125500,013360,1370,2,60,4.58,101.3,655901,664447,8546,4257,5683,1426,1410923,1370,1370,1370,0,0,0,55355,168823,0,0
125600,013360,1375,2,65,4.96,101.3,655901,664450,8549,4257,5684,1427,1410926,1375,1375,1375,0,0,0,55355,169520,0,0
125600,013360,1370,2,60,4.58,101.18,656701,664450,7749,4258,5684,1426,1411726,1370,1370,1370,800,1,0,55352,168863,800,0
125700,013360,1370,2,60,4.58,101.18,656703,664450,7747,4260,5684,1424,1411728,1370,1370,1370,1,1,0,56157,168062,1,0
125700,013360,1375,2,65,4.96,101.24,656703,664871,8168,4260,5686,1426,1412149,1370,1375,1370,422,1,2,55740,168061,1,421
125800,013360,1375,2,65,4.96,101.24,656703,664871,8168,4260,5686,1426,1412149,1375,1375,1375,0,0,0,55740,168061,0,0
125800,013360,1370,2,60,4.58,101.24,656705,664876,8171,4261,5687,1426,1412156,1375,1375,1370,7,1,1,55731,168261,2,5
125900,013360,1375,2,65,4.96,101.33,656706,665431,8725,4262,5689,1427,1412712,1375,1375,1375,0,0,0,55196,168288,0,0
125900,013360,1375,2,65,4.96,101.33,656706,665434,8728,4262,5690,1428,1412715,1375,1375,1375,3,0,1,55176,168288,0,3
130000,013360,1375,2,65,4.96,101.33,656706,665459,8753,4262,5692,1430,1412740,1375,1375,1375,2,0,1,55055,169095,0,2
130000,013360,1370,2,60,4.58,101.33,656707,665459,8752,4263,5692,1429,1412741,1375,1375,1370,3,1,1,55053,168095,1,2
130100,013360,1375,2,65,4.96,101.33,656707,665463,8756,4263,5693,1430,1412745,1375,1375,1375,4,0,1,55053,168100,0,4
130100,013360,1375,2,65,4.96,101.36,656707,665613,8906,4263,5694,1431,1412895,1375,1375,1375,154,0,2,55049,169263,0,154
130200,013360,1375,2,65,4.96,101.44,656710,666179,9469,4264,5697,1433,1413464,1375,1375,1375,369,1,2,56581,150805,3,366
130200,013360,1380,2,70,5.34,101.49,656711,666495,9784,4265,5699,1434,1413781,1375,1380,1375,686,2,4,56578,150808,4,682
130300,013360,1380,2,70,5.34,101.49,656711,666495,9784,4265,5699,1434,1413781,1380,1380,1380,0,0,0,56578,150808,0,0
130300,013360,1380,2,70,5.34,101.49,656711,666511,9800,4265,5702,1437,1413797,1380,1380,1380,16,0,3,56765,150808,0,16
130400,013360,1375,2,65,4.96,101.49,656725,666511,9786,4266,5702,1436,1413811,1375,1375,1375,14,1,0,56749,150983,14,0
130400,013360,1375,2,65,4.96,101.49,656726,666515,9789,4267,5703,1436,1413816,1375,1380,1375,19,2,1,56745,150983,15,4
130500,013360,1375,2,65,4.96,101.49,656726,666515,9789,4267,5703,1436,1413816,1375,1375,1375,0,0,0,56745,150983,0,0
130600,013360,1375,2,65,4.96,101.49,656726,666515,9789,4267,5703,1436,1413816,1375,1375,1375,0,0,0,57745,154611,0,0
130600,013360,1380,2,70,5.34,101.18,658728,666527,7799,4269,5708,1439,1415830,1380,1380,1375,2014,2,5,57984,145301,2002,12
130700,013360,1375,2,65,4.96,101.18,658729,666527,7798,4270,5708,1438,1415831,1375,1375,1375,0,0,0,57983,145238,0,0
130700,013360,1375,2,65,4.96,101.18,658731,666527,7796,4271,5708,1437,1415833,1375,1375,1375,2,1,0,57983,152461,2,0
130800,013360,1375,2,65,4.96,101.06,659627,666623,6996,4272,5714,1442,1416825,1375,1375,1375,61,0,2,55843,166499,0,61
130800,013360,1375,2,65,4.96,101.06,659628,666643,7015,4273,5717,1444,1416846,1375,1375,1370,82,1,5,55833,166498,1,81
130900,013360,1375,2,65,4.96,101.07,659628,666655,7027,4273,5719,1446,1416858,1375,1375,1375,0,0,0,55817,166492,0,0
130900,013360,1375,2,65,4.96,101.07,659628,666655,7027,4273,5719,1446,1416858,1375,1375,1375,0,0,0,55817,166492,0,0
131000,013360,1375,2,65,4.96,101.07,659628,666658,7030,4273,5720,1447,1416861,1375,1375,1375,0,0,0,55811,166799,0,0
131000,013360,1375,2,65,4.96,101.22,659631,667667,8036,4274,5723,1449,1417873,1370,1375,1370,1012,1,3,55801,166808,3,1009
131100,013360,1375,2,65,4.96,101.22,659631,667667,8036,4274,5723,1449,1417873,1375,1375,1375,0,0,0,55801,166808,0,0
131100,013360,1380,2,70,5.34,101.22,659631,667676,8045,4274,5725,1451,1417882,1380,1380,1380,9,0,2,57954,148187,0,9
131200,013360,1380,2,70,5.34,101.22,659631,667676,8045,4274,5725,1451,1417882,1380,1380,1380,0,0,0,57954,148187,0,0
131200,013360,1375,2,65,4.96,101.22,659632,667676,8044,4275,5725,1450,1417883,1375,1375,1375,1,1,0,57949,151459,1,0
131300,013360,1380,2,70,5.34,101.22,659632,667679,8047,4275,5726,1451,1417886,1380,1380,1380,3,0,1,58050,150472,0,3
131300,013360,1380,2,70,5.34,101.24,659632,667779,8147,4275,5727,1452,1417986,1380,1380,1380,103,0,2,58047,150472,0,103
131400,013360,1375,2,65,4.96,101.23,659635,667780,8145,4277,5728,1451,1417990,1380,1380,1375,4,2,1,58156,150476,3,1
131400,013360,1380,2,70,5.34,100.01,667714,667791,77,4280,5730,1450,1426080,1380,1380,1370,8094,5,3,61147,161318,8082,12
131500,013360,1375,2,65,4.96,100.11,667714,668472,758,4280,5732,1452,1426761,1375,1375,1375,677,0,1,60604,162318,0,677
131500,013360,1375,2,65,4.96,100.13,667714,668602,888,4280,5733,1453,1426891,1375,1375,1375,807,0,2,59927,162318,0,807
131600,013360,1375,2,65,4.96,100.07,668116,668602,486,4283,5733,1450,1427293,1375,1375,1375,402,3,0,61145,145871,402,0
131600,013360,1380,2,70,5.34,100.07,668116,668610,494,4283,5735,1452,1427301,1375,1380,1375,410,3,2,61642,145870,402,8
131700,013360,1380,2,70,5.34,100.07,668116,668610,494,4283,5735,1452,1427301,1380,1380,1380,0,0,0,61642,145870,0,0
131700,013360,1380,2,70,5.34,100.07,668116,668610,494,4283,5735,1452,1427301,1380,1380,1380,0,0,0,61642,145870,0,0
131800,013360,1380,2,70,5.34,100.07,668120,668614,494,4285,5736,1451,1427309,1375,1380,1375,8,2,1,62247,146966,4,4
131900,013360,1380,2,70,5.34,100.19,668120,669378,1258,4285,5737,1452,1428073,1380,1380,1380,0,0,0,62243,146966,0,0
131900,013360,1380,2,70,5.34,100.19,668120,669383,1263,4285,5738,1453,1428078,1380,1380,1380,5,0,1,63479,146973,0,5
132000,013360,1380,2,70,5.34,100.19,668134,669386,1252,4286,5739,1453,1428095,1380,1380,1380,3,0,1,63474,146959,0,3
132000,013360,1375,2,65,4.96,100.02,669235,669386,151,4288,5739,1451,1429196,1380,1380,1375,1104,2,1,63471,146958,1101,3
132100,013360,1380,2,70,5.34,100.02,669235,669387,152,4288,5740,1452,1429197,1380,1380,1380,0,0,0,56105,145858,0,0
132100,013360,1380,2,70,5.34,100.02,669235,669387,152,4288,5740,1452,1429197,1380,1380,1380,0,0,0,56105,145858,0,0
132200,013360,1375,2,65,4.96,100.02,669238,669391,153,4290,5741,1451,1429204,1375,1375,1375,3,2,0,56100,145857,3,0
132200,013360,1375,2,65,4.96,100.02,669238,669391,153,4290,5741,1451,1429204,1375,1375,1375,3,2,0,56100,145857,3,0
132300,013360,1375,2,65,4.96,99.91,670618,670022,-596,4291,5742,1451,1431215,1375,1375,1375,2011,1,1,57377,163411,1380,631
132300,013360,1375,2,65,4.96,99.91,670627,670025,-602,4292,5743,1451,1431227,1375,1375,1370,2023,2,2,56749,163402,1389,634
132400,013360,1370,2,60,4.58,99.91,670628,670025,-603,4293,5743,1450,1431228,1370,1370,1370,1,1,0,56356,163016,1,0
132400,013360,1375,2,65,4.96,99.93,670629,670164,-465,4294,5745,1451,1431368,1370,1375,1370,141,2,2,56222,163214,2,139
132500,013360,1375,2,65,4.96,99.93,670629,670168,-461,4294,5746,1452,1431372,1375,1375,1375,4,0,1,56217,167556,0,4
132600,013360,1370,2,60,4.58,100.08,670632,671180,548,4295,5747,1452,1432387,1370,1370,1370,0,0,0,56544,169651,0,0
132600,013360,1370,2,60,4.58,99.88,671974,671181,-793,4297,5748,1451,1433730,1375,1375,1370,1343,2,1,55202,170387,1342,1
132700,013360,1375,2,65,4.96,99.88,671975,671182,-793,4298,5749,1451,1433732,1375,1375,1375,1,0,1,55202,163903,0,1
132700,013360,1380,2,70,5.34,99.88,671975,671189,-786,4298,5751,1453,1433739,1375,1380,1375,8,0,3,56543,146426,0,8
132800,013360,1370,2,60,4.58,99.68,673321,671189,-2132,4300,5751,1451,1435085,1370,1370,1370,0,0,0,56315,163993,0,0
132800,013360,1375,2,65,4.96,99.68,673323,671191,-2132,4302,5753,1451,1435089,1370,1375,1370,4,2,2,56314,163990,2,2
132900,013360,1375,2,65,4.96,99.71,673325,671344,-1981,4304,5756,1452,1435244,1375,1375,1375,141,1,1,57503,146923,1,140
132900,013360,1380,2,70,5.34,99.71,673331,671346,-1985,4305,5757,1452,1435252,1375,1380,1375,149,2,2,57497,147758,7,142
133000,013360,1375,2,65,4.96,99.7,673340,671353,-1987,4310,5759,1449,1435268,1380,1380,1375,8,1,2,57488,147750,1,7
133000,013360,1375,2,65,4.96,99.84,673342,672298,-1044,4312,5761,1449,1436215,1380,1380,1375,955,3,4,56543,147009,3,952
133100,013360,1380,2,70,5.34,99.85,673342,672299,-1043,4312,5762,1450,1436216,1380,1380,1380,0,0,0,56548,147008,0,0
133100,013360,1375,2,65,4.96,99.47,675901,672300,-3601,4315,5763,1448,1438776,1375,1380,1375,2560,3,1,56654,147743,2559,1
133200,013360,1375,2,65,4.96,99.47,675904,672304,-3600,4318,5764,1446,1438783,1375,1380,1375,7,3,1,56650,145091,3,4
133200,013360,1375,2,65,4.96,99.47,675904,672304,-3600,4318,5764,1446,1438783,1375,1380,1375,7,3,1,56650,145091,3,4
133300,013360,1375,2,65,4.96,99.45,676087,672369,-3718,4320,5765,1445,1439031,1375,1375,1375,248,2,1,55324,163769,183,65
133300,013360,1370,2,60,4.58,99.45,676092,672372,-3720,4324,5766,1442,1439039,1375,1375,1370,256,6,2,55321,163765,188,68
133400,013360,1370,2,60,4.58,99.33,676893,672372,-4521,4327,5766,1439,1439840,1370,1375,1370,801,3,0,56650,146298,801,0
133500,013360,1375,2,65,4.96,99.33,676904,672372,-4532,4329,5766,1437,1439851,1375,1375,1375,10,1,0,56640,145522,10,0
133500,013360,1370,2,60,4.58,99.33,676905,672372,-4533,4330,5766,1436,1439852,1375,1375,1370,11,2,0,56640,164441,11,0
133600,013360,1375,2,65,4.96,99.77,676908,675377,-1531,4333,5769,1436,1442860,1375,1375,1375,0,0,0,53635,146571,0,0
133600,013360,1375,2,65,4.96,99.77,676912,675377,-1535,4335,5769,1434,1442864,1375,1375,1375,4,2,0,53635,146869,4,0
133700,013360,1375,2,65,4.96,99.77,676913,675377,-1536,4336,5769,1433,1442865,1375,1375,1375,0,0,0,53985,147401,0,0
133700,013360,1375,2,65,4.96,99.77,676914,675380,-1534,4337,5770,1433,1442869,1380,1380,1375,4,1,1,53982,147399,1,3
133800,013360,1375,2,65,4.96,99.77,676920,675380,-1540,4341,5770,1429,1442875,1375,1375,1375,0,0,0,53982,147393,0,0
133800,013360,1375,2,65,4.96,99.83,676950,675807,-1143,4343,5771,1428,1443332,1380,1380,1375,457,2,1,61054,147384,30,427
133900,013360,1375,2,65,4.96,99.83,676950,675807,-1143,4343,5771,1428,1443332,1375,1375,1375,0,0,0,61054,147384,0,0
133900,013360,1380,2,70,5.34,99.83,676962,675807,-1155,4348,5771,1423,1443344,1380,1380,1375,12,5,0,61054,142270,12,0
134000,013360,1375,2,65,4.96,99.68,677989,675807,-2182,4351,5771,1420,1444371,1375,1375,1375,727,2,0,53556,150810,727,0
134000,013360,1380,2,70,5.34,99.75,677989,676291,-1698,4351,5773,1422,1444855,1375,1380,1375,1211,2,2,53576,169031,727,484
134100,013360,1375,2,65,4.96,99.75,677991,676310,-1681,4353,5775,1422,1444876,1375,1380,1375,15,2,1,61055,150116,2,13
134100,013360,1370,2,60,4.58,99.75,677994,676311,-1683,4355,5776,1421,1444880,1375,1385,1370,19,4,2,53556,168736,5,14
134200,013360,1380,2,70,5.34,99.75,677995,676312,-1683,4356,5777,1421,1444882,1380,1380,1380,1,0,1,55586,168740,0,1
134200,013360,1375,2,65,4.96,99.75,678000,676312,-1688,4358,5777,1419,1444887,1380,1380,1370,6,2,1,55585,149821,5,1
134300,013360,1370,2,60,4.58,99.88,678001,677166,-835,4359,5778,1419,1445742,1370,1370,1370,0,0,0,54731,168739,0,0
134300,013360,1375,2,65,4.96,99.88,678004,677166,-838,4362,5778,1416,1445745,1375,1375,1375,3,3,0,54731,149822,3,0
134400,013360,1375,2,65,4.96,99.88,678005,677166,-839,4363,5778,1415,1445746,1375,1375,1375,1,1,0,54731,149828,1,0
134400,013360,1375,2,65,4.96,99.87,678054,677169,-885,4365,5779,1414,1445798,1375,1380,1375,53,3,1,55304,149826,50,3
134500,013360,1375,2,65,4.96,99.87,678056,677169,-887,4367,5779,1412,1445800,1375,1375,1375,2,2,0,55304,149783,2,0
134500,013360,1375,2,65,4.96,99.87,678060,677169,-891,4369,5779,1410,1445804,1375,1375,1375,6,4,0,55304,149781,6,0
134600,013360,1380,2,70,5.34,99.88,678060,677245,-815,4369,5781,1412,1445880,1380,1380,1380,76,0,2,55300,149883,0,76
134600,013360,1375,2,65,4.96,99.88,678062,677245,-817,4371,5781,1410,1445882,1380,1380,1375,78,2,2,55228,136882,2,76
134700,013360,1380,2,70,5.34,100.0,678064,678049,-15,4373,5783,1410,1446688,1375,1380,1375,805,2,1,55227,150195,2,803
134700,013360,1385,2,75,5.73,100.04,678065,678345,280,4374,5785,1411,1446985,1375,1385,1375,1102,3,3,61630,142947,3,1099
134800,013360,1375,2,65,4.96,100.04,678075,678345,270,4377,5785,1408,1446995,1380,1380,1375,10,3,0,54490,151811,10,0
134900,013360,1375,2,65,4.96,100.04,678075,678345,270,4377,5785,1408,1446995,1375,1375,1375,0,0,0,54490,151811,0,0
134900,013360,1375,2,65,4.96,100.04,678082,678345,263,4381,5785,1404,1447002,1375,1375,1375,7,4,0,54490,152454,7,0
135000,013360,1375,2,65,4.96,99.98,678486,678349,-137,4385,5786,1401,1447410,1375,1375,1375,1,1,0,54481,147221,1,0
135000,013360,1375,2,65,4.96,99.98,678486,678349,-137,4385,5786,1401,1447410,1375,1375,1375,1,1,0,54481,147221,1,0
135100,013360,1380,2,70,5.34,100.11,678488,679212,724,4387,5787,1400,1448275,1380,1380,1380,1,1,0,61622,141652,1,0
135100,013360,1380,2,70,5.34,100.11,678490,679220,730,4389,5789,1400,1448285,1380,1385,1380,11,3,2,61614,141656,3,8
135200,013360,1380,2,70,5.34,100.25,678491,680181,1690,4390,5790,1400,1449247,1380,1380,1380,0,0,0,63263,140531,0,0
135200,013360,1380,2,70,5.34,100.25,678492,680181,1689,4391,5790,1399,1449248,1380,1380,1380,1,1,0,63263,122198,1,0
135300,013360,1380,2,70,5.34,100.16,679080,680186,1106,4395,5792,1397,1449841,1385,1385,1380,6,1,2,72682,142512,1,5
135300,013360,1380,2,70,5.34,99.9,680885,680186,-699,4399,5792,1393,1451646,1385,1385,1380,1811,5,2,72682,140793,1806,5
135400,013360,1380,2,70,5.34,99.9,680886,680187,-699,4400,5793,1393,1451648,1380,1380,1380,0,0,0,72681,140942,0,0
135400,013360,1380,2,70,5.34,99.78,681690,680187,-1503,4401,5793,1392,1452452,1380,1380,1380,804,1,0,62958,141108,804,0
135500,013360,1375,2,65,4.96,99.7,682257,680190,-2067,4405,5794,1389,1453022,1375,1375,1375,1,1,0,56497,148211,1,0
135500,013360,1375,2,65,4.96,99.69,682281,680191,-2090,4410,5795,1385,1453047,1375,1380,1375,26,6,1,56508,148404,25,1
135600,013360,1375,2,65,4.96,99.69,682281,680191,-2090,4410,5795,1385,1453047,1375,1375,1375,0,0,0,56508,148404,0,0
135600,013360,1380,2,70,5.34,99.69,682282,680200,-2082,4411,5797,1386,1453057,1375,1380,1375,10,1,2,56515,148295,1,9
135700,013360,1375,2,65,4.96,99.69,682286,680201,-2085,4415,5798,1383,1453062,1375,1380,1375,3,2,1,56529,148292,2,1
135700,013360,1375,2,65,4.96,99.69,682288,680201,-2087,4416,5798,1382,1453064,1375,1380,1375,5,3,1,56529,148291,4,1
135800,013360,1380,2,70,5.34,99.69,682289,680204,-2085,4417,5799,1382,1453068,1375,1380,1375,4,1,1,56529,148842,1,3
135800,013360,1375,2,65,4.96,99.69,682291,680204,-2087,4419,5799,1380,1453070,1375,1380,1375,6,3,1,56526,128413,3,3
135900,013360,1375,2,65,4.96,99.69,682293,680204,-2089,4421,5799,1378,1453072,1375,1375,1375,0,0,0,56526,128411,0,0
135900,013360,1375,2,65,4.96,99.69,682294,680204,-2090,4422,5799,1377,1453073,1375,1375,1375,1,1,0,57026,128415,1,0
140000,013360,1380,2,70,5.34,99.69,682299,680208,-2091,4423,5800,1377,1453082,1375,1380,1375,9,1,1,57026,128414,5,4
140000,013360,1375,2,65,4.96,99.69,682303,680208,-2095,4427,5800,1373,1453086,1375,1380,1375,13,5,1,57047,128376,9,4
140100,013360,1375,2,65,4.96,99.69,682307,680208,-2099,4429,5800,1371,1453090,1375,1375,1375,4,2,0,57623,128380,4,0
140100,013360,1375,2,65,4.96,99.69,682311,680211,-2100,4430,5801,1371,1453097,1375,1380,1375,11,3,1,57624,128333,8,3
140200,013360,1370,2,60,4.58,99.63,682737,680211,-2526,4433,5801,1368,1453523,1375,1375,1370,426,3,0,56368,148337,426,0
140300,013360,1370,2,60,4.58,99.63,682741,680212,-2529,4437,5802,1365,1453528,1370,1370,1370,0,0,0,56367,148333,0,0
140300,013360,1375,2,65,4.96,99.63,682745,680216,-2529,4438,5803,1365,1453536,1370,1375,1370,8,1,1,56467,150291,4,4
140400,013360,1370,2,60,4.58,99.63,682746,680216,-2530,4439,5803,1364,1453537,1370,1370,1370,0,0,0,56463,150241,0,0
140400,013360,1370,2,60,4.58,99.63,682748,680216,-2532,4441,5803,1362,1453539,1370,1370,1370,2,2,0,56363,150869,2,0
140500,013360,1370,2,60,4.58,99.63,682750,680216,-2534,4443,5803,1360,1453541,1370,1370,1370,0,0,0,56363,150882,0,0
140500,013360,1370,2,60,4.58,99.63,682751,680219,-2532,4444,5804,1360,1453545,1375,1375,1370,4,1,1,56360,150881,1,3
140600,013360,1370,2,60,4.58,99.63,682754,680219,-2535,4446,5804,1358,1453548,1370,1370,1370,2,1,0,57637,151079,2,0
140600,013360,1370,2,60,4.58,99.63,682756,680219,-2537,4448,5804,1356,1453550,1370,1370,1370,4,3,0,57637,151076,4,0
140700,013360,1370,2,60,4.58,99.61,682894,680223,-2671,4452,5805,1353,1453692,1370,1370,1370,2,1,0,57633,150939,2,0
140700,013360,1370,2,60,4.58,99.61,682894,680223,-2671,4452,5805,1353,1453692,1370,1370,1370,2,1,0,57633,150939,2,0
140800,013360,1370,2,60,4.58,99.61,682900,680223,-2677,4456,5805,1349,1453698,1370,1370,1370,4,2,0,57633,148762,4,0
140800,013360,1370,2,60,4.58,99.61,682901,680223,-2678,4457,5805,1348,1453699,1370,1370,1370,5,3,0,57633,148804,5,0
140900,013360,1375,2,65,4.96,99.61,682901,680227,-2674,4457,5807,1350,1453703,1375,1375,1375,0,0,0,57630,148803,0,0
140900,013360,1370,2,60,4.58,99.61,682903,680227,-2676,4459,5807,1348,1453705,1370,1370,1370,2,2,0,57729,148803,2,0
141000,013360,1370,2,60,4.58,99.61,682905,680227,-2678,4461,5807,1346,1453707,1370,1370,1370,2,2,0,57729,148805,2,0
141000,013360,1375,2,65,4.96,99.61,682906,680241,-2665,4462,5809,1347,1453722,1370,1375,1370,17,3,2,57725,148803,3,14
141100,013360,1370,2,60,4.58,99.61,682908,680241,-2667,4464,5809,1345,1453724,1370,1370,1370,2,2,0,57715,148808,2,0
141100,013360,1370,2,60,4.58,99.61,682909,680252,-2657,4465,5810,1345,1453736,1370,1375,1370,14,3,1,57704,148807,3,11
141200,013360,1375,2,65,4.96,99.61,682910,680255,-2655,4466,5811,1345,1453740,1370,1375,1370,4,1,1,57704,149236,1,3
141200,013360,1370,2,60,4.58,99.61,682912,680255,-2657,4468,5811,1343,1453742,1370,1375,1370,6,3,1,58133,149240,3,3
141300,013360,1370,2,60,4.58,99.61,682914,680255,-2659,4470,5811,1341,1453744,1370,1370,1370,2,2,0,58133,149238,2,0
141300,013360,1375,2,65,4.96,99.61,682914,680259,-2655,4470,5812,1342,1453748,1370,1375,1370,6,2,1,58133,151237,2,4
141400,013360,1370,2,60,4.58,99.68,682916,680759,-2157,4472,5813,1341,1454250,1375,1375,1370,501,1,1,57629,151243,1,500
141400,013360,1370,2,60,4.58,99.54,683922,680759,-3163,4476,5813,1337,1455256,1375,1375,1370,1507,5,1,57629,150230,1007,500
141500,013360,1370,2,60,4.58,99.54,683923,680759,-3164,4477,5813,1336,1455257,1370,1370,1370,0,0,0,57990,150229,0,0
141500,013360,1370,2,60,4.58,99.54,683924,680762,-3162,4478,5814,1336,1455261,1375,1375,1370,4,1,1,58351,150234,1,3
141600,013360,1370,2,60,4.58,99.54,683926,680762,-3164,4480,5814,1334,1455263,1370,1370,1370,1,1,0,58351,150232,1,0
141700,013360,1370,2,60,4.58,99.54,683928,680762,-3166,4482,5814,1332,1455265,1370,1370,1370,0,0,0,58351,150230,0,0
141700,013360,1375,2,65,4.96,99.39,684928,680767,-4161,4483,5816,1333,1456270,1375,1375,1370,1005,1,2,57750,149229,1000,5
141800,013360,1370,2,60,4.58,99.39,684930,680767,-4163,4485,5816,1331,1456272,1370,1370,1370,0,0,0,57746,149235,0,0
141800,013360,1375,2,65,4.96,99.38,685033,680768,-4265,4489,5817,1328,1456376,1370,1375,1370,104,4,1,57747,148836,103,1
141900,013360,1375,2,65,4.96,99.38,685033,680771,-4262,4489,5818,1329,1456379,1375,1375,1375,3,0,1,57746,148836,0,3
141900,013360,1370,2,60,4.58,99.38,685035,680771,-4264,4491,5818,1327,1456381,1375,1375,1370,5,2,1,57743,148835,2,3
142000,013360,1370,2,60,4.58,99.38,685037,680771,-4266,4493,5818,1325,1456383,1370,1370,1370,1,1,0,58743,148833,1,0
142000,013360,1370,2,60,4.58,99.67,685038,682771,-2267,4494,5819,1325,1458384,1370,1375,1370,2002,2,1,56743,149232,2,2000
142100,013360,1370,2,60,4.58,99.67,685043,682775,-2268,4496,5820,1324,1458393,1370,1370,1370,0,0,0,57739,149169,0,0
142100,013360,1370,2,60,4.58,99.67,685045,682775,-2270,4498,5820,1322,1458395,1370,1370,1370,2,2,0,57739,149164,2,0
142200,013360,1370,2,60,4.58,99.67,685047,682777,-2270,4500,5821,1321,1458399,1375,1375,1370,3,1,1,57737,147388,1,2
142200,013360,1375,2,65,4.96,99.68,685048,682831,-2217,4501,5833,1332,1458454,1375,1375,1370,58,2,13,58188,147349,2,56
142300,013360,1370,2,60,4.58,99.68,685049,682831,-2218,4502,5833,1331,1458455,1370,1370,1370,1,1,0,58183,142969,1,0
142300,013360,1370,2,60,4.58,99.68,685051,682831,-2220,4504,5833,1329,1458457,1370,1370,1370,3,3,0,58183,142973,3,0
142400,013360,1370,2,60,4.58,99.68,685054,682831,-2223,4507,5833,1326,1458460,1370,1370,1370,3,3,0,58183,142976,3,0
142400,013360,1370,2,60,4.58,99.68,685055,682835,-2220,4508,5834,1326,1458465,1370,1375,1370,8,4,1,58179,142975,4,4
142500,013360,1370,2,60,4.58,99.67,685098,682865,-2233,4510,5835,1325,1458538,1375,1375,1370,43,2,0,59477,122052,43,0
142500,013360,1370,2,60,4.58,99.67,685100,682867,-2233,4512,5837,1325,1458542,1375,1380,1370,47,4,2,58648,142934,45,2
142600,013360,1370,2,60,4.58,99.67,685107,682870,-2237,4515,5838,1323,1458552,1370,1375,1370,10,3,1,58650,142932,7,3
142600,013360,1370,2,60,4.58,99.67,685107,682870,-2237,4515,5838,1323,1458552,1370,1375,1370,10,3,1,58650,142932,7,3
142700,013360,1370,2,60,4.58,99.67,685110,682873,-2237,4518,5841,1323,1458558,1370,1375,1370,6,3,3,58647,144736,3,3
142700,013360,1375,2,65,4.96,99.67,685110,682879,-2231,4518,5843,1325,1458564,1370,1375,1370,12,3,5,58645,145035,3,9
142800,013360,1375,2,65,4.96,99.82,685113,683872,-1241,4520,5845,1325,1459560,1370,1375,1370,994,1,2,58641,145232,1,993
142800,013360,1375,2,65,4.96,99.82,685114,683872,-1242,4521,5845,1324,1459561,1370,1375,1370,995,2,2,58976,124112,2,993
142900,013360,1375,2,65,4.96,99.82,685117,683872,-1245,4524,5845,1321,1459564,1375,1375,1375,3,3,0,58976,123240,3,0
142900,013360,1375,2,65,4.96,99.82,685119,683875,-1244,4526,5846,1320,1459569,1375,1380,1375,8,5,1,58973,123248,5,3
143000,013360,1375,2,65,4.96,99.82,685119,683875,-1244,4526,5846,1320,1459569,1375,1375,1375,0,0,0,58973,123248,0,0
143100,013360,1375,2,65,4.96,99.82,685119,683875,-1244,4526,5846,1320,1459569,1375,1375,1375,0,0,0,58973,122247,0,0
143100,013360,1375,2,65,4.96,99.68,686044,683879,-2165,4529,5847,1318,1460498,1375,1380,1375,929,3,1,58972,123103,925,4
143200,013360,1370,2,60,4.58,99.69,686045,683884,-2161,4530,5848,1318,1460504,1370,1370,1370,0,0,0,56716,143101,0,0
143200,013360,1375,2,65,4.96,99.56,686988,683956,-3032,4531,5849,1318,1461519,1375,1375,1375,1015,1,1,57972,123117,943,72
143300,013360,1375,2,65,4.96,99.58,686988,684113,-2875,4531,5850,1319,1461676,1375,1375,1375,0,0,0,56801,143125,0,0
143300,013360,1380,2,70,5.34,99.58,686988,684114,-2874,4531,5851,1320,1461677,1380,1380,1380,1,0,1,57972,122306,0,1
143400,013360,1375,2,65,4.96,99.58,686989,684128,-2861,4532,5853,1321,1461692,1375,1375,1375,0,0,0,57957,122312,0,0
143400,013360,1375,2,65,4.96,99.58,686989,684128,-2861,4532,5853,1321,1461692,1375,1375,1375,0,0,0,57957,122312,0,0
143500,013360,1380,2,70,5.34,99.58,686989,684133,-2856,4532,5855,1323,1461697,1380,1380,1380,0,0,0,57953,119376,0,0
143500,013360,1380,2,70,5.34,99.58,686989,684133,-2856,4532,5855,1323,1461697,1380,1380,1380,0,0,0,57953,119376,0,0
143600,013360,1375,2,65,4.96,99.58,687038,684133,-2905,4534,5855,1321,1461746,1375,1375,1375,48,1,0,57952,118246,48,0
143600,013360,1380,2,70,5.34,99.58,687038,684186,-2852,4534,5858,1324,1461799,1375,1380,1375,101,1,3,58396,118334,48,53
143700,013360,1380,2,70,5.34,99.58,687038,684186,-2852,4534,5858,1324,1461799,1380,1380,1380,0,0,0,58396,118334,0,0
143700,013360,1375,2,65,4.96,99.58,687039,684186,-2853,4535,5858,1323,1461800,1375,1375,1375,1,1,0,58398,118641,1,0
143800,013360,1380,2,70,5.34,99.59,687039,684190,-2849,4535,5859,1324,1461804,1380,1380,1380,4,0,1,58422,118640,0,4
143800,013360,1380,2,70,5.34,99.59,687039,684190,-2849,4535,5859,1324,1461804,1380,1380,1380,4,0,1,58422,118640,0,4
143900,013360,1380,2,70,5.34,99.59,687039,684206,-2833,4535,5861,1326,1461820,1380,1380,1380,5,0,1,58107,118692,0,5
143900,013360,1375,2,65,4.96,99.59,687040,684207,-2833,4536,5862,1326,1461822,1380,1380,1375,7,1,2,68101,118692,1,6
144000,013360,1380,2,70,5.34,99.59,687040,684210,-2830,4536,5863,1327,1461825,1380,1380,1380,0,0,0,68101,118691,0,0
144000,013360,1380,2,70,5.34,99.59,687040,684210,-2830,4536,5863,1327,1461825,1380,1380,1380,0,0,0,68101,118691,0,0
144100,013360,1375,2,65,4.96,99.57,687143,684210,-2933,4538,5863,1325,1461928,1375,1375,1375,103,2,0,68099,118638,103,0
144100,013360,1375,2,65,4.96,99.57,687167,684220,-2947,4540,5865,1325,1461962,1375,1380,1375,137,4,2,68090,119634,127,10
144200,013360,1370,2,60,4.58,99.5,687644,684220,-3424,4541,5865,1324,1462439,1370,1370,1370,0,0,0,67339,141537,0,0
144200,013360,1370,2,60,4.58,99.5,687654,684220,-3434,4542,5865,1323,1462449,1370,1370,1370,10,1,0,68090,140960,10,0
144300,013360,1370,2,60,4.58,99.5,687654,684220,-3434,4542,5865,1323,1462449,1370,1370,1370,0,0,0,68090,140960,0,0
144400,013360,1375,2,65,4.96,99.5,687655,684220,-3435,4543,5865,1322,1462450,1375,1375,1375,0,0,0,68090,120034,0,0
144400,013360,1375,2,65,4.96,99.5,687655,684220,-3435,4543,5865,1322,1462450,1375,1375,1375,0,0,0,68090,120034,0,0
144500,013360,1375,2,65,4.96,99.5,687655,684220,-3435,4543,5865,1322,1462450,1375,1375,1375,0,0,0,68090,120238,0,0
144500,013360,1375,2,65,4.96,99.5,687656,684224,-3432,4544,5866,1322,1462455,1380,1380,1375,5,1,1,68574,125107,1,4
144600,013360,1375,2,65,4.96,99.5,687656,684224,-3432,4544,5866,1322,1462455,1375,1375,1375,0,0,0,68574,125107,0,0
144600,013360,1380,2,70,5.34,99.51,687730,684330,-3400,4545,5868,1323,1462635,1380,1380,1375,180,1,2,68573,125148,74,106
144700,013360,1380,2,70,5.34,99.51,687730,684334,-3396,4545,5869,1324,1462639,1380,1380,1380,0,0,0,68468,125154,0,0
144700,013360,1380,2,70,5.34,99.52,687731,684419,-3312,4546,5871,1325,1462725,1380,1380,1375,86,1,2,68459,125153,1,85
144800,013360,1380,2,70,5.34,99.52,687731,684419,-3312,4546,5871,1325,1462725,1380,1380,1380,0,0,0,68459,125153,0,0
144800,013360,1380,2,70,5.34,99.52,687731,684424,-3307,4546,5873,1327,1462730,1380,1380,1380,5,0,2,68481,122316,0,5
144900,013360,1375,2,65,4.96,99.26,690382,685273,-5109,4547,5874,1327,1466230,1375,1375,1375,0,0,0,68098,140591,0,0
144900,013360,1375,2,65,4.96,99.26,690382,685274,-5108,4547,5875,1328,1466231,1375,1375,1375,1,0,1,67250,140591,0,1
145000,013360,1375,2,65,4.96,99.2,690834,685274,-5560,4549,5875,1326,1466683,1375,1375,1375,390,1,0,68477,122216,390,0
145000,013360,1380,2,70,5.34,99.2,690834,685278,-5556,4549,5876,1327,1466687,1375,1380,1375,394,1,1,68477,119509,390,4
145100,013360,1375,2,65,4.96,99.2,690835,685278,-5557,4550,5876,1326,1466688,1375,1375,1375,1,1,0,68473,119141,1,0
145100,013360,1375,2,65,4.96,100.09,690836,691486,650,4551,5879,1328,1472897,1375,1380,1375,6210,2,3,62265,119140,2,6208
145200,013360,1380,2,70,5.34,100.09,690836,691490,654,4551,5880,1329,1472901,1380,1380,1380,4,0,1,62265,119139,0,4
145200,013360,1380,2,70,5.34,100.04,691244,691490,246,4553,5880,1327,1473309,1380,1380,1380,412,2,1,67666,112321,408,4
145300,013360,1380,2,70,5.34,100.04,691244,691490,246,4553,5880,1327,1473309,1380,1380,1380,0,0,0,67666,112321,0,0
145300,013360,1385,2,75,5.73,100.04,691244,691493,249,4553,5882,1329,1473312,1380,1385,1380,3,0,2,62762,118741,0,3
145400,013360,1380,2,70,5.34,100.04,691248,691493,245,4554,5882,1328,1473316,1380,1380,1380,0,0,0,67664,111974,0,0
145400,013360,1380,2,70,5.34,100.04,691248,691493,245,4554,5882,1328,1473316,1380,1380,1380,0,0,0,67664,111974,0,0
145500,013360,1375,2,65,4.96,100.04,691249,691499,250,4555,5883,1328,1473323,1380,1380,1375,7,1,1,64254,118753,1,6
145600,013360,1380,2,70,5.34,100.05,691249,691611,362,4555,5885,1330,1473435,1380,1380,1380,0,0,0,65370,118952,0,0
145600,013360,1380,2,70,5.34,100.05,691249,691611,362,4555,5885,1330,1473435,1380,1380,1380,0,0,0,65370,118952,0,0
145700,013360,1380,2,70,5.34,100.05,691249,691611,362,4555,5885,1330,1473435,1380,1380,1380,0,0,0,64810,119013,0,0
145700,013360,1380,2,70,5.34,100.05,691250,691615,365,4556,5886,1330,1473440,1375,1380,1375,5,1,1,64811,119079,1,4
145800,013360,1380,2,70,5.34,100.05,691250,691622,372,4556,5888,1332,1473447,1380,1380,1380,0,0,0,64885,119077,0,0
145800,013360,1375,2,65,4.96,100.04,691322,691622,300,4557,5888,1331,1473519,1375,1375,1375,72,1,0,64880,118238,72,0
145900,013360,1380,2,70,5.34,100.04,691323,691627,304,4558,5890,1332,1473525,1375,1380,1375,6,1,2,64880,118245,1,5
145900,013360,1380,2,70,5.34,100.34,691323,693663,2340,4558,5893,1335,1475561,1375,1380,1375,2042,1,5,62875,118251,1,2041
150000,013360,1385,2,75,5.73,100.34,691323,693664,2341,4558,5894,1336,1475562,1385,1385,1385,0,0,0,67744,112927,0,0
150000,013360,1385,2,75,5.73,100.35,691323,693777,2454,4558,5898,1340,1475675,1385,1385,1385,113,0,4,67729,112388,0,113
150100,013360,1380,2,70,5.34,100.35,691324,693777,2453,4559,5898,1339,1475676,1380,1380,1380,1,1,0,67725,112388,1,0
150100,013360,1385,2,75,5.73,100.35,691324,693778,2454,4559,5899,1340,1475677,1380,1385,1380,2,1,1,67725,113148,1,1
150200,013360,1380,2,70,5.34,100.24,692146,693778,1632,4561,5899,1338,1476499,1380,1380,1380,0,0,0,67724,112973,0,0
150200,013360,1380,2,70,5.34,100.24,692150,693778,1628,4562,5899,1337,1476503,1380,1380,1380,4,1,0,68224,111543,4,0
150300,013360,1380,2,70,5.34,100.35,692176,694611,2435,4563,5902,1339,1477362,1380,1380,1380,559,0,2,63346,118317,0,559
150300,013360,1380,2,70,5.34,100.35,692176,694611,2435,4563,5902,1339,1477362,1380,1380,1380,559,0,2,63346,118317,0,559
150400,013360,1380,2,70,5.34,100.35,692176,694625,2449,4563,5904,1341,1477376,1380,1380,1380,14,0,2,63723,119418,0,14
150400,013360,1380,2,70,5.34,100.35,692176,694625,2449,4563,5904,1341,1477376,1380,1380,1380,14,0,2,63723,119418,0,14
150500,013360,1375,2,65,4.96,100.14,693669,694625,956,4565,5904,1339,1478869,1375,1375,1375,1343,1,0,63929,119564,1343,0
150500,013360,1375,2,65,4.96,100.14,693671,694625,954,4566,5904,1338,1478871,1375,1375,1375,1345,2,0,63929,118527,1345,0
150600,013360,1380,2,70,5.34,100.14,693671,694629,958,4566,5905,1339,1478875,1380,1380,1380,4,0,1,63929,118530,0,4
150600,013360,1380,2,70,5.34,100.14,693671,694629,958,4566,5905,1339,1478875,1380,1380,1380,4,0,1,63929,118530,0,4
150700,013360,1380,2,70,5.34,100.14,693671,694629,958,4566,5905,1339,1478875,1380,1380,1380,0,0,0,63929,118530,0,0
150700,013360,1380,2,70,5.34,100.14,693671,694633,962,4566,5906,1340,1478879,1380,1380,1380,4,0,1,64377,118558,0,4
150800,013360,1380,2,70,5.34,100.04,694362,694641,279,4567,5908,1341,1479578,1375,1380,1375,699,1,2,64371,118444,691,8
150900,013360,1380,2,70,5.34,100.04,694362,694641,279,4567,5908,1341,1479578,1380,1380,1380,0,0,0,64371,118444,0,0
150900,013360,1380,2,70,5.34,100.18,694362,695645,1283,4567,5910,1343,1480582,1380,1380,1380,1004,0,2,62918,134843,0,1004
151000,013360,1385,2,75,5.73,100.25,694638,696406,1768,4568,5912,1344,1481619,1385,1385,1385,0,0,0,67547,135150,0,0
151000,013360,1385,2,75,5.73,100.31,694658,696829,2171,4569,5914,1345,1482062,1380,1385,1380,443,1,2,66345,134859,20,423
151100,013360,1385,2,75,5.73,100.31,694699,696833,2134,4571,5915,1344,1482107,1385,1385,1385,4,0,1,66295,135093,0,4
151100,013360,1385,2,75,5.73,100.31,694699,696833,2134,4571,5915,1344,1482107,1385,1385,1385,4,0,1,66295,135093,0,4
151200,013360,1385,2,75,5.73,100.31,694699,696833,2134,4571,5915,1344,1482107,1385,1385,1385,0,0,0,66295,135093,0,0
151200,013360,1385,2,75,5.73,100.31,694699,696833,2134,4571,5915,1344,1482107,1385,1385,1385,0,0,0,67061,137906,0,0
151300,013360,1385,2,75,5.73,100.31,694699,696837,2138,4571,5916,1345,1482111,1385,1385,1385,0,0,0,67072,139524,0,0
151300,013360,1385,2,75,5.73,100.31,694699,696842,2143,4571,5917,1346,1482116,1385,1385,1385,5,0,1,67063,138524,0,5
151400,013360,1385,2,75,5.73,100.31,694699,696842,2143,4571,5917,1346,1482116,1385,1385,1385,0,0,0,67063,138524,0,0
151400,013360,1385,2,75,5.73,100.31,694699,696866,2167,4571,5919,1348,1482140,1385,1385,1385,24,0,2,67189,138524,0,24
151500,013360,1380,2,70,5.34,100.12,696200,697065,865,4572,5920,1348,1483840,1380,1380,1380,1700,1,1,67695,145854,1501,199
151500,013360,1375,2,65,4.96,99.83,698265,697065,-1200,4575,5920,1345,1485905,1380,1380,1375,3765,4,1,71584,145596,3566,199
151600,013360,1370,2,60,4.58,99.38,701423,697065,-4358,4580,5920,1340,1489063,1375,1375,1370,2958,4,0,73573,162154,2958,0
151600,013360,1375,2,65,4.96,99.48,701423,697778,-3645,4580,5924,1344,1489776,1375,1375,1370,3671,4,4,74332,165119,2958,713
151700,013360,1370,2,60,4.58,99.65,701424,698978,-2446,4581,5926,1345,1490977,1375,1375,1370,1201,1,2,73061,165399,1,1200
151800,013360,1370,2,60,4.58,99.65,701424,698978,-2446,4581,5926,1345,1490977,1370,1370,1370,0,0,0,73061,165399,0,0
151800,013360,1370,2,60,4.58,98.95,706424,698987,-7437,4582,5928,1346,1495986,1375,1375,1370,5009,1,2,66025,166563,5000,9
151900,013360,1375,2,65,4.96,98.99,706424,699324,-7100,4582,5931,1349,1496323,1375,1375,1375,106,0,2,65788,161563,0,106
151900,013360,1375,2,65,4.96,99.0,706424,699332,-7092,4582,5933,1351,1496331,1375,1375,1375,114,0,4,65683,162573,0,114
152000,013360,1375,2,65,4.96,99.62,706424,703742,-2682,4582,5937,1355,1500741,1375,1375,1375,0,0,0,65217,162573,0,0
152000,013360,1380,2,70,5.34,99.64,706424,703908,-2516,4582,5938,1356,1500907,1380,1380,1380,166,0,1,62788,140821,0,166
152000,013360,1380,2,70,5.34,99.64,706424,703909,-2515,4582,5939,1357,1500908,1380,1380,1380,167,0,2,58700,140450,0,167
152000,013360,1380,2,70,5.34,99.64,706424,703909,-2515,4582,5939,1357,1500908,1380,1380,1380,167,0,2,58700,140450,0,167
152000,013360,1380,2,70,5.34,99.64,706424,703909,-2515,4582,5939,1357,1500908,1380,1380,1380,167,0,2,58700,140450,0,167
152000,013360,1380,2,70,5.34,99.64,706424,703909,-2515,4582,5939,1357,1500908,1380,1380,1380,167,0,2,58700,140450,0,167
152000,013360,1380,2,70,5.34,99.64,706424,703909,-2515,4582,5939,1357,1500908,1380,1380,1380,167,0,2,58700,140450,0,167
152000,013360,1380,2,70,5.34,99.64,706424,703909,-2515,4582,5939,1357,1500908,1380,1380,1380,167,0,2,58700,140450,0,167
152000,013360,1380,2,70,5.34,99.64,706424,703909,-2515,4582,5939,1357,1500908,1380,1380,1380,167,0,2,58700,140450,0,167
152000,013360,1380,2,70,5.34,99.64,706424,703909,-2515,4582,5939,1357,1500908,1380,1380,1380,167,0,2,58700,140450,0,167
152000,013360,1380,2,70,5.34,99.64,706424,703909,-2515,4582,5939,1357,1500908,1380,1380,1380,167,0,2,58700,140450,0,167
152000,013360,1380,2,70,5.34,99.64,706424,703909,-2515,4582,5939,1357,1500908,1380,1380,1380,167,0,2,58700,140450,0,167
152000,013360,1380,2,70,5.34,99.64,706424,703909,-2515,4582,5939,1357,1500908,1380,1380,1380,167,0,2,58700,140450,0,167
152000,013360,1380,2,70,5.34,99.64,706424,703909,-2515,4582,5939,1357,1500908,1380,1380,1380,167,0,2,58700,140450,0,167
152000,013360,1380,2,70,5.34,99.64,706424,703909,-2515,4582,5939,1357,1500908,1380,1380,1380,167,0,2,58700,140450,0,167
152000,013360,1380,2,70,5.34,99.64,706424,703909,-2515,4582,5939,1357,1500908,1380,1380,1380,167,0,2,58700,140450,0,167
152000,013360,1380,2,70,5.34,99.64,706424,703909,-2515,4582,5939,1357,1500908,1380,1380,1380,167,0,2,58700,140450,0,167
152000,013360,1380,2,70,5.34,99.64,706424,703909,-2515,4582,5939,1357,1500908,1380,1380,1380,167,0,2,58700,140450,0,167
152000,013360,1380,2,70,5.34,99.64,706424,703909,-2515,4582,5939,1357,1500908,1380,1380,1380,167,0,2,58700,140450,0,167
152000,013360,1380,2,70,5.34,99.64,706424,703909,-2515,4582,5939,1357,1500908,1380,1380,1380,167,0,2,58700,140450,0,167
152000,013360,1380,2,70,5.34,99.64,706424,703909,-2515,4582,5939,1357,1500908,1380,1380,1380,167,0,2,58700,140450,0,167
153000,013360,1380,2,70,5.34,99.64,706424,703909,-2515,4582,5939,1357,1500908,1380,1380,1380,0,0,0,58699,143650,0,0
153000,013360,1385,2,75,5.73,99.64,706424,703909,-2515,4582,5939,1357,1517131,1385,1385,1385,16223,0,0,58699,143650,0,0
153000,013360,1385,2,75,5.73,99.64,706424,703909,-2515,4582,5939,1357,1517131,1385,1385,1385,16223,0,0,58699,143650,0,0
