090200,016580,16400,2,100,0.61,12.21,4635,566,-4069,4,7,3,8599,16500,16500,16400,468,2,3,9928,5383,296,172
090300,016580,16500,2,200,1.23,13.29,4635,616,-4019,4,8,4,8649,16500,16500,16500,0,0,0,9818,5213,0,0
090300,016580,16450,2,150,0.92,16.04,4695,753,-3942,5,11,6,8846,16500,16500,16450,197,1,3,9814,5286,60,137
090400,016580,16450,2,150,0.92,20.06,5438,1091,-4347,8,15,7,9927,16450,16450,16450,26,0,1,8842,5377,0,26
090400,016580,16400,2,100,0.61,21.58,5752,1241,-4511,9,16,7,10391,16450,16450,16400,490,1,2,10128,5807,314,176
090500,016580,16400,2,100,0.61,21.58,5752,1241,-4511,9,16,7,10391,16400,16400,16400,0,0,0,10128,5807,0,0
090500,016580,16450,2,150,0.92,61.24,5846,3580,-2266,12,29,17,12824,16400,16550,16400,2433,3,13,8510,6035,94,2339
090600,016580,16500,2,200,1.23,64.93,5868,3810,-2058,13,31,18,13076,16550,16550,16500,252,1,2,11020,3582,22,230
090600,016580,16550,2,250,1.53,65.22,5868,3827,-2041,13,32,19,13093,16550,16550,16500,269,1,3,11020,3581,22,247
090700,016580,16500,2,200,1.23,65.31,6025,3935,-2090,14,36,22,13358,16500,16500,16500,11,0,2,10854,7610,0,11
090700,016580,16500,2,200,1.23,65.31,6025,3935,-2090,14,36,22,13358,16500,16500,16500,11,0,2,10854,7610,0,11
090800,016580,16550,2,250,1.53,128.04,6056,7754,1698,15,41,26,17208,16500,16550,16500,3819,0,5,11178,7044,0,3819
090800,016580,16550,2,250,1.53,140.67,6056,8519,2463,15,49,34,17973,16500,16550,16500,4584,0,13,11457,7146,0,4584
090900,016580,16550,2,250,1.53,138.87,6179,8581,2402,17,51,34,18158,16500,16550,16500,9,1,1,12081,7164,8,1
090900,016580,16550,2,250,1.53,139.72,6179,8633,2454,17,53,36,18210,16500,16550,16500,61,1,3,12098,8215,8,53
091000,016580,16550,2,250,1.53,147.99,6201,9177,2976,18,62,44,18776,16550,16550,16550,544,0,9,12759,9111,0,544
091000,016580,16550,2,250,1.53,140.11,6701,9389,2688,20,67,47,19488,16550,16550,16500,1256,2,14,12983,8767,500,756
091100,016580,16600,2,300,1.84,178.18,6701,11940,5239,20,82,62,22039,16550,16600,16550,2539,0,14,11445,8548,0,2539
091100,016580,16600,2,300,1.84,186.2,6701,12477,5776,20,91,71,22576,16550,16600,16550,3076,0,23,11310,8800,0,3076
091200,016580,16600,2,300,1.84,196.94,6730,13254,6524,24,99,75,23382,16600,16650,16550,806,4,8,12496,9026,29,777
091300,016580,16650,2,350,2.15,226.25,6738,15245,8507,26,112,86,25681,16650,16650,16650,0,0,0,12597,6008,0,0
091300,016580,16600,2,300,1.84,184.9,8284,15317,7033,32,115,83,27299,16650,16650,16600,1618,6,3,11198,7812,1546,72
091400,016580,16650,2,350,2.15,195.93,8407,16472,8065,34,117,83,28577,16650,16650,16650,0,0,0,12987,8003,0,0
091400,016580,16700,2,400,2.45,186.94,8821,16490,7669,37,118,81,29009,16650,16700,16650,432,3,1,13037,7428,414,18
091500,016580,16800,2,500,3.07,218.1,8862,19328,10466,39,138,99,31888,16800,16800,16800,887,0,8,14250,7218,0,887
091500,016580,16750,2,450,2.76,221.99,8905,19768,10863,40,149,109,32371,16800,16800,16750,1370,1,19,15829,7994,43,1327
091600,016580,16750,2,450,2.76,199.66,10246,20457,10211,42,160,118,34401,16750,16800,16750,447,1,3,18902,6725,5,442
091600,016580,16750,2,450,2.76,181.08,11604,21013,9409,50,163,113,36315,16750,16800,16750,2361,9,6,18974,7482,1363,998
091700,016580,16750,2,450,2.76,210.1,11816,24826,13010,51,187,136,40340,16750,16800,16750,2506,1,12,18274,8503,212,2294
091700,016580,16750,2,450,2.76,208.27,12106,25213,13107,59,195,136,41017,16750,16800,16750,3183,9,20,18172,9183,502,2681
091800,016580,16750,2,450,2.76,198.71,13140,26110,12970,67,202,135,42948,16750,16800,16750,669,7,1,17891,9117,668,1
091800,016580,16800,2,500,3.07,215.33,13140,28295,15155,67,215,148,45133,16750,16800,16750,2854,7,14,18390,10572,668,2186
091900,016580,16800,2,500,3.07,213.76,13856,29619,15763,70,230,160,47173,16800,16800,16800,319,0,5,17484,8852,0,319
091900,016580,16750,2,450,2.76,219.24,13909,30494,16585,73,235,162,48101,16800,16800,16750,1247,3,10,18320,9063,53,1194
092000,016580,16800,2,500,3.07,221.17,14057,31090,17033,76,240,164,48845,16750,16850,16750,740,2,5,20082,7799,144,596
092000,016580,16800,2,500,3.07,219.95,14135,31090,16955,83,240,157,48923,16750,16850,16750,818,9,5,20152,9239,222,596
092100,016580,16800,2,500,3.07,217.99,14262,31090,16828,87,240,153,49050,16800,16800,16800,114,2,0,20272,9508,114,0
092100,016580,16800,2,500,3.07,200.28,15577,31197,15620,93,243,150,50472,16800,16850,16800,1536,8,3,20375,7529,1429,107
092200,016580,16800,2,500,3.07,198.92,15683,31197,15514,100,243,143,50578,16800,16800,16800,31,4,0,20380,8038,31,0
092200,016580,16800,2,500,3.07,198.45,15720,31197,15477,105,243,138,50615,16800,16800,16800,68,9,0,20495,9424,68,0
092300,016580,16800,2,500,3.07,197.11,15827,31197,15370,111,243,132,50722,16800,16800,16800,52,3,0,20395,9495,52,0
092300,016580,16800,2,500,3.07,195.98,15955,31268,15313,115,246,131,50921,16800,16850,16800,251,7,3,20824,9947,180,71
092400,016580,16800,2,500,3.07,195.84,15966,31268,15302,117,246,129,50932,16800,16800,16800,11,2,0,21444,10663,11,0
092400,016580,16800,2,500,3.07,195.06,16030,31268,15238,121,246,125,50996,16800,16800,16800,75,6,0,21583,11245,75,0
092500,016580,16800,2,500,3.07,183.13,17086,31289,14203,126,247,121,52073,16800,16850,16800,1051,4,1,22074,10024,1030,21
092500,016580,16800,2,500,3.07,182.23,17170,31289,14119,129,247,118,52157,16800,16850,16800,1135,7,1,22092,10006,1114,21
092600,016580,16850,2,550,3.37,181.79,17278,31410,14132,135,249,114,52386,16800,16850,16800,128,3,1,22186,9776,28,100
092600,016580,16900,2,600,3.68,194.31,17295,33606,16311,138,256,118,54599,16800,16900,16800,2341,6,8,20256,8830,45,2296
092700,016580,16850,2,550,3.37,194.9,17359,33832,16473,142,262,120,54889,16900,16900,16850,185,3,4,20399,8240,60,125
092700,016580,16900,2,600,3.68,210.34,17367,36530,19163,144,270,126,57595,16900,16950,16850,2891,5,12,19300,8166,68,2823
092800,016580,16950,2,650,3.99,215.24,18260,39303,21043,150,286,136,61261,16900,17000,16900,3566,6,15,19560,8331,893,2673
092800,016580,16900,2,600,3.68,210.86,18884,39818,20934,158,293,135,62400,16900,17000,16900,4705,14,22,17075,7779,1517,3188
092900,016580,16900,2,600,3.68,207.77,19236,39966,20730,168,298,130,62900,16950,17000,16900,480,9,5,16937,7559,332,148
093000,016580,16850,2,550,3.37,199.42,20110,40104,19994,173,305,132,63912,16850,16850,16850,0,0,0,16040,9216,0,0
093000,016580,16800,2,500,3.07,197.97,20737,41053,20316,180,314,134,65488,16800,16850,16750,1576,7,9,14579,12956,627,949
093100,016580,16800,2,500,3.07,197.44,20821,41109,20288,183,319,136,65628,16800,16800,16800,10,1,0,16983,12008,10,0
093100,016580,16800,2,500,3.07,196.52,20949,41169,20220,186,321,135,65816,16800,16800,16800,198,4,2,17503,12056,138,60
093200,016580,16850,2,550,3.37,199.19,20990,41809,20819,190,326,136,66497,16850,16900,16850,429,2,1,16757,10809,29,400
093200,016580,16800,2,500,3.07,197.1,21212,41809,20597,194,326,132,66719,16850,16900,16800,651,6,1,16347,10627,251,400
093300,016580,16800,2,500,3.07,191.1,21892,41836,19944,201,329,128,67426,16800,16800,16800,3,0,1,13913,11105,0,3
093300,016580,16800,2,500,3.07,190.84,22018,42019,20001,203,332,129,67735,16800,16800,16800,312,2,4,16172,9995,126,186
093400,016580,16750,2,450,2.76,183.17,22957,42051,19094,213,333,120,68706,16750,16750,16750,32,0,1,14063,11555,0,32
093400,016580,16700,2,400,2.45,183.89,22976,42251,19275,216,334,118,68925,16750,16750,16700,251,3,2,13931,11688,19,232
093500,016580,16700,2,400,2.45,183.01,23092,42261,19169,220,335,115,69051,16750,16750,16700,56,1,1,13957,12497,46,10
093500,016580,16750,2,450,2.76,184.76,23100,42680,19580,222,342,120,69478,16750,16750,16700,483,3,8,13580,12537,54,429
093600,016580,16750,2,450,2.76,179.03,23912,42810,18898,227,347,120,70420,16750,16750,16750,4,1,0,14461,12036,4,0
093600,016580,16750,2,450,2.76,178.66,24107,43070,18963,231,351,120,70875,16750,16800,16750,459,5,4,14301,11842,199,260
093700,016580,16750,2,450,2.76,178.52,24126,43070,18944,234,351,117,70894,16750,16750,16750,15,2,0,14658,11901,15,0
093700,016580,16750,2,450,2.76,178.06,24189,43070,18881,239,351,112,70957,16750,16750,16750,78,7,0,14658,11867,78,0
093800,016580,16700,2,400,2.45,176.86,24373,43107,18734,246,352,106,71178,16700,16700,16700,5,2,0,13963,12854,5,0
093800,016580,16700,2,400,2.45,176.85,24377,43110,18733,247,353,106,71185,16700,16750,16700,12,3,1,14184,12056,9,3
093900,016580,16700,2,400,2.45,176.53,24453,43168,18715,255,356,101,71319,16700,16700,16700,68,7,0,14210,12087,68,0
093900,016580,16700,2,400,2.45,175.38,24737,43384,18647,261,360,99,71819,16700,16750,16700,568,13,4,14100,11915,352,216
094000,016580,16750,2,450,2.76,171.98,25242,43412,18170,264,361,97,72352,16700,16750,16700,528,1,1,14450,11465,500,28
094000,016580,16700,2,400,2.45,169.52,25641,43467,17826,275,365,90,72806,16700,16750,16700,982,12,5,14595,10838,899,83
094100,016580,16700,2,400,2.45,169.43,25655,43468,17813,281,366,85,72821,16700,16700,16700,5,2,0,14594,10837,5,0
094100,016580,16650,2,350,2.15,161.06,26988,43468,16480,295,366,71,74154,16700,16700,16650,1338,16,0,10006,9729,1338,0
094200,016580,16650,2,350,2.15,159.91,27182,43468,16286,302,366,64,74348,16650,16650,16650,185,3,0,10094,11748,185,0
094200,016580,16700,2,400,2.45,159.19,27332,43511,16179,303,368,65,74541,16650,16700,16650,378,4,2,9438,12343,335,43
094300,016580,16650,2,350,2.15,159.05,27408,43593,16185,311,370,59,74699,16700,16700,16650,113,7,1,9579,9510,72,41
094300,016580,16650,2,350,2.15,158.77,27459,43596,16137,319,371,52,74753,16700,16700,16650,167,15,2,9785,9437,123,44
094400,016580,16650,2,350,2.15,157.41,27695,43596,15901,329,371,42,74989,16650,16650,16650,174,8,0,9785,9481,174,0
094400,016580,16650,2,350,2.15,157.02,27765,43596,15831,336,371,35,75059,16650,16650,16650,244,15,0,9763,9640,244,0
094500,016580,16700,2,400,2.45,157.77,27792,43848,16056,340,373,33,75338,16650,16700,16650,179,4,1,14193,9814,27,152
094500,016580,16700,2,400,2.45,155.19,28255,43848,15593,347,373,26,75801,16650,16700,16650,642,11,1,14732,9869,490,152
094600,016580,16650,2,350,2.15,154.99,28290,43848,15558,353,373,20,75836,16650,16650,16650,35,6,0,10651,9614,35,0
094600,016580,16600,2,300,1.84,148.38,29621,43951,14330,364,376,12,77270,16650,16650,16550,1469,17,3,6921,9200,1366,103
094700,016580,16600,2,300,1.84,148.49,29726,44140,14414,370,379,9,77564,16600,16600,16600,289,4,3,8252,9121,100,189
094700,016580,16600,2,300,1.84,148.02,29821,44140,14319,378,379,1,77659,16600,16600,16600,384,12,3,8822,9824,195,189
094800,016580,16650,2,350,2.15,147.69,29887,44141,14254,384,380,-4,77726,16600,16650,16600,63,4,1,8822,10842,62,1
094900,016580,16600,2,300,1.84,147.65,29897,44143,14246,388,382,-6,77738,16600,16600,16600,0,0,0,8799,10927,0,0
094900,016580,16600,2,300,1.84,145.59,30481,44378,13897,394,385,-9,78557,16600,16600,16550,819,6,3,9019,11124,584,235
095000,016580,16650,2,350,2.15,144.48,30726,44393,13667,399,388,-11,78817,16650,16650,16650,0,0,0,9011,11734,0,0
095000,016580,16600,2,300,1.84,144.14,30799,44393,13594,405,388,-17,78890,16600,16600,16600,73,6,0,9008,11922,73,0
095100,016580,16600,2,300,1.84,142.49,31157,44395,13238,414,389,-25,79250,16600,16600,16600,37,2,0,8721,11584,37,0
095100,016580,16650,2,350,2.15,142.62,31226,44536,13310,418,391,-27,79460,16600,16700,16600,247,6,2,10787,12037,106,141
095200,016580,16650,2,350,2.15,140.55,31689,44538,12849,423,392,-31,79925,16650,16700,16650,461,4,1,10965,11946,459,2
095200,016580,16600,2,300,1.84,140.3,31745,44538,12793,426,392,-34,79981,16650,16700,16600,517,7,1,8938,11718,515,2
095300,016580,16650,2,350,2.15,140.32,31745,44543,12798,426,393,-33,79986,16650,16650,16650,5,0,1,8852,11817,0,5
095300,016580,16650,2,350,2.15,140.28,31807,44618,12811,428,394,-34,80123,16650,16650,16600,142,2,2,8827,11981,62,80
095400,016580,16650,2,350,2.15,140.28,31807,44618,12811,428,394,-34,80123,16650,16650,16650,0,0,0,8827,11981,0,0
095400,016580,16600,2,300,1.84,138.43,32232,44618,12386,435,394,-41,80548,16650,16650,16600,425,7,0,8562,12042,425,0
095500,016580,16600,2,300,1.84,138.04,32323,44618,12295,443,394,-49,80639,16600,16600,16600,91,8,0,8606,13982,91,0
095500,016580,16600,2,300,1.84,137.92,32350,44618,12268,445,394,-51,80666,16600,16600,16600,118,10,0,8706,13896,118,0
095600,016580,16600,2,300,1.84,137.92,32350,44618,12268,445,394,-51,80666,16600,16600,16600,0,0,0,8706,13896,0,0
095600,016580,16600,2,300,1.84,137.97,32412,44718,12306,447,395,-52,80828,16650,16650,16600,162,2,1,8534,14612,62,100
095700,016580,16600,2,300,1.84,137.97,32412,44718,12306,447,395,-52,80828,16600,16600,16600,0,0,0,8534,14612,0,0
095800,016580,16600,2,300,1.84,137.85,32440,44718,12278,449,395,-54,80856,16600,16600,16600,0,0,0,8659,13842,0,0
095800,016580,16600,2,300,1.84,137.75,32464,44718,12254,453,395,-58,80880,16600,16600,16600,24,4,0,8659,13915,24,0
095900,016580,16650,2,350,2.15,137.75,32470,44727,12257,455,398,-57,80895,16650,16650,16650,7,0,1,8664,13907,0,7
095900,016580,16600,2,300,1.84,137.63,32498,44727,12229,457,398,-59,80923,16650,16650,16600,35,2,1,8963,13885,28,7
100000,016580,16600,2,300,1.84,135.55,32997,44727,11730,462,398,-64,81422,16600,16600,16600,0,0,0,9293,13442,0,0
100000,016580,16600,2,300,1.84,135.55,32997,44727,11730,462,398,-64,81422,16600,16600,16600,0,0,0,9293,13442,0,0
100100,016580,16600,2,300,1.84,135.33,33051,44727,11676,466,398,-68,81476,16600,16600,16600,0,0,0,9303,13332,0,0
100100,016580,16600,2,300,1.84,131.87,34144,45025,10881,473,399,-74,82867,16600,16600,16550,1391,7,1,9540,12287,1093,298
100200,016580,16600,2,300,1.84,131.82,34156,45025,10869,474,399,-75,82879,16600,16600,16600,0,0,0,9540,12363,0,0
100200,016580,16600,2,300,1.84,131.78,34166,45025,10859,476,399,-77,82889,16600,16600,16600,10,2,0,9350,12364,10,0
100300,016580,16600,2,300,1.84,130.84,34412,45026,10614,482,400,-82,83136,16650,16650,16600,247,6,1,9347,13246,246,1
100300,016580,16550,2,250,1.53,129.65,34730,45026,10296,485,400,-85,83454,16650,16650,16550,565,9,1,9020,13557,564,1
100400,016580,16600,2,300,1.84,132.56,34730,46037,11307,485,402,-83,84465,16600,16600,16600,1011,0,2,8247,13551,0,1011
100400,016580,16600,2,300,1.84,132.56,34730,46037,11307,485,402,-83,84465,16600,16600,16600,1011,0,2,8247,13551,0,1011
100500,016580,16600,2,300,1.84,132.56,34730,46038,11308,485,403,-82,84466,16600,16600,16600,1,0,1,8269,13551,0,1
100500,016580,16550,2,250,1.53,132.52,34741,46038,11297,486,403,-83,84477,16600,16600,16550,12,1,1,8352,13551,11,1
100600,016580,16550,2,250,1.53,132.31,34802,46048,11246,490,404,-86,84548,16550,16600,16550,68,2,1,8462,13584,58,10
100600,016580,16550,2,250,1.53,131.89,34913,46048,11135,495,404,-91,84659,16550,16600,16550,179,7,1,8413,13671,169,10
100700,016580,16550,2,250,1.53,131.87,34918,46048,11130,496,404,-92,84664,16550,16550,16550,0,0,0,8413,13649,0,0
100700,016580,16550,2,250,1.53,131.87,34918,46048,11130,496,404,-92,84664,16550,16550,16550,0,0,0,8413,13649,0,0
100800,016580,16600,2,300,1.84,130.57,35291,46078,10787,498,405,-93,85067,16600,16600,16600,30,0,1,8435,13306,0,30
100800,016580,16600,2,300,1.84,130.88,35291,46190,10899,498,408,-90,85179,16600,16600,16600,142,0,4,8298,13285,0,142
100900,016580,16550,2,250,1.53,130.77,35324,46192,10868,500,409,-91,85214,16550,16550,16550,33,2,0,8386,13495,33,0
100900,016580,16550,2,250,1.53,130.54,35385,46192,10807,503,409,-94,85275,16550,16550,16550,94,5,0,8606,13511,94,0
101000,016580,16550,2,250,1.53,130.65,35405,46255,10850,504,411,-93,85358,16600,16600,16550,83,1,2,8343,13505,20,63
101000,016580,16550,2,250,1.53,130.56,35427,46255,10828,505,411,-94,85380,16600,16600,16550,105,2,2,8483,13636,42,63
101100,016580,16550,2,250,1.53,130.56,35427,46255,10828,505,411,-94,85380,16550,16550,16550,0,0,0,8483,13636,0,0
101200,016580,16600,2,300,1.84,131.41,35448,46582,11134,506,413,-93,85728,16600,16600,16600,0,0,0,9639,13114,0,0
101200,016580,16650,2,350,2.15,131.42,35470,46614,11144,507,414,-93,85782,16600,16650,16600,54,1,1,9794,13036,22,32
101300,016580,16600,2,300,1.84,131.13,35549,46614,11065,513,414,-99,85861,16600,16600,16600,2,1,0,9776,13266,2,0
101300,016580,16600,2,300,1.84,130.57,35700,46614,10914,518,414,-104,86012,16600,16600,16600,153,6,0,9776,13118,153,0
101400,016580,16650,2,350,2.15,130.54,35710,46615,10905,520,415,-105,86023,16650,16650,16650,0,0,0,9776,13213,0,0
101400,016580,16600,2,300,1.84,130.43,35739,46615,10876,522,415,-107,86052,16600,16600,16600,29,2,0,10075,13390,29,0
101500,016580,16600,2,300,1.84,130.58,35740,46670,10930,523,417,-106,86108,16650,16650,16600,6,1,1,9995,13379,1,5
101500,016580,16600,2,300,1.84,130.53,35774,46695,10921,526,418,-108,86167,16650,16650,16600,65,4,2,9975,13591,35,30
101600,016580,16600,2,300,1.84,130.09,35894,46695,10801,530,418,-112,86287,16600,16600,16600,58,2,0,9970,13517,58,0
101600,016580,16600,2,300,1.84,129.94,35936,46695,10759,535,418,-117,86329,16600,16600,16600,100,7,0,9980,13498,100,0
101700,016580,16600,2,300,1.84,129.49,36061,46695,10634,537,418,-119,86454,16600,16600,16600,0,0,0,10027,13401,0,0
101700,016580,16600,2,300,1.84,128.57,36320,46695,10375,540,418,-122,86713,16600,16600,16600,259,3,0,10027,12169,259,0
101800,016580,16600,2,300,1.84,127.21,36708,46695,9987,543,418,-125,87101,16600,16600,16600,388,3,0,10027,12083,388,0
101800,016580,16550,2,250,1.53,127.11,36737,46695,9958,546,418,-128,87130,16600,16600,16550,417,6,0,9178,12346,417,0
101900,016580,16550,2,250,1.53,126.86,36814,46704,9890,549,420,-129,87216,16600,16600,16550,85,3,1,9234,14291,77,8
101900,016580,16550,2,250,1.53,126.75,36926,46804,9878,554,421,-133,87428,16600,16600,16550,297,8,2,9149,14386,189,108
102000,016580,16550,2,250,1.53,126.87,36970,46904,9934,559,422,-137,87572,16550,16550,16550,4,2,0,9202,12218,4,0
102000,016580,16550,2,250,1.53,126.87,36970,46904,9934,559,422,-137,87572,16550,16550,16550,4,2,0,9202,12218,4,0
102100,016580,16550,2,250,1.53,126.77,36998,46904,9906,561,422,-139,87600,16550,16550,16550,0,0,0,9202,12258,0,0
102100,016580,16550,2,250,1.53,126.74,37008,46904,9896,563,422,-141,87610,16550,16550,16550,10,2,0,9202,12164,10,0
102200,016580,16550,2,250,1.53,126.56,37061,46904,9843,567,422,-145,87663,16550,16550,16550,53,4,0,9537,12686,53,0
102200,016580,16550,2,250,1.53,126.34,37124,46904,9780,569,422,-147,87726,16550,16550,16550,116,6,0,9537,12631,116,0
102300,016580,16550,2,250,1.53,126.31,37135,46904,9769,570,422,-148,87737,16550,16550,16550,11,1,0,9537,12759,11,0
102300,016580,16550,2,250,1.53,126.29,37140,46904,9764,572,422,-150,87742,16550,16550,16550,16,3,0,9537,13745,16,0
102400,016580,16600,2,300,1.84,126.21,37167,46909,9742,574,423,-151,87774,16600,16600,16600,5,0,1,9836,13731,0,5
102400,016580,16550,2,250,1.53,126.32,37184,46971,9787,576,425,-151,87853,16600,16600,16550,84,2,3,9782,13724,17,67
102500,016580,16550,2,250,1.53,126.2,37219,46971,9752,580,425,-155,87888,16550,16550,16550,35,4,0,9516,13676,35,0
102500,016580,16550,2,250,1.53,125.99,37282,46971,9689,582,425,-157,87951,16550,16550,16550,98,6,0,9519,13624,98,0
102600,016580,16550,2,250,1.53,125.9,37311,46976,9665,585,426,-159,87985,16550,16550,16550,0,0,0,9516,13584,0,0
102600,016580,16550,2,250,1.53,125.78,37349,46976,9627,588,426,-162,88023,16550,16550,16550,38,3,0,9514,13581,38,0
102700,016580,16550,2,250,1.53,125.75,37356,46976,9620,591,426,-165,88030,16550,16550,16550,3,1,0,9514,13294,3,0
102700,016580,16500,2,200,1.23,117.38,40022,46976,6954,599,426,-173,90696,16550,16550,16500,2669,9,0,9525,11695,2669,0
102800,016580,16500,2,200,1.23,115.61,40634,46976,6342,604,426,-178,91308,16500,16500,16500,587,3,0,8831,11309,587,0
102800,016580,16500,2,200,1.23,115.33,40731,46976,6245,607,426,-181,91405,16500,16500,16500,684,6,0,8559,10997,684,0
102900,016580,16500,2,200,1.23,115.31,40739,46976,6237,609,426,-183,91413,16500,16500,16500,0,0,0,8560,10977,0,0
102900,016580,16500,2,200,1.23,115.15,40794,46976,6182,613,426,-187,91468,16500,16500,16500,55,4,0,9591,11129,55,0
103000,016580,16500,2,200,1.23,114.88,40897,46981,6084,616,427,-189,91576,16550,16550,16500,108,3,1,9494,11033,103,5
103000,016580,16500,2,200,1.23,113.62,41351,46981,5630,624,427,-197,92030,16550,16550,16500,562,11,1,9522,13678,557,5
103100,016580,16550,2,250,1.53,115.53,41380,47805,6425,627,428,-199,92883,16500,16550,16500,853,3,1,9803,13915,29,824
103100,016580,16550,2,250,1.53,115.35,41445,47805,6360,630,428,-202,92948,16500,16550,16500,918,6,1,9835,14399,94,824
103200,016580,16550,2,250,1.53,115.27,41472,47805,6333,632,428,-204,92975,16550,16550,16550,27,2,0,9855,15400,27,0
103200,016580,16600,2,300,1.84,116.17,41505,48217,6712,635,429,-206,93420,16550,16600,16550,472,5,1,11050,17499,60,412
103300,016580,16600,2,300,1.84,116.09,41534,48217,6683,637,429,-208,93449,16600,16600,16600,29,2,0,11095,17453,29,0
103400,016580,16600,2,300,1.84,115.98,41573,48217,6644,641,429,-212,93488,16600,16600,16600,0,0,0,11070,15988,0,0
103400,016580,16650,2,350,2.15,117.56,41646,48961,7315,643,430,-213,94305,16650,16650,16650,817,2,1,13002,12563,73,744
103500,016580,16650,2,350,2.15,117.97,41671,49159,7488,644,431,-213,94528,16650,16650,16650,25,1,0,12591,13183,25,0
103500,016580,16700,2,400,2.45,116.04,42548,49373,6825,650,432,-218,95619,16650,16700,16650,1116,7,1,18244,12936,902,214
103600,016580,16700,2,400,2.45,116.04,42548,49373,6825,650,432,-218,95619,16700,16700,16700,0,0,0,18244,12936,0,0
103600,016580,16750,2,450,2.76,116.43,42776,49802,7026,658,435,-223,96276,16700,16750,16700,657,8,3,19077,11407,228,429
103700,016580,16750,2,450,2.76,114.5,43628,49955,6327,666,441,-225,97281,16750,16750,16750,588,2,2,19822,11240,564,24
103700,016580,16750,2,450,2.76,114.58,43699,50071,6372,670,443,-227,97468,16750,16750,16650,775,6,4,19576,10945,635,140
103800,016580,16700,2,400,2.45,114.59,43704,50082,6378,672,444,-228,97484,16700,16700,16700,3,1,0,18884,11361,3,0
103800,016580,16700,2,400,2.45,114.06,43955,50137,6182,678,445,-233,97790,16700,16700,16700,309,7,1,14182,11617,254,55
103900,016580,16700,2,400,2.45,114.05,43961,50137,6176,680,445,-235,97796,16700,16700,16700,0,0,0,19674,11191,0,0
103900,016580,16700,2,400,2.45,115.95,43991,51007,7016,686,447,-239,98696,16750,16750,16700,900,6,2,18910,11342,30,870
104000,016580,16700,2,400,2.45,115.95,43992,51007,7015,687,447,-240,98697,16700,16700,16700,0,0,0,18910,11336,0,0
104000,016580,16700,2,400,2.45,115.93,44001,51009,7008,689,448,-241,98708,16700,16750,16700,11,2,1,19240,11578,9,2
104100,016580,16650,2,350,2.15,114.94,44377,51009,6632,694,448,-246,99084,16700,16700,16650,26,3,0,13187,11474,26,0
104100,016580,16650,2,350,2.15,114.78,44442,51009,6567,698,448,-250,99149,16700,16700,16650,91,7,0,13672,11509,91,0
104200,016580,16650,2,350,2.15,114.78,44442,51009,6567,698,448,-250,99149,16650,16650,16650,0,0,0,13672,11509,0,0
104200,016580,16650,2,350,2.15,114.71,44467,51009,6542,700,448,-252,99174,16650,16650,16650,25,2,0,13672,11660,25,0
104300,016580,16650,2,350,2.15,114.23,44654,51009,6355,702,448,-254,99361,16650,16650,16650,0,0,0,19211,11507,0,0
104300,016580,16650,2,350,2.15,114.18,44673,51009,6336,704,448,-256,99380,16650,16650,16650,19,2,0,19244,11491,19,0
104400,016580,16650,2,350,2.15,114.13,44717,51034,6317,709,449,-260,99449,16650,16650,16650,10,2,0,19219,11440,10,0
104400,016580,16650,2,350,2.15,115.35,45011,51922,6911,713,450,-263,100631,16650,16700,16650,1192,6,1,18361,11178,304,888
104500,016580,16650,2,350,2.15,115.08,45147,51957,6810,718,451,-267,100802,16700,16700,16650,143,3,1,18334,11089,108,35
104500,016580,16700,2,400,2.45,115.65,45200,52273,7073,720,453,-267,101171,16700,16700,16650,512,5,3,18058,10586,161,351
104600,016580,16700,2,400,2.45,115.66,45200,52278,7078,720,454,-266,101176,16700,16700,16700,0,0,0,12557,11068,0,0
104600,016580,16700,2,400,2.45,115.65,45202,52278,7076,722,454,-268,101178,16700,16700,16700,2,2,0,18107,10677,2,0
104700,016580,16700,2,400,2.45,115.58,45230,52278,7048,725,454,-271,101206,16700,16700,16700,2,1,0,18107,10259,2,0
104700,016580,16650,2,350,2.15,115.45,45280,52278,6998,726,454,-272,101256,16700,16700,16650,52,2,0,12483,10966,52,0
104800,016580,16650,2,350,2.15,115.4,45322,52302,6980,732,455,-277,101322,16650,16650,16650,14,2,0,12459,10877,14,0
104800,016580,16650,2,350,2.15,115.35,45383,52350,6967,738,457,-281,101431,16650,16700,16650,123,8,2,18080,10839,75,48
104900,016580,16650,2,350,2.15,115.35,45383,52350,6967,738,457,-281,101431,16650,16650,16650,0,0,0,18080,10839,0,0
104900,016580,16650,2,350,2.15,115.01,45535,52372,6837,742,459,-283,101605,16700,16700,16650,174,4,2,17917,10967,152,22
105000,016580,16650,2,350,2.15,115.01,45535,52372,6837,742,459,-283,101605,16650,16650,16650,0,0,0,17917,10967,0,0
105000,016580,16650,2,350,2.15,115.01,45535,52372,6837,742,459,-283,101605,16650,16650,16650,0,0,0,17917,10967,0,0
105100,016580,16700,2,400,2.45,114.79,45623,52372,6749,746,459,-287,101693,16700,16700,16700,25,2,0,18096,10424,25,0
105100,016580,16650,2,350,2.15,114.45,45760,52372,6612,750,459,-291,101830,16700,16700,16650,162,6,0,12590,10191,162,0
105200,016580,16650,2,350,2.15,114.39,45785,52372,6587,752,459,-293,101855,16650,16650,16650,25,2,0,12507,10999,25,0
105200,016580,16750,2,450,2.76,115.08,45819,52730,6911,755,461,-294,102247,16650,16750,16650,417,5,2,12507,10942,59,358
105300,016580,16750,2,450,2.76,115.21,45819,52788,6969,755,462,-293,102305,16750,16750,16750,58,0,1,18007,10535,0,58
105300,016580,16750,2,450,2.76,115.21,45819,52788,6969,755,462,-293,102305,16750,16750,16750,58,0,1,18007,10535,0,58
105400,016580,16700,2,400,2.45,114.99,45907,52788,6881,758,462,-296,102393,16700,16700,16700,88,3,0,18021,10696,88,0
105400,016580,16700,2,400,2.45,114.99,45907,52788,6881,758,462,-296,102393,16700,16700,16700,88,3,0,18021,10696,88,0
105500,016580,16700,2,400,2.45,114.89,45948,52788,6840,762,462,-300,102434,16700,16700,16700,41,4,0,18036,10833,41,0
105600,016580,16700,2,400,2.45,114.86,45960,52788,6828,765,462,-303,102446,16700,16700,16700,0,0,0,18116,11862,0,0
105600,016580,16700,2,400,2.45,114.79,45988,52788,6800,767,462,-305,102474,16700,16700,16700,28,2,0,18116,11900,28,0
105700,016580,16700,2,400,2.45,114.79,45988,52788,6800,767,462,-305,102474,16700,16700,16700,0,0,0,18116,11900,0,0
105700,016580,16700,2,400,2.45,114.57,46075,52788,6713,771,462,-309,102561,16700,16700,16700,87,4,0,18145,11819,87,0
105800,016580,16700,2,400,2.45,114.57,46075,52788,6713,771,462,-309,102561,16700,16700,16700,0,0,0,18145,11819,0,0
105800,016580,16700,2,400,2.45,114.65,46128,52887,6759,774,463,-311,102713,16750,16750,16700,152,3,1,18220,11954,53,99
105900,016580,16700,2,400,2.45,114.62,46143,52887,6744,776,463,-313,102728,16700,16700,16700,0,0,0,18195,11881,0,0
105900,016580,16700,2,400,2.45,114.58,46156,52887,6731,779,463,-316,102741,16700,16700,16700,13,3,0,18195,11678,13,0
110000,016580,16700,2,400,2.45,114.44,46215,52887,6672,784,463,-321,102800,16700,16700,16700,59,5,0,18195,12146,59,0
110000,016580,16700,2,400,2.45,114.42,46387,53076,6689,789,464,-325,103161,16700,16750,16700,420,10,1,18145,12032,231,189
110100,016580,16700,2,400,2.45,114.42,46387,53076,6689,789,464,-325,103161,16700,16700,16700,0,0,0,18145,12032,0,0
110100,016580,16700,2,400,2.45,113.92,46589,53076,6487,793,464,-329,103363,16700,16700,16700,202,4,0,18140,11853,202,0
110200,016580,16700,2,400,2.45,113.85,46620,53076,6456,795,464,-331,103394,16700,16700,16700,0,0,0,18140,11793,0,0
110200,016580,16700,2,400,2.45,112.91,47009,53076,6067,799,464,-335,103783,16700,16700,16700,389,4,0,18010,12031,389,0
110300,016580,16700,2,400,2.45,112.82,47046,53076,6030,804,464,-340,103820,16700,16700,16700,12,3,0,18060,11949,12,0
110300,016580,16750,2,450,2.76,112.9,47046,53116,6070,804,466,-338,103860,16700,16750,16700,52,3,2,18065,12447,12,40
110400,016580,16700,2,400,2.45,112.6,47173,53116,5943,811,466,-345,103987,16700,16700,16700,27,2,0,18059,12325,27,0
110400,016580,16700,2,400,2.45,111.61,47592,53116,5524,813,466,-347,104406,16700,16700,16700,446,4,0,18059,12027,446,0
110500,016580,16700,2,400,2.45,111.61,47592,53116,5524,813,466,-347,104406,16700,16700,16700,0,0,0,18059,12027,0,0
110500,016580,16700,2,400,2.45,111.61,47592,53116,5524,813,466,-347,104406,16700,16700,16700,0,0,0,18059,12027,0,0
110600,016580,16700,2,400,2.45,111.49,47643,53116,5473,819,466,-353,104457,16700,16700,16700,12,2,0,18268,12023,12,0
110600,016580,16650,2,350,2.15,111.26,47741,53116,5375,824,466,-358,104555,16700,16700,16650,110,7,0,12715,12532,110,0
110700,016580,16650,2,350,2.15,111.03,47840,53116,5276,829,466,-363,104654,16650,16650,16650,0,0,0,12715,12443,0,0
110700,016580,16650,2,350,2.15,110.96,47868,53116,5248,831,466,-365,104682,16650,16650,16650,28,2,0,12731,12408,28,0
110800,016580,16650,2,350,2.15,110.96,47868,53116,5248,831,466,-365,104682,16650,16650,16650,0,0,0,12731,12408,0,0
110800,016580,16650,2,350,2.15,110.91,47893,53116,5223,833,466,-367,104707,16650,16650,16650,25,2,0,13151,12402,25,0
110900,016580,16650,2,350,2.15,110.91,47893,53116,5223,833,466,-367,104707,16650,16650,16650,0,0,0,13151,12402,0,0
110900,016580,16650,2,350,2.15,110.56,48042,53116,5074,838,466,-372,104856,16650,16650,16650,149,5,0,13178,12202,149,0
111000,016580,16650,2,350,2.15,110.37,48125,53116,4991,845,466,-379,104939,16650,16650,16650,77,6,0,13178,12144,77,0
111000,016580,16650,2,350,2.15,110.35,48135,53116,4981,847,466,-381,104949,16650,16650,16650,87,8,0,13178,12566,87,0
111100,016580,16650,2,350,2.15,110.35,48135,53116,4981,847,466,-381,104949,16650,16650,16650,0,0,0,13178,12566,0,0
111100,016580,16650,2,350,2.15,110.28,48189,53145,4956,851,467,-384,105032,16650,16700,16650,83,4,1,13141,12535,54,29
111200,016580,16650,2,350,2.15,110.28,48189,53145,4956,851,467,-384,105032,16650,16650,16650,0,0,0,13141,12535,0,0
111200,016580,16650,2,350,2.15,110.22,48217,53145,4928,853,467,-386,105060,16650,16650,16650,28,2,0,13161,12508,28,0
111300,016580,16650,2,350,2.15,110.05,48293,53145,4852,857,467,-390,105136,16650,16650,16650,63,2,0,13161,12985,63,0
111300,016580,16650,2,350,2.15,110.04,48295,53145,4850,858,467,-391,105138,16650,16650,16650,65,3,0,13161,13002,65,0
111400,016580,16650,2,350,2.15,110.04,48295,53145,4850,858,467,-391,105138,16650,16650,16650,0,0,0,13161,13002,0,0
111400,016580,16650,2,350,2.15,109.96,48330,53145,4815,862,467,-395,105173,16650,16650,16650,35,4,0,13161,12965,35,0
111500,016580,16650,2,350,2.15,109.9,48358,53145,4787,864,467,-397,105201,16650,16650,16650,28,2,0,13161,12972,28,0
111500,016580,16650,2,350,2.15,109.84,48385,53145,4760,866,467,-399,105228,16650,16650,16650,55,4,0,13161,12944,55,0
111600,016580,16650,2,350,2.15,109.84,48385,53145,4760,866,467,-399,105228,16650,16650,16650,0,0,0,13161,12944,0,0
111600,016580,16650,2,350,2.15,109.57,48521,53164,4643,870,468,-402,105383,16650,16700,16650,155,4,1,13256,12865,136,19
111700,016580,16650,2,350,2.15,109.56,48524,53164,4640,871,468,-403,105386,16650,16650,16650,3,1,0,13398,12807,3,0
111800,016580,16650,2,350,2.15,109.51,48549,53164,4615,873,468,-405,105411,16650,16650,16650,0,0,0,13398,12784,0,0
111800,016580,16650,2,350,2.15,109.42,48586,53164,4578,877,468,-409,105448,16650,16650,16650,37,4,0,14898,12304,37,0
111900,016580,16650,2,350,2.15,109.36,48613,53164,4551,879,468,-411,105475,16650,16650,16650,0,0,0,14898,12276,0,0
111900,016580,16650,2,350,2.15,109.36,48613,53164,4551,879,468,-411,105475,16650,16650,16650,0,0,0,14898,12276,0,0
112000,016580,16650,2,350,2.15,109.2,48687,53164,4477,882,468,-414,105549,16650,16650,16650,11,1,0,14898,12223,11,0
112000,016580,16650,2,350,2.15,109.13,48714,53164,4450,885,468,-417,105576,16650,16650,16650,38,4,0,14898,12378,38,0
112100,016580,16650,2,350,2.15,109.13,48718,53164,4446,887,468,-419,105580,16650,16650,16650,0,0,0,14898,12351,0,0
112100,016580,16650,2,350,2.15,109.11,48754,53196,4442,889,469,-420,105648,16700,16700,16650,68,2,1,14869,12328,36,32
112200,016580,16650,2,350,2.15,109.09,48762,53196,4434,890,469,-421,105656,16650,16650,16650,8,1,0,15194,12314,8,0
112200,016580,16650,2,350,2.15,109.09,48764,53196,4432,891,469,-422,105658,16650,16650,16650,10,2,0,15194,12306,10,0
112300,016580,16650,2,350,2.15,108.61,48980,53196,4216,897,469,-428,105874,16650,16650,16650,125,2,0,15094,12060,125,0
112300,016580,16650,2,350,2.15,108.53,49016,53196,4180,900,469,-431,105910,16650,16650,16650,161,5,0,15334,12010,161,0
112400,016580,16650,2,350,2.15,108.47,49041,53196,4155,902,469,-433,105935,16650,16650,16650,22,1,0,15334,12032,22,0
112400,016580,16650,2,350,2.15,108.45,49049,53196,4147,905,469,-436,105943,16650,16650,16650,30,4,0,15334,12495,30,0
112500,016580,16700,2,400,2.45,108.46,49049,53198,4149,905,470,-435,105945,16700,16700,16700,0,0,0,15334,12497,0,0
112500,016580,16700,2,400,2.45,108.46,49049,53198,4149,905,470,-435,105945,16700,16700,16700,0,0,0,15334,12497,0,0
112600,016580,16650,2,350,2.15,108.3,49122,53198,4076,909,470,-439,106018,16650,16650,16650,63,2,0,15332,12237,63,0
112600,016580,16650,2,350,2.15,108.18,49174,53198,4024,913,470,-443,106070,16650,16650,16650,115,6,0,15352,12077,115,0
112700,016580,16650,2,350,2.15,107.12,49663,53198,3535,925,470,-455,106559,16650,16650,16650,259,6,0,15315,11586,259,0
112700,016580,16650,2,350,2.15,107.12,49663,53198,3535,925,470,-455,106559,16650,16650,16650,259,6,0,15315,11586,259,0
112800,016580,16650,2,350,2.15,107.11,49667,53198,3531,927,470,-457,106563,16650,16650,16650,4,2,0,15355,11585,4,0
112800,016580,16650,2,350,2.15,107.11,49667,53198,3531,927,470,-457,106563,16650,16650,16650,4,2,0,15355,11585,4,0
112900,016580,16650,2,350,2.15,107.0,49718,53198,3480,932,470,-462,106614,16650,16650,16650,51,5,0,15142,11688,51,0
112900,016580,16650,2,350,2.15,106.77,49827,53198,3371,938,470,-468,106723,16650,16650,16650,160,11,0,15142,11716,160,0
113000,016580,16650,2,350,2.15,106.71,49854,53198,3344,940,470,-470,106750,16650,16650,16650,0,0,0,15162,11992,0,0
113000,016580,16650,2,350,2.15,106.62,49895,53198,3303,944,470,-474,106791,16650,16650,16650,41,4,0,15182,11970,41,0
113100,016580,16650,2,350,2.15,106.62,49895,53198,3303,944,470,-474,106791,16650,16650,16650,0,0,0,15182,11970,0,0
113100,016580,16650,2,350,2.15,106.61,49898,53198,3300,946,470,-476,106794,16650,16650,16650,3,2,0,15202,12076,3,0
113200,016580,16600,2,300,1.84,105.38,50484,53198,2714,951,470,-481,107380,16650,16650,16600,586,5,0,13138,11668,586,0
113200,016580,16600,2,300,1.84,103.12,51587,53198,1611,956,470,-486,108483,16650,16650,16600,1689,10,0,13133,10565,1689,0
113300,016580,16600,2,300,1.84,103.12,51587,53198,1611,956,470,-486,108483,16600,16600,16600,0,0,0,13133,10565,0,0
113300,016580,16600,2,300,1.84,103.1,51596,53198,1602,958,470,-488,108492,16600,16600,16600,9,2,0,13138,10554,9,0
113400,016580,16600,2,300,1.84,103.02,51640,53198,1558,962,470,-492,108536,16600,16600,16600,44,4,0,13138,10623,44,0
113400,016580,16600,2,300,1.84,100.94,52724,53222,498,966,471,-495,109644,16600,16600,16550,1152,8,1,11498,10557,1128,24
113500,016580,16550,2,250,1.53,100.93,52753,53241,488,970,472,-498,109692,16550,16550,16550,4,2,0,11455,10502,4,0
113500,016580,16550,2,250,1.53,100.75,52843,53241,398,973,472,-501,109782,16550,16550,16550,94,5,0,11455,10429,94,0
113600,016580,16550,2,250,1.53,100.75,52843,53241,398,973,472,-501,109782,16550,16550,16550,0,0,0,11455,10429,0,0
113600,016580,16550,2,250,1.53,100.75,52843,53241,398,973,472,-501,109782,16550,16550,16550,0,0,0,11455,10429,0,0
113700,016580,16550,2,250,1.53,100.73,52853,53241,388,975,472,-503,109792,16550,16550,16550,10,2,0,11945,10823,10,0
113800,016580,16550,2,250,1.53,100.67,52919,53271,352,981,473,-508,109888,16550,16550,16550,0,0,0,11938,11760,0,0
113800,016580,16550,2,250,1.53,100.62,52941,53271,330,982,473,-509,109910,16550,16550,16550,22,1,0,12136,11955,22,0
113900,016580,16550,2,250,1.53,100.41,53076,53292,216,986,474,-512,110066,16550,16550,16550,0,0,0,12056,11811,0,0
113900,016580,16550,2,250,1.53,100.41,53076,53292,216,986,474,-512,110066,16550,16550,16550,0,0,0,12056,11811,0,0
114000,016580,16550,2,250,1.53,100.38,53089,53292,203,988,474,-514,110079,16550,16550,16550,13,2,0,12028,11827,13,0
114000,016580,16550,2,250,1.53,100.38,53090,53292,202,989,474,-515,110080,16550,16550,16550,14,3,0,12028,11824,14,0
114100,016580,16550,2,250,1.53,100.31,53125,53292,167,993,474,-519,110115,16550,16550,16550,10,2,0,12028,11932,10,0
114100,016580,16550,2,250,1.53,99.76,53420,53292,-128,999,474,-525,110410,16550,16550,16550,305,8,0,12028,11640,305,0
114200,016580,16500,2,200,1.23,98.37,54246,53361,-885,1003,476,-527,111305,16550,16550,16500,803,3,0,12255,12075,803,0
114200,016580,16500,2,200,1.23,98.36,54249,53361,-888,1005,476,-529,111308,16550,16550,16500,806,5,0,12242,12060,806,0
114300,016580,16550,2,250,1.53,98.55,54249,53461,-788,1005,477,-528,111408,16550,16550,16550,0,0,0,12242,12060,0,0
114300,016580,16550,2,250,1.53,98.55,54249,53461,-788,1005,477,-528,111408,16550,16550,16550,0,0,0,12242,12060,0,0
114400,016580,16500,2,200,1.23,98.5,54274,53461,-813,1007,477,-530,111433,16500,16500,16500,0,0,0,12147,11080,0,0
114400,016580,16500,2,200,1.23,98.45,54302,53461,-841,1009,477,-532,111461,16500,16500,16500,28,2,0,12147,12569,28,0
114500,016580,16500,2,200,1.23,98.41,54325,53461,-864,1013,477,-536,111484,16500,16500,16500,0,0,0,12147,12544,0,0
114500,016580,16500,2,200,1.23,98.25,54415,53461,-954,1017,477,-540,111574,16500,16500,16500,90,4,0,12247,12565,90,0
114600,016580,16500,2,200,1.23,98.24,54419,53461,-958,1019,477,-542,111578,16500,16500,16500,4,2,0,12311,12556,4,0
114600,016580,16500,2,200,1.23,98.23,54445,53482,-963,1021,478,-543,111625,16500,16550,16500,51,4,1,12295,12535,30,21
114700,016580,16500,2,200,1.23,98.18,54472,53482,-990,1023,478,-545,111652,16500,16500,16500,27,2,0,12289,10552,27,0
114700,016580,16550,2,250,1.53,98.36,54472,53577,-895,1023,479,-544,111747,16500,16550,16500,122,2,1,12294,10452,27,95
114800,016580,16550,2,250,1.53,98.45,54486,53643,-843,1024,481,-543,111827,16550,16550,16550,80,1,2,12969,9704,14,66
114800,016580,16500,2,200,1.23,98.31,54567,53643,-924,1030,481,-549,111908,16550,16550,16500,161,7,2,12045,10171,95,66
114900,016580,16500,2,200,1.23,98.26,54595,53643,-952,1032,481,-551,111936,16500,16500,16500,28,2,0,12045,10147,28,0
114900,016580,16500,2,200,1.23,98.21,54623,53643,-980,1035,481,-554,111964,16500,16500,16500,56,5,0,12045,10116,56,0
115000,016580,16500,2,200,1.23,98.16,54651,53643,-1008,1037,481,-556,111992,16500,16500,16500,28,2,0,12045,10071,28,0
115000,016580,16500,2,200,1.23,98.16,54651,53643,-1008,1037,481,-556,111992,16500,16500,16500,28,2,0,12045,10071,28,0
115100,016580,16500,2,200,1.23,98.16,54651,53643,-1008,1037,481,-556,111992,16500,16500,16500,0,0,0,12045,10071,0,0
115100,016580,16500,2,200,1.23,98.04,54713,53643,-1070,1039,481,-558,112054,16500,16500,16500,62,2,0,12052,10062,62,0
115200,016580,16500,2,200,1.23,98.02,54727,53643,-1084,1041,481,-560,112068,16500,16500,16500,14,2,0,12052,10054,14,0
115200,016580,16500,2,200,1.23,97.91,54790,53643,-1147,1047,481,-566,112131,16500,16500,16500,77,8,0,12552,9995,77,0
115300,016580,16500,2,200,1.23,97.85,54821,53643,-1178,1051,481,-570,112162,16500,16500,16500,31,4,0,12552,9989,31,0
115300,016580,16500,2,200,1.23,97.85,54821,53643,-1178,1051,481,-570,112162,16500,16500,16500,31,4,0,12552,9989,31,0
115400,016580,16500,2,200,1.23,97.8,54850,53643,-1207,1053,481,-572,112191,16500,16500,16500,29,2,0,12552,9965,29,0
115500,016580,16550,2,250,1.53,97.74,54900,53661,-1239,1054,482,-572,112259,16550,16550,16550,0,0,0,12552,10382,0,0
115500,016580,16500,2,200,1.23,97.7,54925,53661,-1264,1056,482,-574,112284,16500,16500,16500,25,2,0,12634,10961,25,0
115600,016580,16500,2,200,1.23,97.62,54968,53661,-1307,1060,482,-578,112327,16500,16500,16500,0,0,0,12634,10919,0,0
115600,016580,16500,2,200,1.23,97.61,54977,53661,-1316,1062,482,-580,112336,16500,16500,16500,9,2,0,12634,10906,9,0
115700,016580,16500,2,200,1.23,97.59,55008,53680,-1328,1065,483,-582,112386,16500,16500,16500,0,0,0,12620,10826,0,0
115700,016580,16500,2,200,1.23,97.59,55008,53680,-1328,1065,483,-582,112386,16500,16500,16500,0,0,0,12620,10826,0,0
115800,016580,16500,2,200,1.23,97.48,55070,53680,-1390,1067,483,-584,112448,16500,16500,16500,62,2,0,12642,10785,62,0
115800,016580,16500,2,200,1.23,97.43,55095,53680,-1415,1069,483,-586,112473,16500,16500,16500,87,4,0,12642,10753,87,0
115900,016580,16500,2,200,1.23,95.98,55948,53701,-2247,1073,484,-589,113347,16500,16500,16500,0,0,0,12621,10106,0,0
115900,016580,16500,2,200,1.23,95.96,55961,53701,-2260,1075,484,-591,113360,16500,16500,16500,13,2,0,12622,9990,13,0
120000,016580,16500,2,200,1.23,95.24,56383,53701,-2682,1078,484,-594,113782,16500,16500,16500,422,3,0,12855,10418,422,0
120000,016580,16450,2,150,0.92,94.41,56883,53701,-3182,1084,484,-600,114282,16500,16500,16450,922,9,0,8146,12714,922,0
120100,016580,16450,2,150,0.92,94.36,56911,53701,-3210,1086,484,-602,114310,16450,16450,16450,0,0,0,8148,12789,0,0
120100,016580,16450,2,150,0.92,94.17,57026,53701,-3325,1091,484,-607,114425,16450,16450,16450,115,5,0,8698,12668,115,0
120200,016580,16450,2,150,0.92,93.8,57270,53719,-3551,1095,485,-610,114687,16450,16450,16450,4,1,0,8698,12403,4,0
120200,016580,16450,2,150,0.92,93.78,57284,53719,-3565,1097,485,-612,114701,16450,16450,16450,18,3,0,8694,12438,18,0
120300,016580,16450,2,150,0.92,93.78,57284,53719,-3565,1097,485,-612,114701,16450,16450,16450,0,0,0,8694,12438,0,0
120300,016580,16450,2,150,0.92,93.78,57284,53719,-3565,1097,485,-612,114701,16450,16450,16450,0,0,0,8694,12438,0,0
120400,016580,16450,2,150,0.92,93.75,57322,53741,-3581,1102,486,-616,114761,16450,16500,16450,47,2,1,8677,12609,25,22
120400,016580,16450,2,150,0.92,93.76,57422,53841,-3581,1106,488,-618,114961,16450,16500,16450,247,6,3,8595,12539,125,122
120500,016580,16450,2,150,0.92,93.76,57422,53841,-3581,1106,488,-618,114961,16450,16450,16450,0,0,0,8595,12539,0,0
120500,016580,16450,2,150,0.92,93.81,57431,53877,-3554,1107,489,-618,115006,16500,16500,16450,45,1,1,8568,12319,9,36
120600,016580,16450,2,150,0.92,93.79,57445,53877,-3568,1109,489,-620,115020,16450,16450,16450,14,2,0,8559,12537,14,0
120600,016580,16550,2,250,1.53,93.94,57445,53965,-3480,1109,491,-618,115108,16450,16550,16450,102,2,2,13187,12481,14,88
120700,016580,16500,2,200,1.23,93.86,57498,53969,-3529,1113,492,-621,115165,16500,16550,16500,57,4,1,13174,9797,53,4
120700,016580,16500,2,200,1.23,93.75,57577,53979,-3598,1120,493,-627,115254,16500,16550,16500,146,11,2,13164,9734,132,14
120800,016580,16500,2,200,1.23,93.71,57601,53979,-3622,1122,493,-629,115278,16500,16500,16500,24,2,0,13164,9709,24,0
120800,016580,16450,2,150,0.92,93.71,57602,53979,-3623,1123,493,-630,115279,16500,16500,16450,25,3,0,8484,12284,25,0
120900,016580,16500,2,200,1.23,93.79,57602,54024,-3578,1123,495,-628,115324,16500,16500,16500,8,0,1,8488,12423,0,8
120900,016580,16500,2,200,1.23,93.79,57602,54024,-3578,1123,495,-628,115324,16500,16500,16500,8,0,1,8488,12423,0,8
121000,016580,16450,2,150,0.92,93.7,57655,54024,-3631,1127,495,-632,115377,16450,16450,16450,28,2,0,8791,12602,28,0
121000,016580,16450,2,150,0.92,93.6,57718,54024,-3694,1129,495,-634,115440,16450,16450,16450,91,4,0,8791,12546,91,0
121100,016580,16450,2,150,0.92,93.6,57720,54024,-3696,1130,495,-635,115442,16450,16450,16450,2,1,0,8812,12533,2,0
121100,016580,16450,2,150,0.92,93.58,57729,54024,-3705,1132,495,-637,115451,16450,16450,16450,11,3,0,8812,12298,11,0
121200,016580,16400,2,100,0.61,96.6,58303,56319,-1984,1141,503,-638,118320,16450,16550,16400,2869,9,8,6475,11008,574,2295
121300,016580,16450,2,150,0.92,96.54,58337,56319,-2018,1144,503,-641,118354,16450,16450,16450,0,0,0,8564,10135,0,0
121300,016580,16450,2,150,0.92,96.26,58505,56319,-2186,1150,503,-647,118522,16450,16450,16450,168,6,0,9231,12117,168,0
121400,016580,16400,2,100,0.61,96.16,58567,56319,-2248,1152,503,-649,118584,16400,16400,16400,62,2,0,9231,14450,62,0
121400,016580,16400,2,100,0.61,96.16,58569,56319,-2250,1154,503,-651,118586,16400,16400,16400,64,4,0,9231,14437,64,0
121500,016580,16400,2,100,0.61,96.16,58569,56319,-2250,1154,503,-651,118586,16400,16400,16400,0,0,0,9231,14437,0,0
121500,016580,16400,2,100,0.61,96.15,58580,56324,-2256,1157,504,-653,118602,16400,16450,16400,16,3,1,7013,14697,11,5
121600,016580,16400,2,100,0.61,96.06,58632,56324,-2308,1161,504,-657,118654,16400,16400,16400,0,0,0,7044,14749,0,0
121600,016580,16400,2,100,0.61,96.06,58632,56324,-2308,1161,504,-657,118654,16400,16400,16400,0,0,0,7044,14749,0,0
121700,016580,16400,2,100,0.61,96.04,58644,56324,-2320,1163,504,-659,118666,16400,16400,16400,0,0,0,7044,15390,0,0
121700,016580,16450,2,150,0.92,96.0,58694,56346,-2348,1164,506,-658,118738,16450,16450,16400,72,1,2,6339,15424,50,22
121800,016580,16450,2,150,0.92,96.0,58694,56346,-2348,1164,506,-658,118738,16450,16450,16450,0,0,0,6339,15424,0,0
121800,016580,16450,2,150,0.92,95.99,58697,56346,-2351,1165,506,-659,118741,16450,16450,16450,3,1,0,8515,14580,3,0
121900,016580,16450,2,150,0.92,95.91,58747,56346,-2401,1168,506,-662,118791,16450,16450,16450,8,1,0,8515,14743,8,0
121900,016580,16450,2,150,0.92,95.88,58769,56346,-2423,1169,506,-663,118813,16450,16450,16450,30,2,0,8515,14775,30,0
122000,016580,16450,2,150,0.92,95.88,58769,56346,-2423,1169,506,-663,118813,16450,16450,16450,0,0,0,8515,14775,0,0
122000,016580,16450,2,150,0.92,95.78,58830,56346,-2484,1171,506,-665,118874,16450,16450,16450,61,2,0,8515,12668,61,0
122100,016580,16450,2,150,0.92,95.78,58830,56346,-2484,1171,506,-665,118874,16450,16450,16450,0,0,0,8515,12668,0,0
122100,016580,16450,2,150,0.92,95.7,58875,56346,-2529,1174,506,-668,118919,16450,16450,16450,45,3,0,8705,12614,45,0
122200,016580,16450,2,150,0.92,95.7,58875,56346,-2529,1174,506,-668,118919,16450,16450,16450,0,0,0,8705,12614,0,0
122200,016580,16450,2,150,0.92,95.7,58875,56346,-2529,1174,506,-668,118919,16450,16450,16450,0,0,0,8705,12614,0,0
122300,016580,16450,2,150,0.92,95.69,58882,56346,-2536,1175,506,-669,118926,16450,16450,16450,0,0,0,8705,12612,0,0
122300,016580,16450,2,150,0.92,95.57,58955,56346,-2609,1177,506,-671,118999,16450,16450,16450,73,2,0,8705,12702,73,0
122400,016580,16450,2,150,0.92,95.09,59255,56346,-2909,1179,506,-673,119299,16450,16450,16450,289,1,0,8705,12841,289,0
122400,016580,16400,2,100,0.61,95.02,59297,56346,-2951,1181,506,-675,119341,16450,16450,16400,331,3,0,6833,13444,331,0
122500,016580,16450,2,150,0.92,95.4,59300,56575,-2725,1182,509,-673,119573,16450,16450,16450,3,1,0,8987,14309,3,0
122500,016580,16450,2,150,0.92,95.41,59396,56669,-2727,1183,510,-673,119763,16450,16450,16450,193,2,1,6708,14929,99,94
122600,016580,16500,2,200,1.23,95.32,59449,56669,-2780,1185,510,-675,119816,16450,16500,16450,53,2,0,13515,12294,53,0
122600,016580,16450,2,150,0.92,95.22,59511,56669,-2842,1188,510,-678,119878,16450,16500,16450,115,5,0,8640,14455,115,0
122700,016580,16450,2,150,0.92,95.1,59591,56669,-2922,1194,510,-684,119958,16450,16450,16450,80,6,0,8894,14218,80,0
122700,016580,16450,2,150,0.92,95.07,59605,56669,-2936,1196,510,-686,119972,16450,16450,16450,94,8,0,8894,14220,94,0
122800,016580,16450,2,150,0.92,95.07,59605,56669,-2936,1196,510,-686,119972,16450,16450,16450,0,0,0,8894,14220,0,0
122900,016580,16450,2,150,0.92,95.07,59609,56669,-2940,1198,510,-688,119976,16450,16450,16450,0,0,0,8834,15964,0,0
122900,016580,16450,2,150,0.92,95.07,59609,56669,-2940,1198,510,-688,119976,16450,16450,16450,0,0,0,8834,15964,0,0
123000,016580,16450,2,150,0.92,94.97,59671,56669,-3002,1200,510,-690,120038,16450,16450,16450,0,0,0,8845,15953,0,0
123000,016580,16450,2,150,0.92,94.87,59734,56669,-3065,1206,510,-696,120101,16450,16450,16450,63,6,0,8845,15786,63,0
123100,016580,16450,2,150,0.92,94.83,59756,56669,-3087,1207,510,-697,120123,16450,16450,16450,22,1,0,8845,15926,22,0
123100,016580,16450,2,150,0.92,94.8,59776,56669,-3107,1210,510,-700,120143,16450,16450,16450,42,4,0,8845,15884,42,0
123200,016580,16450,2,150,0.92,94.73,59820,56669,-3151,1212,510,-702,120187,16450,16450,16450,0,0,0,8845,15849,0,0
123200,016580,16450,2,150,0.92,94.73,59822,56669,-3153,1213,510,-703,120189,16450,16450,16450,2,1,0,8845,15840,2,0
123300,016580,16450,2,150,0.92,94.73,59822,56669,-3153,1213,510,-703,120189,16450,16450,16450,0,0,0,8845,15840,0,0
123300,016580,16450,2,150,0.92,94.55,59937,56669,-3268,1218,510,-708,120304,16450,16450,16450,115,5,0,8845,15743,115,0
123400,016580,16450,2,150,0.92,94.55,59937,56669,-3268,1218,510,-708,120304,16450,16450,16450,0,0,0,8845,15743,0,0
123400,016580,16450,2,150,0.92,94.51,59961,56669,-3292,1224,510,-714,120328,16450,16450,16450,24,6,0,8845,15717,24,0
123500,016580,16450,2,150,0.92,94.46,59990,56669,-3321,1226,510,-716,120357,16450,16450,16450,0,0,0,8855,15741,0,0
123500,016580,16450,2,150,0.92,94.46,59990,56669,-3321,1226,510,-716,120357,16450,16450,16450,0,0,0,8855,15741,0,0
123600,016580,16450,2,150,0.92,94.38,60041,56669,-3372,1231,510,-721,120408,16450,16450,16450,51,5,0,8855,15928,51,0
123600,016580,16450,2,150,0.92,94.28,60109,56669,-3440,1234,510,-724,120476,16450,16450,16450,119,8,0,8855,16103,119,0
123700,016580,16500,2,200,1.23,94.31,60109,56688,-3421,1234,511,-723,120495,16500,16500,16500,19,0,1,8855,16074,0,19
123700,016580,16500,2,200,1.23,94.3,60112,56688,-3424,1235,511,-724,120498,16500,16500,16500,22,1,1,13519,13882,3,19
123800,016580,16500,2,200,1.23,94.27,60136,56688,-3448,1239,511,-728,120522,16500,16500,16500,24,4,0,13528,13782,24,0
123800,016580,16550,2,250,1.53,94.26,60158,56707,-3451,1240,512,-728,120563,16500,16550,16500,65,5,1,13617,13763,46,19
123900,016580,16500,2,200,1.23,94.18,60210,56707,-3503,1244,512,-732,120615,16500,16500,16500,24,2,0,13539,13721,24,0
123900,016580,16500,2,200,1.23,94.09,60345,56777,-3568,1249,513,-736,120820,16500,16550,16500,229,7,1,13507,13567,159,70
124000,016580,16500,2,200,1.23,94.09,60345,56777,-3568,1249,513,-736,120820,16500,16500,16500,0,0,0,13507,13567,0,0
124000,016580,16550,2,250,1.53,94.09,60345,56779,-3566,1249,514,-735,120822,16550,16550,16550,2,0,1,13507,13567,0,2
124100,016580,16550,2,250,1.53,94.13,60348,56805,-3543,1250,515,-735,120851,16550,16550,16550,29,1,1,14411,12219,3,26
124100,016580,16500,2,200,1.23,93.8,60559,56805,-3754,1254,515,-739,121062,16550,16550,16500,240,5,1,13599,13876,214,26
124200,016580,16500,2,200,1.23,93.75,60594,56805,-3789,1258,515,-743,121097,16500,16500,16500,25,2,0,13599,13841,25,0
124200,016580,16500,2,200,1.23,93.61,60685,56805,-3880,1262,515,-747,121188,16500,16500,16500,116,6,0,13599,13660,116,0
124300,016580,16550,2,250,1.53,93.68,60688,56855,-3833,1264,516,-748,121241,16500,16550,16500,53,2,1,13599,14095,3,50
124300,016580,16550,2,250,1.53,93.37,60890,56855,-4035,1266,516,-750,121443,16500,16550,16500,255,4,1,14622,12337,205,50
124400,016580,16500,2,200,1.23,93.26,60965,56857,-4108,1268,517,-751,121520,16550,16550,16500,77,2,1,13673,14068,75,2
124400,016580,16500,2,200,1.23,93.18,61018,56857,-4161,1272,517,-755,121573,16550,16550,16500,130,6,1,13673,14515,128,2
124500,016580,16500,2,200,1.23,93.16,61032,56857,-4175,1274,517,-757,121587,16500,16500,16500,14,2,0,13473,14499,14,0
124600,016580,16500,2,200,1.23,93.05,61104,56857,-4247,1278,517,-761,121659,16500,16500,16500,0,0,0,13473,14457,0,0
124600,016580,16500,2,200,1.23,93.01,61132,56857,-4275,1280,517,-763,121687,16500,16500,16500,28,2,0,13473,14422,28,0
124700,016580,16500,2,200,1.23,93.07,61135,56899,-4236,1281,518,-763,121732,16500,16500,16500,0,0,0,13288,13771,0,0
124700,016580,16500,2,200,1.23,93.03,61163,56899,-4264,1283,518,-765,121760,16500,16500,16500,28,2,0,13288,13746,28,0
124800,016580,16500,2,200,1.23,92.99,61188,56899,-4289,1285,518,-767,121785,16500,16500,16500,0,0,0,13308,13720,0,0
124800,016580,16500,2,200,1.23,92.99,61188,56899,-4289,1285,518,-767,121785,16500,16500,16500,0,0,0,13308,13720,0,0
124900,016580,16500,2,200,1.23,92.97,61203,56899,-4304,1287,518,-769,121800,16500,16500,16500,0,0,0,13308,13979,0,0
124900,016580,16500,2,200,1.23,92.86,61274,56899,-4375,1291,518,-773,121871,16500,16500,16500,71,4,0,13308,13928,71,0
125000,016580,16550,2,250,1.53,92.78,61329,56900,-4429,1295,519,-776,121927,16500,16550,16500,28,2,1,13308,13591,27,1
125000,016580,16500,2,200,1.23,92.73,61359,56900,-4459,1298,519,-779,121957,16500,16550,16500,58,5,1,13316,13602,57,1
125100,016580,16500,2,200,1.23,92.7,61384,56900,-4484,1300,519,-781,121982,16500,16500,16500,0,0,0,13316,13576,0,0
125100,016580,16500,2,200,1.23,92.7,61384,56900,-4484,1300,519,-781,121982,16500,16500,16500,0,0,0,13316,13576,0,0
125200,016580,16500,2,200,1.23,92.7,61384,56900,-4484,1300,519,-781,121982,16500,16500,16500,0,0,0,13336,13550,0,0
125200,016580,16500,2,200,1.23,92.75,61463,57004,-4459,1305,520,-785,122165,16550,16550,16500,183,5,1,13186,13538,79,104
125300,016580,16500,2,200,1.23,92.64,61535,57004,-4531,1307,520,-787,122237,16500,16500,16500,72,2,0,13186,13477,72,0
125300,016580,16500,2,200,1.23,92.57,61597,57018,-4579,1313,521,-792,122313,16500,16550,16500,148,8,1,14302,13406,134,14
125400,016580,16500,2,200,1.23,92.56,61601,57018,-4583,1315,521,-794,122317,16500,16500,16500,0,0,0,13266,13448,0,0
125400,016580,16500,2,200,1.23,92.56,61601,57018,-4583,1315,521,-794,122317,16500,16500,16500,0,0,0,13266,13448,0,0
125500,016580,16500,2,200,1.23,92.56,61601,57018,-4583,1315,521,-794,122317,16500,16500,16500,0,0,0,13266,13447,0,0
125500,016580,16500,2,200,1.23,92.47,61663,57018,-4645,1317,521,-796,122379,16500,16500,16500,62,2,0,13266,13397,62,0
125600,016580,16500,2,200,1.23,92.4,61706,57018,-4688,1321,521,-800,122422,16500,16500,16500,29,2,0,13266,13348,29,0
125600,016580,16500,2,200,1.23,92.37,61731,57018,-4713,1323,521,-802,122447,16500,16500,16500,54,4,0,13266,13122,54,0
125700,016580,16500,2,200,1.23,92.35,61741,57018,-4723,1325,521,-804,122457,16500,16500,16500,10,2,0,13266,13109,10,0
125700,016580,16500,2,200,1.23,92.3,61772,57018,-4754,1329,521,-808,122488,16500,16500,16500,41,6,0,13283,13101,41,0
125800,016580,16500,2,200,1.23,92.3,61772,57018,-4754,1329,521,-808,122488,16500,16500,16500,0,0,0,13283,13101,0,0
125800,016580,16500,2,200,1.23,92.21,61835,57018,-4817,1331,521,-810,122551,16500,16500,16500,63,2,0,13284,13046,63,0
125900,016580,16500,2,200,1.23,92.17,61862,57018,-4844,1333,521,-812,122578,16500,16500,16500,27,2,0,13221,13011,27,0
125900,016580,16500,2,200,1.23,92.11,61901,57018,-4883,1336,521,-815,122617,16500,16500,16500,66,5,0,13221,12975,66,0
130000,016580,16500,2,200,1.23,92.11,61901,57018,-4883,1336,521,-815,122617,16500,16500,16500,0,0,0,13221,12975,0,0
130100,016580,16500,2,200,1.23,92.1,61910,57018,-4892,1338,521,-817,122626,16500,16500,16500,0,0,0,13147,13062,0,0
130100,016580,16500,2,200,1.23,92.05,61940,57018,-4922,1341,521,-820,122656,16500,16500,16500,30,3,0,13156,13227,30,0
130200,016580,16500,2,200,1.23,91.92,62030,57018,-5012,1344,521,-823,122746,16500,16500,16500,0,0,0,13156,13255,0,0
130200,016580,16500,2,200,1.23,91.9,62041,57018,-5023,1345,521,-824,122757,16500,16500,16500,11,1,0,13156,13237,11,0
130300,016580,16450,2,150,0.92,91.88,62055,57018,-5037,1347,521,-826,122771,16450,16450,16450,14,2,0,8605,15712,14,0
130300,016580,16450,2,150,0.92,91.88,62055,57018,-5037,1347,521,-826,122771,16450,16450,16450,14,2,0,8605,15712,14,0
130400,016580,16450,2,150,0.92,91.88,62055,57018,-5037,1347,521,-826,122771,16450,16450,16450,0,0,0,8605,15712,0,0
130400,016580,16450,2,150,0.92,91.88,62055,57018,-5037,1347,521,-826,122771,16450,16450,16450,0,0,0,8806,15710,0,0
130500,016580,16450,2,150,0.92,91.7,62182,57018,-5164,1356,521,-835,122898,16450,16450,16450,86,3,0,8617,18276,86,0
130500,016580,16450,2,150,0.92,91.65,62213,57018,-5195,1359,521,-838,122929,16450,16450,16450,117,6,0,8617,18227,117,0
130600,016580,16450,2,150,0.92,91.44,62355,57018,-5337,1361,521,-840,123071,16450,16450,16450,142,2,0,8608,17987,142,0
130600,016580,16450,2,150,0.92,91.42,62369,57018,-5351,1363,521,-842,123085,16450,16450,16450,156,4,0,8633,18345,156,0
130700,016580,16450,2,150,0.92,91.42,62369,57018,-5351,1363,521,-842,123085,16450,16450,16450,0,0,0,8633,18345,0,0
130700,016580,16450,2,150,0.92,91.37,62403,57018,-5385,1367,521,-846,123119,16450,16450,16450,34,4,0,8633,18640,34,0
130800,016580,16450,2,150,0.92,91.24,62494,57018,-5476,1373,521,-852,123210,16450,16450,16450,91,6,0,8933,18544,91,0
130800,016580,16450,2,150,0.92,91.22,62504,57018,-5486,1375,521,-854,123220,16450,16450,16450,101,8,0,8933,18535,101,0
130900,016580,16500,2,200,1.23,90.9,62771,57057,-5714,1378,523,-855,123526,16450,16500,16450,42,1,1,8927,18296,22,20
130900,016580,16500,2,200,1.23,90.9,62771,57057,-5714,1378,523,-855,123526,16450,16500,16450,42,1,1,8927,18296,22,20
131000,016580,16450,2,150,0.92,90.88,62786,57057,-5729,1380,523,-857,123541,16450,16450,16450,15,2,0,8922,18284,15,0
131000,016580,16450,2,150,0.92,90.83,62814,57057,-5757,1382,523,-859,123569,16450,16450,16450,43,4,0,8922,18269,43,0
131100,016580,16450,2,150,0.92,90.8,62839,57057,-5782,1384,523,-861,123594,16450,16450,16450,25,2,0,8985,18243,25,0
131100,016580,16450,2,150,0.92,90.7,62904,57057,-5847,1388,523,-865,123659,16450,16450,16450,90,6,0,8992,18195,90,0
131200,016580,16450,2,150,0.92,90.69,62913,57057,-5856,1390,523,-867,123668,16450,16450,16450,9,2,0,8991,18243,9,0
131200,016580,16450,2,150,0.92,90.61,62970,57057,-5913,1394,523,-871,123725,16450,16450,16450,66,6,0,8979,17433,66,0
131300,016580,16450,2,150,0.92,90.03,63373,57057,-6316,1398,523,-875,124128,16450,16450,16450,403,4,0,8978,17150,403,0
131300,016580,16450,2,150,0.92,90.02,63386,57057,-6329,1400,523,-877,124141,16450,16450,16450,416,6,0,8961,17133,416,0
131400,016580,16500,2,200,1.23,90.0,63411,57067,-6344,1402,524,-878,124176,16450,16500,16450,35,2,1,8961,17626,25,10
131500,016580,16450,2,150,0.92,89.91,63474,57067,-6407,1404,524,-880,124239,16450,16450,16450,0,0,0,9043,17662,0,0
131500,016580,16450,2,150,0.92,89.9,63478,57067,-6411,1406,524,-882,124243,16450,16450,16450,4,2,0,9052,17772,4,0
131600,016580,16450,2,150,0.92,89.9,63478,57067,-6411,1406,524,-882,124243,16450,16450,16450,0,0,0,9052,17772,0,0
131600,016580,16450,2,150,0.92,89.85,63515,57067,-6448,1410,524,-886,124280,16450,16450,16450,37,4,0,9052,17739,37,0
131700,016580,16450,2,150,0.92,89.73,63598,57067,-6531,1416,524,-892,124363,16450,16450,16450,5,1,0,9263,17788,5,0
131700,016580,16450,2,150,0.92,89.71,63611,57067,-6544,1418,524,-894,124376,16450,16450,16450,18,3,0,9324,17772,18,0
131800,016580,16450,2,150,0.92,89.62,63674,57067,-6607,1420,524,-896,124439,16450,16450,16450,0,0,0,9316,17720,0,0
131800,016580,16450,2,150,0.92,89.08,64061,57067,-6994,1422,524,-898,124826,16450,16450,16450,387,2,0,9316,17397,387,0
131900,016580,16450,2,150,0.92,89.04,64093,57067,-7026,1426,524,-902,124858,16450,16450,16450,32,4,0,9316,17316,32,0
131900,016580,16450,2,150,0.92,89.04,64093,57067,-7026,1426,524,-902,124858,16450,16450,16450,32,4,0,9316,17316,32,0
132000,016580,16450,2,150,0.92,88.99,64128,57067,-7061,1430,524,-906,124893,16450,16450,16450,0,0,0,9416,17387,0,0
132000,016580,16400,2,100,0.61,88.86,64224,57071,-7153,1435,525,-910,124993,16450,16450,16400,100,5,1,7536,18173,96,4
132100,016580,16450,2,150,0.92,88.84,64285,57114,-7171,1439,528,-911,125097,16450,16450,16450,82,1,2,7462,18227,46,36
132100,016580,16400,2,100,0.61,88.84,64289,57114,-7175,1441,528,-913,125101,16450,16450,16400,86,3,2,7446,18224,50,36
132200,016580,16450,2,150,0.92,88.76,64364,57128,-7236,1445,530,-915,125190,16450,16450,16450,82,4,1,7728,18153,75,7
132200,016580,16400,2,100,0.61,88.72,64391,57128,-7263,1448,530,-918,125217,16450,16450,16400,109,7,1,8321,18701,102,7
132300,016580,16450,2,150,0.92,88.73,64391,57135,-7256,1448,532,-916,125224,16450,16450,16450,7,0,2,8317,18696,0,7
132300,016580,16450,2,150,0.92,88.74,64391,57143,-7248,1448,534,-914,125232,16450,16450,16450,15,0,4,8322,18696,0,15
132400,016580,16400,2,100,0.61,88.64,64468,57144,-7324,1452,535,-917,125310,16400,16400,16400,77,4,0,8280,18622,77,0
132400,016580,16400,2,100,0.61,88.64,64468,57144,-7324,1452,535,-917,125310,16400,16400,16400,77,4,0,8280,18622,77,0
132500,016580,16400,2,100,0.61,88.6,64495,57144,-7351,1454,535,-919,125337,16400,16400,16400,0,0,0,8280,18603,0,0
132500,016580,16400,2,100,0.61,88.57,64520,57144,-7376,1456,535,-921,125362,16400,16400,16400,25,2,0,8287,18610,25,0
132600,016580,16400,2,100,0.61,88.56,64524,57144,-7380,1458,535,-923,125366,16400,16400,16400,4,2,0,8287,18602,4,0
132600,016580,16400,2,100,0.61,88.56,64524,57144,-7380,1458,535,-923,125366,16400,16400,16400,4,2,0,8287,18602,4,0
132700,016580,16400,2,100,0.61,88.48,64586,57144,-7442,1460,535,-925,125428,16400,16400,16400,62,2,0,8285,18741,62,0
132700,016580,16400,2,100,0.61,88.38,64660,57144,-7516,1467,535,-932,125502,16400,16400,16400,136,9,0,8293,18677,136,0
132800,016580,16400,2,100,0.61,88.37,64666,57144,-7522,1469,535,-934,125508,16400,16400,16400,1,1,0,8291,18650,1,0
132900,016580,16400,2,100,0.61,88.33,64691,57144,-7547,1471,535,-936,125533,16400,16400,16400,0,0,0,8291,18640,0,0
132900,016580,16400,2,100,0.61,88.33,64691,57144,-7547,1471,535,-936,125533,16400,16400,16400,0,0,0,8291,18640,0,0
133000,016580,16400,2,100,0.61,88.33,64694,57144,-7550,1473,535,-938,125536,16400,16400,16400,0,0,0,8291,18641,0,0
133000,016580,16400,2,100,0.61,88.33,64694,57144,-7550,1473,535,-938,125536,16400,16400,16400,0,0,0,8291,18641,0,0
133100,016580,16400,2,100,0.61,88.25,64773,57164,-7609,1476,536,-940,125635,16400,16400,16400,0,0,0,8269,18580,0,0
133100,016580,16400,2,100,0.61,88.19,64822,57164,-7658,1482,536,-946,125684,16400,16400,16400,49,6,0,8336,18530,49,0
133200,016580,16400,2,100,0.61,88.15,64849,57164,-7685,1484,536,-948,125711,16400,16400,16400,0,0,0,8347,18513,0,0
133200,016580,16450,2,150,0.92,88.38,64849,57313,-7536,1484,538,-946,125860,16450,16450,16450,149,0,2,8242,18508,0,149
133300,016580,16450,2,150,0.92,88.38,64849,57313,-7536,1484,538,-946,125860,16450,16450,16450,0,0,0,8242,18508,0,0
133300,016580,16400,2,100,0.61,88.34,64881,57313,-7568,1488,538,-950,125892,16400,16400,16400,32,4,0,8225,19050,32,0
133400,016580,16450,2,150,0.92,88.27,64943,57323,-7620,1490,539,-951,125964,16450,16450,16450,0,0,0,8225,18992,0,0
133400,016580,16450,2,150,0.92,88.24,64966,57323,-7643,1492,539,-953,125987,16450,16450,16450,23,2,0,10243,17974,23,0
133500,016580,16450,2,150,0.92,88.2,64990,57323,-7667,1496,539,-957,126011,16450,16450,16450,13,3,0,10243,17956,13,0
133500,016580,16450,2,150,0.92,88.16,65019,57323,-7696,1498,539,-959,126040,16450,16450,16450,42,5,0,10243,17917,42,0
133600,016580,16450,2,150,0.92,88.16,65019,57323,-7696,1498,539,-959,126040,16450,16450,16450,0,0,0,10243,17917,0,0
133600,016580,16450,2,150,0.92,88.2,65020,57349,-7671,1499,541,-958,126067,16450,16450,16450,27,1,2,8218,18729,1,26
133700,016580,16450,2,150,0.92,88.14,65075,57360,-7715,1503,542,-961,126133,16450,16450,16450,62,2,1,8370,19612,51,11
133700,016580,16450,2,150,0.92,88.05,65148,57360,-7788,1507,542,-965,126206,16450,16450,16400,135,6,1,10243,18858,124,11
133800,016580,16450,2,150,0.92,88.05,65148,57360,-7788,1507,542,-965,126206,16450,16450,16450,0,0,0,10243,18858,0,0
133800,016580,16450,2,150,0.92,88.03,65162,57360,-7802,1509,542,-967,126220,16450,16450,16450,14,2,0,10243,18181,14,0
133900,016580,16450,2,150,0.92,87.95,65220,57360,-7860,1514,542,-972,126278,16450,16450,16450,50,3,0,10549,18122,50,0
133900,016580,16450,2,150,0.92,87.94,65225,57360,-7865,1515,542,-973,126283,16450,16450,16450,55,4,0,10549,18118,55,0
134000,016580,16450,2,150,0.92,87.82,65313,57360,-7953,1519,542,-977,126371,16450,16450,16450,88,4,0,10349,18012,88,0
134000,016580,16450,2,150,0.92,87.82,65315,57360,-7955,1520,542,-978,126373,16450,16450,16450,90,5,0,10349,18029,90,0
134100,016580,16450,2,150,0.92,87.82,65315,57360,-7955,1520,542,-978,126373,16450,16450,16450,0,0,0,10349,18029,0,0
134100,016580,16450,2,150,0.92,87.82,65315,57360,-7955,1520,542,-978,126373,16450,16450,16450,0,0,0,10349,17727,0,0
134200,016580,16450,2,150,0.92,87.68,65419,57360,-8059,1526,542,-984,126477,16450,16450,16450,104,6,0,10560,17866,104,0
134300,016580,16450,2,150,0.92,87.71,65425,57386,-8039,1527,543,-984,126509,16450,16450,16450,0,0,0,10552,19937,0,0
134300,016580,16450,2,150,0.92,87.56,65542,57386,-8156,1533,543,-990,126626,16450,16450,16450,117,6,0,10552,19858,117,0
134400,016580,16500,2,200,1.23,87.24,65804,57407,-8397,1535,544,-991,126909,16500,16500,16500,0,0,0,10552,19077,0,0
134400,016580,16500,2,200,1.23,87.47,65808,57564,-8244,1537,546,-991,127070,16450,16500,16450,161,2,2,10405,19051,4,157
134500,016580,16500,2,200,1.23,87.48,65833,57588,-8245,1539,547,-992,127119,16500,16500,16500,25,2,0,14981,17386,25,0
134500,016580,16500,2,200,1.23,87.48,65833,57588,-8245,1539,547,-992,127119,16500,16500,16500,25,2,0,14981,17386,25,0
134600,016580,16550,2,250,1.53,87.21,66055,57609,-8446,1542,548,-994,127362,16550,16550,16550,0,0,0,14981,16144,0,0
134600,016580,16500,2,200,1.23,87.11,66157,57628,-8529,1548,549,-999,127483,16500,16550,16500,121,6,1,15054,15816,102,19
134700,016580,16500,2,200,1.23,87.07,66185,57628,-8557,1550,549,-1001,127511,16500,16500,16500,0,0,0,15054,15877,0,0
134700,016580,16500,2,200,1.23,87.07,66188,57628,-8560,1551,549,-1002,127514,16500,16500,16500,3,1,0,15054,15871,3,0
134800,016580,16500,2,200,1.23,87.03,66216,57628,-8588,1553,549,-1004,127542,16500,16500,16500,0,0,0,15054,15846,0,0
134800,016580,16500,2,200,1.23,87.03,66216,57628,-8588,1553,549,-1004,127542,16500,16500,16500,0,0,0,15054,15846,0,0
134900,016580,16550,2,250,1.53,87.01,66252,57649,-8603,1556,550,-1006,127599,16500,16550,16500,57,3,1,15079,15875,36,21
134900,016580,16550,2,250,1.53,87.01,66252,57649,-8603,1556,550,-1006,127599,16500,16550,16500,57,3,1,15079,15875,36,21
135000,016580,16500,2,200,1.23,87.03,66336,57734,-8602,1559,551,-1008,127768,16500,16500,16500,0,0,0,15315,15857,0,0
135000,016580,16500,2,200,1.23,86.99,66372,57734,-8638,1563,551,-1012,127804,16500,16500,16500,36,4,0,15294,15815,36,0
135100,016580,16500,2,200,1.23,86.9,66439,57734,-8705,1568,551,-1017,127871,16500,16500,16500,2,1,0,15308,15744,2,0
135100,016580,16500,2,200,1.23,86.9,66439,57734,-8705,1568,551,-1017,127871,16500,16500,16500,2,1,0,15308,15744,2,0
135200,016580,16500,2,200,1.23,86.87,66465,57735,-8730,1571,552,-1019,127898,16500,16500,16500,0,0,0,15307,15910,0,0
135200,016580,16500,2,200,1.23,86.85,66478,57735,-8743,1573,552,-1021,127911,16500,16500,16500,13,2,0,15307,15894,13,0
135300,016580,16500,2,200,1.23,86.77,66541,57735,-8806,1575,552,-1023,127974,16500,16500,16500,0,0,0,15307,15842,0,0
135300,016580,16500,2,200,1.23,86.73,66568,57735,-8833,1577,552,-1025,128001,16500,16500,16500,27,2,0,15307,15807,27,0
135400,016580,16500,2,200,1.23,86.76,66587,57768,-8819,1580,553,-1027,128053,16500,16500,16500,19,3,0,15274,15785,19,0
135400,016580,16500,2,200,1.23,86.68,66644,57768,-8876,1586,553,-1033,128110,16500,16500,16500,76,9,0,15989,16176,76,0
135500,016580,16500,2,200,1.23,86.68,66644,57768,-8876,1586,553,-1033,128110,16500,16500,16500,0,0,0,15989,16176,0,0
135500,016580,16500,2,200,1.23,86.68,66644,57768,-8876,1586,553,-1033,128110,16500,16500,16500,0,0,0,15989,16176,0,0
135600,016580,16500,2,200,1.23,86.58,66720,57768,-8952,1590,553,-1037,128186,16500,16500,16500,76,4,0,16389,13495,76,0
135600,016580,16500,2,200,1.23,86.55,66748,57768,-8980,1592,553,-1039,128214,16500,16500,16500,104,6,0,16407,13471,104,0
135700,016580,16500,2,200,1.23,86.55,66748,57768,-8980,1592,553,-1039,128214,16500,16500,16500,0,0,0,16407,13471,0,0
135800,016580,16500,2,200,1.23,86.5,66783,57768,-9015,1596,553,-1043,128249,16500,16500,16500,0,0,0,16407,13654,0,0
135800,016580,16500,2,200,1.23,86.46,66814,57768,-9046,1600,553,-1047,128280,16500,16500,16500,31,4,0,16457,13623,31,0
135900,016580,16500,2,200,1.23,86.52,66827,57818,-9009,1601,554,-1047,128343,16500,16500,16500,0,0,0,16407,13673,0,0
135900,016580,16500,2,200,1.23,86.4,66917,57818,-9099,1605,554,-1051,128433,16500,16500,16500,90,4,0,16534,13691,90,0
140000,016580,16500,2,200,1.23,86.39,66931,57819,-9112,1607,555,-1052,128448,16500,16500,16500,0,0,0,16565,13703,0,0
140000,016580,16500,2,200,1.23,86.34,66967,57819,-9148,1609,555,-1054,128484,16500,16500,16500,36,2,0,16536,13670,36,0
140100,016580,16500,2,200,1.23,86.31,66992,57819,-9173,1611,555,-1056,128509,16500,16500,16500,0,0,0,16536,13643,0,0
140100,016580,16550,2,250,1.53,86.46,67017,57941,-9076,1612,557,-1055,128656,16550,16550,16500,147,1,2,16436,13939,25,122
140200,016580,16550,2,250,1.53,87.04,67088,58393,-8695,1621,563,-1058,129179,16550,16550,16550,361,2,3,17041,12121,24,337
140200,016580,16550,2,250,1.53,86.92,67178,58393,-8785,1625,563,-1062,129269,16550,16550,16550,451,6,3,17041,12149,114,337
140300,016580,16650,2,350,2.15,89.89,67178,60388,-6790,1625,570,-1055,131264,16650,16650,16650,303,0,2,17187,11899,0,303
140300,016580,16650,2,350,2.15,90.53,67203,60838,-6365,1627,572,-1055,131739,16650,16650,16550,778,2,4,15328,12058,25,753
140400,016580,16650,2,350,2.15,90.53,67203,60838,-6365,1627,572,-1055,131739,16650,16650,16650,0,0,0,15328,12058,0,0
140400,016580,16650,2,350,2.15,90.64,67240,60949,-6291,1628,576,-1052,131887,16650,16700,16650,148,1,4,19040,8698,37,111
140500,016580,16550,2,250,1.53,90.78,67268,61065,-6203,1630,578,-1052,132031,16650,16650,16550,144,2,2,15034,12392,28,116
140500,016580,16550,2,250,1.53,90.68,67343,61065,-6278,1635,578,-1057,132106,16650,16650,16550,219,7,2,14979,11996,103,116
140600,016580,16550,2,250,1.53,90.64,67370,61065,-6305,1637,578,-1059,132133,16550,16550,16550,0,0,0,14979,11962,0,0
140600,016580,16550,2,250,1.53,90.11,67769,61067,-6702,1641,579,-1062,132534,16600,16600,16550,401,4,1,17241,11882,399,2
140700,016580,16600,2,300,1.84,90.02,67836,61067,-6769,1646,579,-1067,132601,16600,16600,16600,53,3,0,16468,8792,53,0
140700,016580,16600,2,300,1.84,90.02,67837,61067,-6770,1647,579,-1068,132602,16600,16600,16600,54,4,0,16485,8760,54,0
140800,016580,16600,2,300,1.84,90.04,67843,61087,-6756,1649,580,-1069,132628,16600,16600,16600,26,2,1,16729,9237,6,20
140900,016580,16600,2,300,1.84,89.96,67906,61087,-6819,1651,580,-1071,132691,16600,16600,16600,0,0,0,16800,9320,0,0
140900,016580,16600,2,300,1.84,89.91,67943,61087,-6856,1656,580,-1076,132728,16600,16600,16600,37,5,0,16809,8817,37,0
141000,016580,16600,2,300,1.84,89.87,67971,61087,-6884,1658,580,-1078,132756,16600,16600,16600,0,0,0,16823,8790,0,0
141000,016580,16600,2,300,1.84,89.85,67984,61087,-6897,1660,580,-1080,132769,16600,16600,16600,13,2,0,16848,8777,13,0
141100,016580,16600,2,300,1.84,89.82,68012,61087,-6925,1662,580,-1082,132797,16600,16600,16600,0,0,0,16848,8753,0,0
141100,016580,16600,2,300,1.84,89.82,68012,61087,-6925,1662,580,-1082,132797,16600,16600,16600,0,0,0,16848,8753,0,0
141200,016580,16600,2,300,1.84,89.74,68074,61087,-6987,1664,580,-1084,132859,16600,16600,16600,62,2,0,16863,8730,62,0
141200,016580,16600,2,300,1.84,89.69,68115,61090,-7025,1669,581,-1088,132903,16600,16650,16600,106,7,1,16776,8933,103,3
141300,016580,16600,2,300,1.84,89.67,68125,61090,-7035,1671,581,-1090,132913,16600,16600,16600,10,2,0,16776,8932,10,0
141300,016580,16600,2,300,1.84,89.65,68148,61096,-7052,1673,582,-1091,132942,16600,16600,16600,39,4,1,16776,8941,33,6
141400,016580,16550,2,250,1.53,89.61,68183,61096,-7087,1676,582,-1094,132977,16550,16550,16550,13,2,0,15046,12048,13,0
141400,016580,16650,2,350,2.15,89.62,68183,61103,-7080,1676,584,-1092,132984,16550,16650,16550,20,2,2,16776,9091,13,7
141500,016580,16600,2,300,1.84,89.59,68205,61103,-7102,1678,584,-1094,133006,16600,16600,16600,20,1,0,16776,8929,20,0
141500,016580,16600,2,300,1.84,89.56,68252,61125,-7127,1682,585,-1097,133075,16600,16600,16550,89,5,1,16775,8863,67,22
141600,016580,16600,2,300,1.84,89.55,68255,61125,-7130,1683,585,-1098,133078,16600,16600,16600,3,1,0,16775,9120,3,0
141600,016580,16600,2,300,1.84,89.52,68283,61125,-7158,1685,585,-1100,133106,16600,16600,16600,31,3,0,16775,9091,31,0
141700,016580,16600,2,300,1.84,89.47,68319,61125,-7194,1689,585,-1104,133142,16600,16600,16600,27,2,0,16775,9116,27,0
141700,016580,16600,2,300,1.84,89.45,68333,61126,-7207,1691,586,-1105,133157,16600,16650,16600,42,4,1,16774,9105,41,1
141800,016580,16600,2,300,1.84,89.43,68358,61130,-7228,1693,587,-1106,133186,16650,16650,16600,29,2,1,16771,9115,25,4
141800,016580,16600,2,300,1.84,89.18,68546,61130,-7416,1697,587,-1110,133374,16650,16650,16600,217,6,1,16771,8950,213,4
141900,016580,16600,2,300,1.84,89.18,68546,61130,-7416,1697,587,-1110,133374,16600,16600,16600,0,0,0,16771,8950,0,0
141900,016580,16600,2,300,1.84,89.14,68576,61130,-7446,1701,587,-1114,133404,16600,16600,16600,30,4,0,16771,9009,30,0
142000,016580,16600,2,300,1.84,89.14,68576,61130,-7446,1701,587,-1114,133404,16600,16600,16600,0,0,0,16771,9009,0,0
142000,016580,16600,2,300,1.84,89.13,68586,61130,-7456,1703,587,-1116,133414,16600,16600,16600,10,2,0,16796,9000,10,0
142100,016580,16600,2,300,1.84,89.04,68652,61130,-7522,1708,587,-1121,133480,16600,16600,16600,66,5,0,16813,8966,66,0
142200,016580,16600,2,300,1.84,88.96,68714,61130,-7584,1710,587,-1123,133542,16600,16600,16600,0,0,0,16813,8913,0,0
142200,016580,16600,2,300,1.84,88.93,68743,61130,-7613,1714,587,-1127,133571,16600,16600,16600,29,4,0,16835,9246,29,0
142300,016580,16600,2,300,1.84,88.93,68743,61130,-7613,1714,587,-1127,133571,16600,16600,16600,0,0,0,16835,9246,0,0
142300,016580,16600,2,300,1.84,88.92,68747,61130,-7617,1716,587,-1129,133575,16600,16600,16600,4,2,0,16800,9274,4,0
142400,016580,16600,2,300,1.84,88.89,68772,61130,-7642,1718,587,-1131,133600,16600,16600,16600,25,2,0,16868,9253,25,0
142400,016580,16600,2,300,1.84,88.87,68782,61130,-7652,1720,587,-1133,133610,16600,16600,16600,35,4,0,16868,9537,35,0
142500,016580,16600,2,300,1.84,88.74,68888,61130,-7758,1725,587,-1138,133716,16600,16600,16600,0,0,0,17086,9447,0,0
142500,016580,16650,2,350,2.15,88.85,68916,61230,-7686,1727,588,-1139,133844,16600,16650,16600,128,2,1,17101,9414,28,100
142600,016580,16600,2,300,1.84,88.82,68941,61230,-7711,1728,588,-1140,133869,16600,16600,16600,0,0,0,17026,9414,0,0
142600,016580,16600,2,300,1.84,88.82,68941,61230,-7711,1728,588,-1140,133869,16600,16600,16600,0,0,0,17026,9414,0,0
142700,016580,16600,2,300,1.84,88.78,68969,61230,-7739,1731,588,-1143,133897,16600,16600,16600,0,0,0,17029,9364,0,0
142700,016580,16600,2,300,1.84,88.81,68977,61259,-7718,1732,589,-1143,133934,16650,16650,16600,37,1,1,17008,9362,8,29
142800,016580,16600,2,300,1.84,88.53,69192,61259,-7933,1738,589,-1149,134149,16600,16600,16600,215,6,0,17019,9187,215,0
142800,016580,16600,2,300,1.84,88.45,69259,61259,-8000,1745,589,-1156,134216,16600,16600,16600,282,13,0,17015,9149,282,0
142900,016580,16600,2,300,1.84,88.45,69259,61259,-8000,1745,589,-1156,134216,16600,16600,16600,0,0,0,17015,9149,0,0
142900,016580,16600,2,300,1.84,88.48,69267,61290,-7977,1746,590,-1156,134255,16650,16650,16600,39,1,1,16993,9140,8,31
143000,016580,16600,2,300,1.84,88.43,69309,61290,-8019,1750,590,-1160,134297,16600,16600,16600,17,2,0,16985,9093,17,0
143000,016580,16600,2,300,1.84,88.43,69312,61290,-8022,1752,590,-1162,134300,16600,16600,16600,20,4,0,17010,9090,20,0
143100,016580,16600,2,300,1.84,87.98,69661,61290,-8371,1758,590,-1168,134649,16600,16600,16600,349,6,0,17010,8791,349,0
143100,016580,16550,2,250,1.53,87.9,69723,61290,-8433,1763,590,-1173,134711,16600,16600,16550,411,11,0,16066,11675,411,0
143200,016580,16550,2,250,1.53,87.89,69733,61290,-8443,1765,590,-1175,134721,16550,16550,16550,10,2,0,16012,11664,10,0
143200,016580,16550,2,250,1.53,87.83,69787,61291,-8496,1769,591,-1178,134776,16550,16600,16550,65,6,1,16029,11613,64,1
143300,016580,16550,2,250,1.53,87.83,69787,61291,-8496,1769,591,-1178,134776,16550,16550,16550,0,0,0,16029,11613,0,0
143300,016580,16550,2,250,1.53,87.79,69814,61291,-8523,1771,591,-1180,134803,16550,16550,16550,27,2,0,16253,11644,27,0
143400,016580,16550,2,250,1.53,87.71,69880,61291,-8589,1775,591,-1184,134869,16550,16550,16550,66,4,0,16253,11585,66,0
143400,016580,16550,2,250,1.53,87.47,70068,61291,-8777,1779,591,-1188,135057,16550,16550,16550,254,8,0,16265,11510,254,0
143500,016580,16550,2,250,1.53,87.46,70082,61291,-8791,1781,591,-1190,135071,16550,16550,16550,14,2,0,16265,11987,14,0
143600,016580,16550,2,250,1.53,87.41,70117,61291,-8826,1785,591,-1194,135106,16550,16550,16550,0,0,0,16265,11951,0,0
143600,016580,16550,2,250,1.53,87.38,70144,61291,-8853,1787,591,-1196,135133,16550,16550,16550,27,2,0,16265,11959,27,0
143700,016580,16550,2,250,1.53,87.34,70172,61291,-8881,1789,591,-1198,135161,16550,16550,16550,0,0,0,16265,11932,0,0
143700,016580,16550,2,250,1.53,87.36,70185,61314,-8871,1791,592,-1199,135197,16600,16600,16550,36,2,1,16688,11915,13,23
143800,016580,16500,2,200,1.23,86.71,70713,61314,-9399,1799,592,-1207,135725,16500,16500,16500,0,0,0,15105,13155,0,0
143800,016580,16500,2,200,1.23,86.68,70738,61314,-9424,1801,592,-1209,135750,16500,16500,16500,25,2,0,15224,13336,25,0
143900,016580,16500,2,200,1.23,86.45,70927,61314,-9613,1805,592,-1213,135939,16500,16500,16500,0,0,0,15240,13126,0,0
143900,016580,16500,2,200,1.23,86.08,71232,61314,-9918,1813,592,-1221,136244,16500,16500,16500,305,8,0,15256,13063,305,0
144000,016580,16550,2,250,1.53,86.06,71284,61348,-9936,1820,593,-1227,136330,16500,16550,16500,73,4,1,15282,13211,39,34
144000,016580,16550,2,250,1.53,86.29,71409,61618,-9791,1824,596,-1228,136725,16500,16550,16500,468,8,4,16460,11055,164,304
144100,016580,16550,2,250,1.53,86.26,71431,61618,-9813,1826,596,-1230,136747,16550,16550,16550,22,2,0,14978,11181,22,0
144200,016580,16550,2,250,1.53,86.26,71436,61618,-9818,1827,596,-1231,136752,16550,16550,16550,0,0,0,14978,11161,0,0
144200,016580,16550,2,250,1.53,86.2,71479,61618,-9861,1831,596,-1235,136795,16550,16550,16550,43,4,0,16188,11391,43,0
144300,016580,16550,2,250,1.53,86.2,71479,61618,-9861,1831,596,-1235,136795,16550,16550,16550,0,0,0,16188,11391,0,0
144300,016580,16550,2,250,1.53,86.19,71487,61618,-9869,1833,596,-1237,136803,16550,16550,16550,8,2,0,16188,11492,8,0
144400,016580,16600,2,300,1.84,86.19,71566,61683,-9883,1836,598,-1238,136947,16600,16600,16550,115,1,2,16173,11470,50,65
144400,016580,16550,2,250,1.53,86.47,71599,61910,-9689,1839,600,-1239,137207,16600,16600,16550,375,4,4,16002,11445,83,292
144500,016580,16550,2,250,1.53,86.6,71634,62034,-9600,1842,601,-1241,137366,16550,16550,16550,0,0,0,15870,11432,0,0
144500,016580,16550,2,250,1.53,86.6,71669,62065,-9604,1845,602,-1243,137432,16550,16600,16550,66,3,1,15837,11475,35,31
144600,016580,16550,2,250,1.53,86.58,71683,62065,-9618,1847,602,-1245,137446,16550,16550,16550,3,1,0,15845,11368,3,0
144600,016580,16550,2,250,1.53,86.58,71683,62065,-9618,1847,602,-1245,137446,16550,16550,16550,3,1,0,15845,11368,3,0
144700,016580,16550,2,250,1.53,86.54,71754,62099,-9655,1850,603,-1247,137551,16600,16600,16550,105,3,1,15865,11275,71,34
144700,016580,16550,2,250,1.53,86.47,71817,62099,-9718,1855,603,-1252,137614,16600,16600,16550,168,8,1,15865,11206,134,34
144800,016580,16550,2,250,1.53,86.44,71844,62099,-9745,1857,603,-1254,137641,16550,16550,16550,27,2,0,15880,11178,27,0
144800,016580,16550,2,250,1.53,86.43,71847,62099,-9748,1859,603,-1256,137644,16550,16550,16550,30,4,0,15896,11171,30,0
144900,016580,16550,2,250,1.53,86.41,71864,62099,-9765,1863,603,-1260,137661,16550,16550,16550,12,3,0,15896,11187,12,0
144900,016580,16550,2,250,1.53,86.38,71888,62099,-9789,1867,603,-1264,137685,16550,16550,16550,36,7,0,15896,11230,36,0
145000,016580,16500,2,200,1.23,86.34,72002,62164,-9838,1872,604,-1268,138041,16550,16550,16500,291,5,0,14406,13060,114,0
145000,016580,16500,2,200,1.23,86.26,72065,62164,-9901,1874,604,-1270,138104,16550,16550,16500,354,7,0,14406,12903,177,0
145100,016580,16550,2,250,1.53,86.42,72169,62365,-9804,1879,610,-1269,138409,16550,16550,16500,305,5,6,14230,14446,104,201
145100,016580,16550,2,250,1.53,86.33,72241,62365,-9876,1882,610,-1272,138481,16550,16550,16500,377,8,6,15627,12856,176,201
145200,016580,16550,2,250,1.53,86.32,72251,62365,-9886,1885,610,-1275,138491,16550,16550,16550,10,3,0,15627,12833,10,0
145200,016580,16600,2,300,1.84,86.43,72261,62456,-9805,1886,613,-1273,138592,16550,16600,16550,111,4,3,17673,9874,20,91
145300,016580,16600,2,300,1.84,86.73,72363,62761,-9602,1890,616,-1274,138999,16600,16650,16600,394,4,2,15770,12384,102,292
145400,016580,16650,2,350,2.15,86.91,72425,62945,-9480,1892,618,-1274,139245,16650,16650,16650,0,0,0,17516,10248,0,0
145400,016580,16600,2,300,1.84,86.86,72467,62945,-9522,1895,618,-1277,139287,16600,16600,16600,42,3,0,17473,10226,42,0
145500,016580,16600,2,300,1.84,86.85,72475,62945,-9530,1897,618,-1279,139295,16600,16600,16600,0,0,0,17459,9731,0,0
145500,016580,16600,2,300,1.84,86.82,72504,62945,-9559,1899,618,-1281,139324,16600,16600,16600,29,2,0,17459,9631,29,0
145600,016580,16600,2,300,1.84,86.79,72528,62945,-9583,1902,618,-1284,139348,16600,16600,16600,20,1,0,17459,9653,20,0
145600,016580,16600,2,300,1.84,86.78,72533,62945,-9588,1903,618,-1285,139353,16600,16600,16600,25,2,0,17459,9633,25,0
145700,016580,16650,2,350,2.15,86.66,72637,62947,-9690,1909,619,-1290,139459,16650,16650,16650,2,0,1,17525,9556,0,2
145700,016580,16650,2,350,2.15,86.66,72637,62947,-9690,1909,619,-1290,139459,16650,16650,16650,2,0,1,17525,9556,0,2
145800,016580,16650,2,350,2.15,86.69,72637,62972,-9665,1909,620,-1289,139484,16650,16650,16650,25,0,1,17841,9344,0,25
145800,016580,16600,2,300,1.84,86.69,72644,62972,-9672,1910,620,-1290,139491,16650,16650,16600,32,1,1,17823,9344,7,25
145900,016580,16600,2,300,1.84,86.61,72709,62972,-9737,1918,620,-1298,139556,16600,16600,16600,35,5,0,17816,9298,35,0
145900,016580,16600,2,300,1.84,86.46,72834,62972,-9862,1920,620,-1300,139681,16600,16600,16600,160,7,0,17816,9151,160,0
150000,016580,16550,2,250,1.53,86.37,72918,62977,-9941,1923,621,-1302,139770,16550,16550,16550,62,2,0,17816,12726,62,0
150000,016580,16600,2,300,1.84,86.37,72950,63005,-9945,1924,625,-1299,139830,16550,16600,16550,122,3,4,16040,12677,94,28
150100,016580,16550,2,250,1.53,86.23,73069,63005,-10064,1926,625,-1301,139949,16550,16550,16550,0,0,0,17784,12668,0,0
150100,016580,16650,2,350,2.15,86.22,73075,63008,-10067,1928,626,-1302,139958,16550,16650,16550,9,2,1,18184,13452,6,3
150200,016580,16550,2,250,1.53,86.07,73206,63009,-10197,1931,627,-1304,140090,16600,16600,16550,131,3,0,18081,13021,131,0
150200,016580,16550,2,250,1.53,86.01,73263,63013,-10250,1938,628,-1310,140151,16600,16600,16550,192,10,1,16362,14003,188,4
150300,016580,16600,2,300,1.84,86.02,73269,63024,-10245,1939,630,-1309,140168,16600,16600,16600,0,0,0,16353,13231,0,0
150300,016580,16550,2,250,1.53,85.9,73374,63025,-10349,1942,631,-1311,140274,16650,16650,16550,106,3,1,18307,13145,105,1
150400,016580,16550,2,250,1.53,85.78,73497,63046,-10451,1944,633,-1311,140418,16600,16600,16550,144,2,2,16772,13079,123,21
150400,016580,16550,2,250,1.53,85.66,73602,63051,-10551,1947,634,-1313,140528,16600,16600,16550,254,5,3,17984,9707,228,26
150500,016580,16600,2,300,1.84,85.69,73602,63071,-10531,1947,635,-1312,140548,16600,16600,16600,20,0,1,16248,12913,0,20
150500,016580,16550,2,250,1.53,85.6,73697,63084,-10613,1949,636,-1313,140656,16600,16600,16550,128,2,2,16237,13118,95,33
150600,016580,16550,2,250,1.53,85.52,73767,63084,-10683,1952,636,-1316,140726,16550,16550,16550,70,3,0,16270,13127,70,0
150700,016580,16550,2,250,1.53,85.49,73794,63084,-10710,1954,636,-1318,140753,16550,16550,16550,0,0,0,16210,13045,0,0
150700,016580,16550,2,250,1.53,85.35,73915,63084,-10831,1956,636,-1320,140874,16550,16550,16550,121,2,0,15735,12980,121,0
150800,016580,16500,2,200,1.23,84.32,74815,63085,-11730,1959,637,-1322,141775,16500,16500,16500,0,0,0,14568,14314,0,0
150800,016580,16500,2,200,1.23,84.15,74963,63085,-11878,1964,637,-1327,141923,16500,16500,16500,148,5,0,14153,14157,148,0
150900,016580,16500,2,200,1.23,84.15,74970,63085,-11885,1966,637,-1329,141930,16500,16500,16500,0,0,0,14153,14162,0,0
150900,016580,16600,2,300,1.84,84.48,75038,63395,-11643,1969,641,-1328,142308,16550,16600,16500,378,3,4,15335,14061,68,310
151000,016580,16550,2,250,1.53,84.33,75181,63397,-11784,1975,642,-1333,142453,16500,16550,16500,10,1,1,13898,13838,8,2
151000,016580,16550,2,250,1.53,84.29,75211,63397,-11814,1978,642,-1336,142483,16500,16550,16500,40,4,1,15334,11784,38,2
151100,016580,16500,2,200,1.23,84.13,75356,63397,-11959,1986,642,-1344,142628,16550,16550,16500,2,2,0,15334,11713,2,0
151100,016580,16500,2,200,1.23,84.12,75366,63397,-11969,1988,642,-1346,142638,16550,16550,16500,12,4,0,13904,13910,12,0
151200,016580,16550,2,250,1.53,84.21,75381,63476,-11905,1989,643,-1346,142732,16550,16550,16550,15,1,0,15288,12163,15,0
151200,016580,16550,2,250,1.53,84.21,75381,63476,-11905,1989,643,-1346,142732,16550,16550,16550,15,1,0,15288,12163,15,0
151300,016580,16550,2,250,1.53,84.21,75381,63476,-11905,1989,643,-1346,142732,16550,16550,16550,0,0,0,15288,12163,0,0
151300,016580,16550,2,250,1.53,84.2,75385,63476,-11909,1991,643,-1348,142736,16550,16550,16550,4,2,0,15288,12121,4,0
151400,016580,16550,2,250,1.53,84.13,75450,63476,-11974,1997,643,-1354,142801,16550,16550,16550,55,4,0,15288,12533,55,0
151400,016580,16550,2,250,1.53,84.15,75496,63533,-11963,2004,644,-1360,142904,16550,16600,16550,158,11,1,15203,12474,101,57
151500,016580,16550,2,250,1.53,84.15,75496,63533,-11963,2004,644,-1360,142904,16550,16550,16550,0,0,0,15203,12474,0,0
151500,016580,16550,2,250,1.53,84.15,75496,63533,-11963,2004,644,-1360,142904,16550,16550,16550,0,0,0,15203,12474,0,0
151600,016580,16550,2,250,1.53,84.15,75498,63533,-11965,2006,644,-1362,142906,16550,16550,16550,1,1,0,15264,12479,1,0
151600,016580,16550,2,250,1.53,84.15,75498,63533,-11965,2006,644,-1362,142906,16550,16550,16550,1,1,0,15264,12479,1,0
151700,016580,16550,2,250,1.53,84.12,75524,63533,-11991,2008,644,-1364,142932,16550,16550,16550,26,2,0,15263,12806,26,0
151700,016580,16600,2,300,1.84,84.7,75532,63974,-11558,2009,646,-1363,143381,16550,16600,16550,475,3,2,14868,12825,34,441
151800,016580,16550,2,250,1.53,84.49,75717,63974,-11743,2012,646,-1366,143566,16550,16550,16550,185,3,0,14989,12776,185,0
151900,016580,16550,2,250,1.53,84.01,76152,63974,-12178,2015,646,-1369,144001,16550,16550,16550,0,0,0,15289,12787,0,0
151900,016580,16550,2,250,1.53,84.16,76302,64214,-12088,2017,654,-1363,144391,16550,16550,16500,390,2,8,13962,13955,150,240
152000,016580,16550,2,250,1.53,84.17,76331,64248,-12083,2018,659,-1359,144454,16550,16550,16550,7,0,1,13970,12967,0,7
152000,016580,16600,2,300,1.84,85.11,76331,64967,-11364,2018,667,-1351,145173,16550,16600,16550,726,0,9,15188,11178,0,726
152000,016580,16650,2,350,2.15,85.97,76341,65632,-10709,2021,674,-1347,145848,16550,16650,16550,1401,3,16,16778,8185,10,1391
152000,016580,16650,2,350,2.15,85.97,76341,65632,-10709,2021,674,-1347,145848,16550,16650,16550,1401,3,16,16778,8185,10,1391
152000,016580,16650,2,350,2.15,85.97,76341,65632,-10709,2021,674,-1347,145848,16550,16650,16550,1401,3,16,16778,8185,10,1391
152000,016580,16650,2,350,2.15,85.97,76341,65632,-10709,2021,674,-1347,145848,16550,16650,16550,1401,3,16,16778,8185,10,1391
152000,016580,16650,2,350,2.15,85.97,76341,65632,-10709,2021,674,-1347,145848,16550,16650,16550,1401,3,16,16778,8185,10,1391
152000,016580,16650,2,350,2.15,85.97,76341,65632,-10709,2021,674,-1347,145848,16550,16650,16550,1401,3,16,16778,8185,10,1391
152000,016580,16650,2,350,2.15,85.97,76341,65632,-10709,2021,674,-1347,145848,16550,16650,16550,1401,3,16,16778,8185,10,1391
152000,016580,16650,2,350,2.15,85.97,76341,65632,-10709,2021,674,-1347,145848,16550,16650,16550,1401,3,16,16778,8185,10,1391
152000,016580,16650,2,350,2.15,85.97,76341,65632,-10709,2021,674,-1347,145848,16550,16650,16550,1401,3,16,16778,8185,10,1391
152000,016580,16650,2,350,2.15,85.97,76341,65632,-10709,2021,674,-1347,145848,16550,16650,16550,1401,3,16,16778,8185,10,1391
152000,016580,16650,2,350,2.15,85.97,76341,65632,-10709,2021,674,-1347,145848,16550,16650,16550,1401,3,16,16778,8185,10,1391
152000,016580,16650,2,350,2.15,85.97,76341,65632,-10709,2021,674,-1347,145848,16550,16650,16550,1401,3,16,16778,8185,10,1391
152000,016580,16650,2,350,2.15,85.97,76341,65632,-10709,2021,674,-1347,145848,16550,16650,16550,1401,3,16,16778,8185,10,1391
152000,016580,16650,2,350,2.15,85.97,76341,65632,-10709,2021,674,-1347,145848,16550,16650,16550,1401,3,16,16778,8185,10,1391
152000,016580,16650,2,350,2.15,85.97,76341,65632,-10709,2021,674,-1347,145848,16550,16650,16550,1401,3,16,16778,8185,10,1391
152000,016580,16650,2,350,2.15,85.97,76341,65632,-10709,2021,674,-1347,145848,16550,16650,16550,1401,3,16,16778,8185,10,1391
152000,016580,16650,2,350,2.15,85.97,76341,65632,-10709,2021,674,-1347,145848,16550,16650,16550,1401,3,16,16778,8185,10,1391
152000,016580,16650,2,350,2.15,85.97,76341,65632,-10709,2021,674,-1347,145848,16550,16650,16550,1401,3,16,16778,8185,10,1391
152000,016580,16650,2,350,2.15,85.97,76341,65632,-10709,2021,674,-1347,145848,16550,16650,16550,1401,3,16,16778,8185,10,1391
153000,016580,16650,2,350,2.15,85.97,76341,65632,-10709,2021,674,-1347,145848,16650,16650,16650,0,0,0,16253,8185,0,0
