094800,272210,11800,2,150,1.29,92.8,688987,639390,-49597,1879,3168,1289,1440113,11850,11850,11800,359,2,2,536886,290841,311,48
094800,272210,11850,2,200,1.72,92.67,690832,640188,-50644,1884,3179,1295,1442756,11850,11850,11800,3002,7,13,536839,289291,2156,846
094900,272210,11850,2,200,1.72,92.81,691120,641460,-49660,1889,3192,1303,1444316,11800,11850,11800,1463,5,10,536063,291546,288,1175
094900,272210,11850,2,200,1.72,92.91,691167,642145,-49022,1891,3205,1314,1445048,11800,11850,11800,2195,7,23,536718,291107,335,1860
095000,272210,11800,2,150,1.29,93.15,691334,643963,-47371,1893,3221,1328,1447033,11850,11850,11800,1901,2,15,535711,296931,167,1734
095000,272210,11850,2,200,1.72,93.33,691689,645583,-46106,1897,3235,1338,1449008,11850,11850,11800,3876,6,29,531953,296206,522,3354
095100,272210,11850,2,200,1.72,93.74,692189,648840,-43349,1898,3254,1356,1452765,11850,11850,11850,3112,0,16,532355,299808,0,3112
095100,272210,11800,2,150,1.29,93.68,693054,649276,-43778,1904,3266,1362,1454066,11850,11850,11800,4413,6,28,533837,299284,865,3548
095200,272210,11800,2,150,1.29,93.36,696542,650282,-46260,1912,3269,1357,1458560,11800,11850,11800,4494,8,3,536672,299488,3488,1006
095200,272210,11850,2,200,1.72,93.53,697008,651890,-45118,1918,3280,1362,1460634,11800,11850,11800,6568,14,14,536787,301326,3954,2614
095300,272210,11850,2,200,1.72,93.36,698919,652523,-46396,1928,3292,1364,1463178,11850,11850,11800,2544,10,12,534928,300494,1911,633
095400,272210,11800,2,150,1.29,93.32,699254,652552,-46702,1930,3294,1364,1463542,11800,11800,11800,0,0,0,536185,301166,0,0
095400,272210,11850,2,200,1.72,93.77,699536,655978,-43558,1935,3314,1379,1467250,11850,11850,11800,3708,5,20,536590,299965,282,3426
095500,272210,11850,2,200,1.72,94.64,699556,662038,-37518,1936,3342,1406,1473330,11850,11850,11850,242,0,1,532951,298455,0,242
095500,272210,11850,2,200,1.72,94.79,699952,663478,-36474,1938,3354,1416,1475166,11850,11850,11800,2078,2,13,533587,300628,396,1682
095600,272210,11850,2,200,1.72,95.34,700032,667409,-32623,1942,3364,1422,1479177,11850,11850,11850,110,0,2,528854,301032,0,110
095600,272210,11900,2,250,2.15,97.85,700316,685252,-15064,1949,3389,1440,1497304,11850,11900,11850,18237,7,27,554221,288758,284,17953
095700,272210,11900,2,250,2.15,97.79,701053,685558,-15495,1959,3394,1435,1498347,11900,11900,11900,200,0,1,554660,287812,0,200
095700,272210,11850,2,200,1.72,97.61,702874,686101,-16773,1965,3399,1434,1500711,11900,11900,11850,2564,6,6,556956,294686,1821,743
095800,272210,11850,2,200,1.72,97.45,704086,686110,-17976,1974,3402,1428,1501932,11850,11850,11850,20,1,0,557297,299735,20,0
095800,272210,11850,2,200,1.72,96.8,708881,686191,-22690,1990,3405,1415,1506808,11850,11900,11850,4896,17,3,560239,294673,4815,81
095900,272210,11900,2,250,2.15,96.58,710825,686496,-24329,2002,3415,1413,1509057,11850,11900,11850,695,3,5,564781,300312,506,189
095900,272210,11850,2,200,1.72,95.71,717701,686910,-30791,2017,3419,1402,1516347,11850,11900,11850,7985,18,9,569574,297139,7382,603
100000,272210,11850,2,200,1.72,95.47,719894,687312,-32582,2025,3428,1403,1518942,11850,11850,11800,316,1,5,526558,312588,25,291
100000,272210,11850,2,200,1.72,95.62,720060,688493,-31567,2027,3436,1409,1520289,11850,11850,11800,1663,3,13,527703,313584,191,1472
100100,272210,11800,2,150,1.29,95.77,721284,690797,-30487,2031,3441,1410,1523817,11850,11850,11800,717,2,1,523848,318057,664,53
100100,272210,11850,2,200,1.72,95.8,721548,691223,-30325,2036,3448,1412,1524507,11850,11850,11800,1407,7,8,531324,318684,928,479
100200,272210,11850,2,200,1.72,95.9,721549,691970,-29579,2037,3459,1422,1525255,11850,11850,11850,206,0,7,531623,316093,0,206
100200,272210,11850,2,200,1.72,95.97,721555,692475,-29080,2038,3463,1425,1525766,11850,11850,11800,717,1,11,533330,317726,6,711
100300,272210,11800,2,150,1.29,96.33,721760,695246,-26514,2042,3488,1446,1528742,11850,11850,11800,450,1,12,531123,312483,1,449
100300,272210,11800,2,150,1.29,96.62,723092,698680,-24412,2047,3493,1446,1533508,11850,11850,11800,5216,6,17,528996,319957,1333,3883
100400,272210,11800,2,150,1.29,96.53,723950,698827,-25123,2053,3495,1442,1534513,11800,11800,11800,796,5,0,538038,324109,796,0
100400,272210,11850,2,200,1.72,95.99,728358,699167,-29191,2055,3501,1446,1539261,11800,11850,11800,5544,7,6,535132,321094,5204,340
100500,272210,11850,2,200,1.72,96.24,728707,701300,-27407,2057,3509,1452,1541743,11850,11850,11850,127,0,5,537145,317581,0,127
100500,272210,11850,2,200,1.72,96.3,728720,701731,-26989,2058,3515,1457,1542187,11850,11850,11800,571,1,11,537388,317886,13,558
100600,272210,11850,2,200,1.72,96.38,728720,702327,-26393,2058,3522,1464,1542783,11850,11850,11850,442,0,4,540428,318961,0,442
100600,272210,11850,2,200,1.72,96.44,728913,702995,-25918,2061,3531,1470,1543644,11850,11850,11800,1303,3,13,546797,319504,193,1110
100700,272210,11800,2,150,1.29,96.09,731693,703069,-28624,2072,3533,1461,1546498,11850,11850,11800,2606,9,1,545657,316551,2605,1
100700,272210,11800,2,150,1.29,93.21,754649,703399,-51250,2101,3537,1436,1569784,11850,11850,11750,25892,38,5,467949,323394,25561,331
100800,272210,11750,2,100,0.86,90.49,777780,703791,-73989,2109,3551,1442,1593307,11750,11750,11700,23173,6,9,388883,309717,22804,369
100800,272210,11750,2,100,0.86,90.58,777782,704512,-73270,2110,3558,1448,1594030,11750,11750,11700,23896,7,16,397329,311660,22806,1090
100900,272210,11750,2,100,0.86,90.76,778344,706392,-71952,2113,3570,1457,1596472,11750,11750,11700,2337,3,10,393355,311864,562,1775
100900,272210,11700,2,50,0.43,91.01,778586,708581,-70005,2120,3584,1464,1598903,11750,11750,11700,4768,10,24,393086,313311,804,3964
101000,272210,11750,2,100,0.86,91.27,778709,710689,-68020,2121,3597,1476,1601134,11750,11750,11700,2055,1,9,396280,316347,123,1932
101000,272210,11800,2,150,1.29,92.16,778915,717869,-61046,2124,3601,1477,1608520,11750,11800,11700,9441,4,13,472274,313506,329,9112
101100,272210,11800,2,150,1.29,92.25,779015,718645,-60370,2128,3613,1485,1609396,11800,11800,11750,666,2,9,472283,315306,51,615
101100,272210,11750,2,100,0.86,92.16,779948,718824,-61124,2132,3616,1484,1610508,11800,11800,11750,1778,6,12,476059,318536,984,794
101200,272210,11800,2,150,1.29,92.18,780181,719179,-61002,2139,3621,1482,1611096,11750,11800,11750,586,5,5,479555,323210,231,355
101200,272210,11750,2,100,0.86,92.25,780377,719935,-60442,2143,3630,1487,1612048,11750,11800,11750,1538,9,14,477641,322694,427,1111
101300,272210,11800,2,150,1.29,92.0,783018,720363,-62655,2151,3634,1483,1615117,11800,11800,11750,2847,7,3,477068,320043,2491,356
101300,272210,11800,2,150,1.29,91.58,786857,720598,-66259,2160,3638,1478,1619191,11800,11800,11750,6921,16,7,476129,322592,6330,591
101400,272210,11750,2,100,0.86,91.14,790905,720863,-70042,2172,3648,1476,1623504,11800,11800,11750,4306,12,9,476363,320835,4048,258
101500,272210,11750,2,100,0.86,91.03,792052,721025,-71027,2187,3651,1464,1624813,11750,11750,11750,0,0,0,476637,322433,0,0
101500,272210,11800,2,150,1.29,90.99,792675,721228,-71447,2192,3655,1463,1625639,11750,11800,11750,826,5,4,476090,322208,623,203
101600,272210,11750,2,100,0.86,90.94,793465,721569,-71896,2198,3659,1461,1626770,11750,11750,11750,0,0,0,476260,333350,0,0
101600,272210,11750,2,100,0.86,89.86,803145,721690,-81455,2236,3660,1424,1636571,11750,11800,11750,9801,38,1,471986,324965,9680,121
101700,272210,11700,2,50,0.43,89.58,805707,721763,-83944,2244,3661,1417,1639206,11700,11700,11700,0,0,0,471992,325169,0,0
101700,272210,11750,2,100,0.86,90.1,805955,726181,-79774,2247,3673,1426,1643872,11750,11750,11700,4666,3,12,470752,328946,248,4418
101800,272210,11750,2,100,0.86,89.97,807250,726255,-80995,2251,3675,1424,1645241,11750,11750,11750,0,0,0,471009,332826,0,0
101800,272210,11750,2,100,0.86,89.92,808050,726577,-81473,2260,3678,1418,1646363,11750,11800,11750,1122,9,3,475664,332664,800,322
101900,272210,11800,2,150,1.29,89.96,808118,726985,-81133,2261,3683,1422,1646839,11800,11800,11800,75,0,1,477744,332584,0,75
101900,272210,11800,2,150,1.29,89.8,809995,727408,-82587,2266,3688,1422,1649139,11800,11800,11750,2375,5,6,477619,333318,1877,498
102000,272210,11800,2,150,1.29,89.79,810555,727796,-82759,2268,3693,1425,1650087,11800,11800,11800,13,0,2,478282,333525,0,13
102000,272210,11750,2,100,0.86,89.81,810742,728161,-82581,2272,3702,1430,1650639,11800,11800,11750,565,4,11,480845,334175,187,378
102100,272210,11750,2,100,0.86,88.96,818800,728431,-90369,2274,3707,1433,1658967,11800,11800,11750,8153,1,2,398908,335118,8034,119
102100,272210,11750,2,100,0.86,88.94,819226,728603,-90623,2278,3711,1433,1659565,11800,11800,11700,8751,5,6,402887,334918,8460,291
102200,272210,11750,2,100,0.86,88.94,819437,728787,-90650,2284,3718,1434,1659960,11750,11750,11700,186,2,3,403067,327941,106,80
102200,272210,11750,2,100,0.86,88.94,819507,728899,-90608,2285,3725,1440,1660142,11750,11750,11700,368,3,10,405857,328002,176,192
102300,272210,11700,2,50,0.43,88.73,824441,731553,-92888,2293,3735,1442,1667730,11750,11750,11700,2067,5,4,405142,323441,1771,296
102300,272210,11750,2,100,0.86,88.7,825558,732248,-93310,2300,3748,1448,1669542,11750,11750,11700,3879,12,17,405921,324769,2888,991
102400,272210,11750,2,100,0.86,88.78,825558,732914,-92644,2300,3751,1451,1670208,11750,11750,11750,550,0,2,404628,340193,0,550
102400,272210,11750,2,100,0.86,88.9,825558,733955,-91603,2300,3765,1465,1671249,11750,11750,11750,1591,0,16,403983,340528,0,1591
102500,272210,11700,2,50,0.43,89.01,825751,734983,-90768,2303,3769,1466,1672470,11750,11750,11700,1077,2,3,402924,338350,121,956
102500,272210,11750,2,100,0.86,89.46,826050,738965,-87085,2307,3781,1474,1676751,11750,11750,11700,5358,6,15,403543,339604,420,4938
102600,272210,11750,2,100,0.86,89.61,826412,740554,-85858,2313,3791,1478,1678702,11750,11800,11750,931,6,9,476940,318882,362,569
102600,272210,11750,2,100,0.86,89.42,828350,740711,-87639,2325,3794,1469,1680797,11750,11800,11700,3026,18,12,483893,328403,2300,726
102700,272210,11750,2,100,0.86,89.5,828635,741646,-86989,2326,3805,1479,1682017,11800,11800,11750,1220,1,11,402420,346440,285,935
102700,272210,11700,2,50,0.43,89.51,828710,741739,-86971,2328,3810,1482,1682185,11800,11800,11700,1388,3,16,402391,346564,360,1028
102800,272210,11700,2,50,0.43,89.2,832360,742498,-89862,2329,3816,1487,1686594,11750,11750,11700,4337,1,5,402502,346514,3650,687
102900,272210,11700,2,50,0.43,89.35,832556,743907,-88649,2332,3827,1495,1688199,11700,11700,11700,5,1,0,401796,343130,5,0
102900,272210,11750,2,100,0.86,89.55,832756,745710,-87046,2335,3838,1503,1690202,11700,11750,11700,2008,4,11,400749,342151,205,1803
103000,272210,11750,2,100,0.86,89.57,832823,745952,-86871,2339,3842,1503,1690511,11750,11750,11750,0,0,0,402333,342506,0,0
103000,272210,11750,2,100,0.86,89.61,833128,746566,-86562,2342,3852,1510,1691430,11700,11750,11700,919,3,10,402609,343159,305,614
103100,272210,11800,2,150,1.29,89.67,833288,747211,-86077,2344,3860,1516,1692235,11800,11800,11800,0,0,0,485865,323878,0,0
103100,272210,11750,2,100,0.86,89.49,835173,747432,-87741,2348,3862,1514,1694341,11750,11800,11750,2106,4,2,485326,331388,1885,221
103200,272210,11750,2,100,0.86,89.46,835674,747590,-88084,2352,3864,1512,1695000,11750,11750,11750,0,0,0,485156,331196,0,0
103200,272210,11750,2,100,0.86,89.46,835889,747821,-88068,2357,3872,1515,1695446,11800,11800,11750,446,5,8,487442,333408,215,231
103300,272210,11800,2,150,1.29,89.59,835935,748896,-87039,2358,3875,1517,1696567,11800,11800,11800,1002,0,2,486142,334696,0,1002
103300,272210,11800,2,150,1.29,89.43,837535,749035,-88500,2359,3877,1518,1698306,11800,11800,11750,2741,1,4,486384,334201,1600,1141
103400,272210,11800,2,150,1.29,89.54,838138,750450,-87688,2362,3895,1533,1700324,11800,11800,11800,340,0,13,484737,335073,0,340
103400,272210,11800,2,150,1.29,89.35,840333,750839,-89494,2384,3923,1539,1702908,11800,11800,11750,2924,22,41,484752,335454,2195,729
103500,272210,11800,2,150,1.29,89.56,840341,752586,-87755,2385,3954,1569,1704663,11800,11800,11800,1715,0,15,485164,336028,0,1715
103500,272210,11800,2,150,1.29,89.47,841643,752987,-88656,2389,3962,1573,1706366,11800,11800,11750,3418,4,23,485999,333856,1302,2116
103600,272210,11750,2,100,0.86,88.91,847097,753172,-93925,2399,3964,1565,1712005,11800,11800,11750,3038,5,2,486141,330616,2853,185
103600,272210,11800,2,150,1.29,88.97,847143,753742,-93401,2400,3967,1567,1712621,11800,11800,11750,3654,6,5,484395,328970,2899,755
103700,272210,11750,2,100,0.86,88.92,848166,754182,-93984,2405,3973,1568,1714084,11750,11750,11750,938,3,0,484621,329479,938,0
103700,272210,11750,2,100,0.86,88.81,849465,754385,-95080,2412,3976,1564,1715586,11750,11800,11750,2440,10,3,484176,329235,2237,203
103800,272210,11750,2,100,0.86,88.69,850765,754537,-96228,2419,3979,1560,1717038,11750,11800,11750,1312,6,3,485532,328449,1160,152
103800,272210,11750,2,100,0.86,88.56,852627,755073,-97554,2425,3988,1563,1719436,11750,11800,11700,3710,12,12,401896,344843,3022,688
103900,272210,11750,2,100,0.86,88.76,853127,757262,-95865,2426,3993,1567,1722125,11750,11750,11700,2647,1,4,402103,345093,500,2147
103900,272210,11750,2,100,0.86,88.9,853435,758716,-94719,2428,4001,1573,1723887,11750,11750,11700,4409,3,12,485641,332943,808,3601
104000,272210,11800,2,150,1.29,88.88,853843,758922,-94921,2435,4005,1570,1724501,11750,11800,11750,219,4,2,486869,335748,161,58
104000,272210,11800,2,150,1.29,89.01,853903,760070,-93833,2437,4012,1575,1725709,11750,11800,11750,1427,6,9,485359,340945,221,1206
104100,272210,11800,2,150,1.29,89.05,853938,760424,-93514,2439,4018,1579,1726098,11800,11800,11750,389,2,6,484987,344757,35,354
104100,272210,11800,2,150,1.29,89.14,854104,761307,-92797,2442,4028,1586,1727147,11800,11800,11750,1438,5,16,485280,347768,201,1237
104200,272210,11800,2,150,1.29,89.23,854163,762149,-92014,2443,4037,1594,1728048,11800,11800,11750,595,1,7,483855,347796,59,536
104300,272210,11800,2,150,1.29,88.71,859347,762315,-97032,2451,4039,1588,1733398,11800,11800,11800,0,0,0,484918,343592,0,0
104300,272210,11800,2,150,1.29,88.83,859372,763390,-95982,2452,4044,1592,1734498,11800,11800,11750,1100,1,5,479622,343287,25,1075
104400,272210,11750,2,100,0.86,88.84,859418,763465,-95953,2453,4045,1592,1734619,11750,11750,11750,0,0,0,480516,345528,0,0
104400,272210,11800,2,150,1.29,88.79,860040,763600,-96440,2462,4052,1590,1735376,11750,11800,11750,757,9,7,481088,352951,622,135
104500,272210,11750,2,100,0.86,88.69,861122,763761,-97361,2467,4055,1588,1736619,11750,11750,11750,87,1,0,480659,353360,87,0
104500,272210,11800,2,150,1.29,88.73,861122,764034,-97088,2467,4059,1592,1736892,11750,11800,11750,360,1,4,479919,353148,87,273
104600,272210,11750,2,100,0.86,88.58,862657,764108,-98549,2472,4061,1589,1738501,11750,11750,11750,10,1,0,480044,351999,10,0
104600,272210,11800,2,150,1.29,88.61,863043,764781,-98262,2475,4066,1591,1739560,11750,11800,11750,1069,4,5,480541,357712,396,673
104700,272210,11750,2,100,0.86,88.67,864090,766173,-97917,2481,4073,1592,1741999,11750,11800,11750,1247,4,3,479662,358025,992,255
104700,272210,11800,2,150,1.29,88.62,864824,766388,-98436,2486,4080,1594,1742948,11750,11800,11750,2196,9,10,479263,359155,1726,470
104800,272210,11750,2,100,0.86,88.62,864837,766461,-98376,2489,4081,1592,1743034,11750,11750,11750,3,1,0,479976,363780,3,0
104800,272210,11750,2,100,0.86,88.3,868231,766669,-101562,2493,4084,1591,1746636,11750,11800,11750,3605,5,3,478844,362842,3397,208
104900,272210,11800,2,150,1.29,88.34,868394,767124,-101270,2497,4087,1590,1747254,11800,11800,11800,300,0,1,485263,362666,0,300
104900,272210,11750,2,100,0.86,88.35,868509,767322,-101187,2500,4090,1590,1747567,11800,11800,11750,613,3,4,485036,363195,115,498
105000,272210,11800,2,150,1.29,88.36,868509,767406,-101103,2500,4092,1592,1747651,11800,11800,11800,84,0,2,485231,363259,0,84
105000,272210,11750,2,100,0.86,88.29,869677,767840,-101837,2510,4101,1591,1749253,11800,11800,11750,1686,10,11,485474,362492,1168,518
105100,272210,11800,2,150,1.29,88.21,871265,768577,-102688,2517,4107,1590,1751578,11750,11800,11750,1674,5,3,485202,360611,1119,555
105100,272210,11800,2,150,1.29,88.42,871266,770402,-100864,2518,4114,1596,1753404,11750,11800,11750,3500,6,10,483236,360621,1120,2380
105200,272210,11800,2,150,1.29,88.53,871465,771467,-99998,2520,4118,1598,1754668,11750,11800,11750,129,1,1,483521,360692,127,2
105200,272210,11800,2,150,1.29,88.72,871639,773278,-98361,2521,4121,1600,1756653,11750,11800,11750,2114,2,4,483562,330493,301,1813
105300,272210,11800,2,150,1.29,89.16,871639,777123,-94516,2521,4133,1612,1760498,11800,11800,11800,3564,0,9,478606,330105,0,3564
105300,272210,11800,2,150,1.29,89.17,871715,777348,-94367,2523,4141,1618,1760799,11800,11800,11750,3865,2,17,478745,330234,76,3789
105400,272210,11800,2,150,1.29,89.19,871777,777521,-94256,2525,4144,1619,1761034,11750,11800,11750,134,2,1,478854,333199,62,72
105400,272210,11800,2,150,1.29,89.19,871924,777628,-94296,2529,4147,1618,1761288,11750,11800,11750,388,6,4,479567,334170,209,179
105500,272210,11800,2,150,1.29,89.1,873213,778016,-95197,2532,4151,1619,1762965,11750,11800,11750,1677,3,4,479589,333622,1289,388
105600,272210,11800,2,150,1.29,89.13,873213,778286,-94927,2532,4157,1625,1763235,11800,11800,11800,0,0,0,479818,334018,0,0
105600,272210,11800,2,150,1.29,89.11,873513,778420,-95093,2536,4163,1627,1763669,11750,11800,11750,434,4,6,480504,335054,300,134
105700,272210,11800,2,150,1.29,89.11,874008,778821,-95187,2538,4169,1631,1764565,11800,11800,11800,0,0,0,481181,336076,0,0
105700,272210,11750,2,100,0.86,88.95,875676,778894,-96782,2544,4171,1627,1766306,11750,11800,11750,1741,6,2,481288,337219,1668,73
105800,272210,11750,2,100,0.86,88.84,876793,778966,-97827,2548,4172,1624,1767495,11750,11750,11750,0,0,0,481445,334171,0,0
105800,272210,11800,2,150,1.29,88.88,876839,779363,-97476,2549,4176,1627,1767938,11750,11800,11750,443,1,4,481501,334295,46,397
105900,272210,11800,2,150,1.29,88.93,876839,779764,-97075,2549,4182,1633,1768339,11800,11800,11800,0,0,0,481020,336447,0,0
105900,272210,11800,2,150,1.29,88.98,877101,780431,-96670,2551,4195,1644,1769268,11800,11800,11750,929,2,13,480267,338123,262,667
110000,272210,11800,2,150,1.29,88.96,877301,780433,-96868,2552,4196,1644,1769470,11800,11800,11800,0,0,0,480223,337923,0,0
110000,272210,11800,2,150,1.29,89.04,877320,781132,-96188,2555,4199,1644,1770188,11750,11800,11750,718,3,3,480687,338603,19,699
110100,272210,11750,2,100,0.86,89.1,877394,781764,-95630,2556,4206,1650,1770894,11750,11750,11750,0,0,0,480430,338544,0,0
110100,272210,11750,2,100,0.86,89.0,878541,781928,-96613,2561,4208,1647,1772205,11750,11800,11750,1311,5,2,481853,337307,1147,164
110200,272210,11750,2,100,0.86,88.96,879265,782211,-97054,2568,4211,1643,1773212,11750,11750,11750,100,1,0,481264,338001,100,0
110200,272210,11750,2,100,0.86,88.96,879427,782345,-97082,2572,4217,1645,1773508,11750,11800,11750,396,5,6,481591,339712,262,134
110300,272210,11750,2,100,0.86,88.94,879999,782653,-97346,2578,4220,1642,1774388,11800,11800,11750,464,3,2,479910,339151,232,232
110300,272210,11750,2,100,0.86,87.6,893600,782802,-110798,2590,4222,1632,1788138,11800,11800,11750,14214,15,4,482198,326056,13833,381
110400,272210,11800,2,150,1.29,87.22,897691,782952,-114739,2597,4226,1629,1792379,11750,11800,11750,1410,4,1,484854,324855,1353,57
110400,272210,11750,2,100,0.86,87.12,898816,783027,-115789,2602,4227,1625,1793579,11750,11800,11750,2610,9,2,484801,326634,2478,132
110500,272210,11750,2,100,0.86,87.04,899647,783027,-116620,2609,4227,1618,1794410,11750,11750,11750,560,3,0,484225,327235,560,0
110500,272210,11700,2,50,0.43,86.28,908868,784194,-124674,2616,4234,1618,1804798,11750,11800,11700,10948,10,7,483565,327401,9781,1167
110600,272210,11700,2,50,0.43,86.28,908937,784194,-124743,2618,4234,1616,1804867,11700,11700,11700,0,0,0,401053,328626,0,0
110600,272210,11750,2,100,0.86,86.41,909994,786341,-123653,2623,4240,1617,1808071,11750,11800,11750,3204,5,6,400172,331030,1057,2147
110700,272210,11750,2,100,0.86,86.43,910103,786599,-123504,2625,4243,1618,1808438,11800,11800,11750,134,1,1,481221,327451,36,98
110700,272210,11750,2,100,0.86,86.37,910910,786736,-124174,2627,4246,1619,1809382,11800,11800,11750,1078,3,4,490620,340290,843,235
110800,272210,11800,2,150,1.29,85.64,919047,787027,-132020,2635,4249,1614,1817810,11750,11800,11750,8424,6,3,491447,332256,8133,291
110800,272210,11800,2,150,1.29,85.67,919289,787587,-131702,2640,4255,1615,1818612,11750,11800,11750,9226,11,9,492439,332979,8375,851
110900,272210,11750,2,100,0.86,85.98,920191,791154,-129037,2644,4260,1616,1823081,11750,11800,11750,4427,4,4,488503,330934,902,3525
110900,272210,11750,2,100,0.86,85.98,920221,791208,-129013,2645,4261,1616,1823165,11750,11800,11750,4511,5,5,489307,330995,932,3579
111000,272210,11750,2,100,0.86,85.96,920702,791393,-129309,2649,4264,1615,1823831,11800,11800,11750,595,3,3,489234,331726,410,185
111100,272210,11750,2,100,0.86,85.95,920862,791482,-129380,2653,4265,1612,1824080,11750,11750,11750,0,0,0,489526,333591,0,0
111100,272210,11750,2,100,0.86,85.93,921222,791568,-129654,2656,4267,1611,1824526,11800,11800,11750,446,3,2,489823,334473,360,86
111200,272210,11800,2,150,1.29,85.99,921222,792187,-129035,2656,4278,1622,1825145,11800,11800,11800,0,0,0,488762,332974,0,0
111200,272210,11750,2,100,0.86,86.01,921592,792646,-128946,2660,4283,1623,1825974,11800,11800,11750,829,4,5,489097,333147,370,459
111300,272210,11800,2,150,1.29,86.04,921850,793131,-128719,2667,4293,1626,1826717,11750,11800,11750,154,2,1,489342,335006,75,79
111300,272210,11800,2,150,1.29,86.04,921880,793198,-128682,2668,4296,1628,1826814,11750,11800,11750,251,3,4,491186,335730,105,146
111400,272210,11750,2,100,0.86,86.05,922058,793461,-128597,2669,4302,1633,1827255,11750,11750,11750,178,1,0,490874,335302,178,0
111400,272210,11750,2,100,0.86,85.5,928217,793628,-134589,2678,4308,1630,1833581,11750,11800,11750,6504,10,6,491001,329311,6337,167
111500,272210,11800,2,150,1.29,85.48,928417,793634,-134783,2680,4310,1630,1833787,11800,11800,11800,2,0,1,492703,329322,0,2
111500,272210,11800,2,150,1.29,85.57,928417,794421,-133996,2680,4311,1631,1834574,11800,11800,11800,789,0,2,493578,328609,0,789
111600,272210,11750,2,100,0.86,85.38,931668,795496,-136172,2687,4313,1626,1838900,11750,11800,11750,1126,2,1,502411,324885,126,1000
111600,272210,11800,2,150,1.29,85.36,932277,795750,-136527,2691,4316,1625,1839763,11750,11800,11750,1989,6,4,503294,324777,735,1254
111700,272210,11800,2,150,1.29,85.4,932347,796179,-136168,2692,4319,1627,1840262,11750,11800,11750,215,1,1,503414,324692,70,145
111700,272210,11750,2,100,0.86,85.35,933262,796500,-136762,2696,4328,1632,1841498,11750,11800,11750,1451,5,10,501369,324777,985,466
111800,272210,11750,2,100,0.86,85.36,933267,796651,-136616,2697,4333,1636,1841654,11750,11750,11750,5,1,0,500919,327691,5,0
111800,272210,11800,2,150,1.29,85.32,933867,796815,-137052,2698,4336,1638,1842418,11750,11800,11750,769,2,3,502256,328053,605,164
111900,272210,11750,2,100,0.86,85.28,934492,796917,-137575,2703,4338,1635,1843145,11750,11750,11750,603,4,0,502595,331101,603,0
111900,272210,11750,2,100,0.86,85.33,934746,797650,-137096,2709,4341,1632,1844132,11750,11800,11750,1590,10,3,504406,329914,857,733
112000,272210,11750,2,100,0.86,85.27,935470,797650,-137820,2716,4341,1625,1844856,11750,11750,11750,515,4,0,496729,328989,515,0
112000,272210,11800,2,150,1.29,84.93,939205,797708,-141497,2764,4346,1582,1848649,11750,11800,11750,4308,52,5,493205,325689,4250,58
112100,272210,11800,2,150,1.29,84.96,939206,797928,-141278,2765,4348,1583,1848870,11750,11800,11750,221,1,2,494158,328769,1,220
112100,272210,11800,2,150,1.29,84.89,940349,798231,-142118,2769,4353,1584,1850316,11750,11800,11750,1667,5,7,493861,328159,1144,523
112200,272210,11750,2,100,0.86,84.72,942415,798435,-143980,2776,4355,1579,1852586,11750,11800,11750,315,6,1,493662,325179,256,59
112200,272210,11750,2,100,0.86,84.64,943767,798774,-144993,2782,4360,1578,1854277,11750,11800,11750,2006,12,6,494378,324214,1608,398
112300,272210,11750,2,100,0.86,84.56,944807,798950,-145857,2790,4363,1573,1855493,11800,11800,11750,1216,8,3,493226,322996,1040,176
112300,272210,11800,2,150,1.29,84.5,945599,799021,-146578,2796,4369,1573,1856356,11800,11800,11750,2079,14,9,492614,322710,1832,247
112400,272210,11800,2,150,1.29,84.51,945599,799087,-146512,2796,4371,1575,1856422,11800,11800,11800,66,0,2,492259,323416,0,66
112400,272210,11800,2,150,1.29,84.53,945599,799351,-146248,2796,4374,1578,1856686,11800,11800,11800,330,0,5,493021,323958,0,330
112500,272210,11800,2,150,1.29,84.54,945670,799426,-146244,2797,4375,1578,1856832,11750,11800,11750,146,1,1,492197,325479,71,75
112600,272210,11800,2,150,1.29,84.55,945670,799574,-146096,2797,4381,1584,1856980,11800,11800,11800,0,0,0,492397,326654,0,0
112600,272210,11800,2,150,1.29,84.56,945813,799740,-146073,2800,4384,1584,1857289,11800,11800,11750,309,3,3,494082,327505,143,166
112700,272210,11800,2,150,1.29,84.59,945913,800166,-145747,2801,4393,1592,1857815,11800,11800,11800,0,0,0,493551,327403,0,0
112700,272210,11800,2,150,1.29,84.59,946059,800241,-145818,2803,4394,1591,1858036,11750,11800,11750,221,2,1,494528,327196,146,75
112800,272210,11750,2,100,0.86,84.54,946863,800520,-146343,2808,4396,1588,1859119,11750,11750,11750,144,3,0,497523,325821,144,0
112800,272210,11800,2,150,1.29,84.55,947045,800716,-146329,2810,4400,1590,1859497,11750,11800,11750,522,5,4,497290,325706,326,196
112900,272210,11800,2,150,1.29,84.53,947316,800791,-146525,2814,4401,1587,1859843,11800,11800,11800,75,0,1,501222,326370,0,75
112900,272210,11800,2,150,1.29,83.84,955503,801055,-154448,2821,4407,1586,1868294,11800,11800,11750,8526,7,7,496284,313670,8187,339
113000,272210,11750,2,100,0.86,83.79,956079,801060,-155019,2826,4409,1583,1868875,11750,11750,11750,175,2,0,496505,315471,175,0
113000,272210,11750,2,100,0.86,81.98,977368,801247,-176121,2834,4413,1579,1890351,11750,11800,11700,21651,10,4,412434,304454,21464,187
113100,272210,11700,2,50,0.43,81.99,977521,801454,-176067,2839,4416,1577,1890711,11700,11700,11700,76,2,0,412708,305746,76,0
113100,272210,11750,2,100,0.86,81.71,981393,801857,-179536,2841,4423,1582,1894986,11700,11750,11700,4351,4,7,413226,304513,3948,403
113200,272210,11750,2,100,0.86,81.73,981401,802138,-179263,2842,4428,1586,1895275,11750,11750,11750,281,0,5,414416,304750,0,281
113200,272210,11750,2,100,0.86,81.78,981468,802603,-178865,2843,4440,1597,1895807,11750,11750,11700,813,1,17,414712,303414,67,746
113300,272210,11750,2,100,0.86,81.87,981468,803531,-177937,2843,4447,1604,1896735,11750,11750,11750,199,0,3,414352,304261,0,199
113300,272210,11800,2,150,1.29,82.14,981785,806487,-175298,2848,4452,1604,1900008,11750,11800,11700,3472,5,8,496616,298408,317,3155
113400,272210,11800,2,150,1.29,82.11,982332,806604,-175728,2851,4454,1603,1900672,11750,11800,11750,189,2,2,496781,298438,72,117
113400,272210,11800,2,150,1.29,82.12,982400,806726,-175674,2853,4456,1603,1900862,11750,11800,11750,379,4,4,497155,298573,140,239
113500,272210,11750,2,100,0.86,82.15,982513,807148,-175365,2856,4458,1602,1901397,11750,11800,11750,250,3,1,496731,299431,113,137
113500,272210,11750,2,100,0.86,82.11,983263,807347,-175916,2861,4466,1605,1902346,11750,11800,11750,1199,8,9,412943,310983,863,336
113600,272210,11750,2,100,0.86,82.18,983292,808099,-175193,2863,4475,1612,1903127,11700,11750,11700,567,2,6,412925,319334,29,538
113600,272210,11750,2,100,0.86,82.15,984080,808400,-175680,2868,4479,1611,1904216,11700,11800,11700,1656,7,10,496857,313632,817,839
113700,272210,11750,2,100,0.86,82.1,984689,808400,-176289,2874,4479,1605,1904825,11750,11750,11750,609,6,0,497736,315719,609,0
113700,272210,11800,2,150,1.29,82.15,984689,808935,-175754,2874,4486,1612,1905360,11750,11800,11750,1144,6,7,510466,318575,609,535
113800,272210,11800,2,150,1.29,82.14,985170,809242,-175928,2879,4494,1615,1906148,11800,11800,11750,788,5,8,510264,320865,481,307
113900,272210,11750,2,100,0.86,82.14,985308,809317,-175991,2884,4495,1611,1906361,11750,11750,11750,0,0,0,511089,327279,0,0
113900,272210,11750,2,100,0.86,82.09,985966,809420,-176546,2890,4500,1610,1907122,11800,11800,11750,761,6,5,511075,327313,658,103
114000,272210,11750,2,100,0.86,82.03,986741,809420,-177321,2894,4500,1606,1907897,11750,11750,11750,70,1,0,511847,327023,70,0
114000,272210,11750,2,100,0.86,82.03,987161,809776,-177385,2897,4504,1607,1908673,11750,11800,11750,846,4,4,511505,324397,490,356
114100,272210,11750,2,100,0.86,82.03,987186,809776,-177410,2898,4504,1606,1908698,11750,11750,11750,0,0,0,510715,327723,0,0
114100,272210,11750,2,100,0.86,81.99,988030,810088,-177942,2902,4510,1608,1909854,11750,11800,11750,1156,4,6,510668,328467,844,312
114200,272210,11750,2,100,0.86,82.27,988031,812883,-175148,2903,4519,1616,1912650,11800,11800,11750,85,1,3,508072,329666,1,84
114200,272210,11800,2,150,1.29,82.32,988130,813475,-174655,2904,4528,1624,1913341,11800,11800,11750,776,2,12,507255,329512,100,676
114300,272210,11800,2,150,1.29,82.35,988201,813751,-174450,2905,4533,1628,1913688,11800,11800,11750,178,1,4,506862,330938,71,107
114300,272210,11800,2,150,1.29,82.42,988201,814439,-173762,2905,4543,1638,1914376,11800,11800,11750,866,1,14,503696,338506,71,795
114400,272210,11800,2,150,1.29,82.7,988201,817231,-170970,2905,4552,1647,1917168,11800,11800,11800,1272,0,8,501530,340464,0,1272
114400,272210,11750,2,100,0.86,82.7,988391,817360,-171031,2909,4557,1648,1917487,11800,11800,11750,1591,4,13,500521,340632,190,1401
114500,272210,11750,2,100,0.86,82.62,989327,817417,-171910,2912,4560,1648,1918480,11750,11800,11750,993,3,3,501178,344670,936,57
114500,272210,11750,2,100,0.86,82.56,990071,817419,-172652,2916,4561,1645,1919226,11750,11800,11750,1739,7,4,501972,343802,1680,59
114600,272210,11800,2,150,1.29,82.58,990296,817822,-172474,2918,4565,1647,1919854,11750,11800,11750,509,2,3,501655,344664,225,284
114600,272210,11750,2,100,0.86,82.79,990297,819833,-170464,2919,4572,1653,1921866,11750,11800,11750,2521,3,10,501914,341696,226,2295
114700,272210,11850,2,200,1.72,85.49,990297,846573,-143724,2919,4589,1670,1948606,11800,11850,11800,26740,0,17,562490,317738,0,26740
114700,272210,11850,2,200,1.72,85.54,990387,847195,-143192,2922,4599,1677,1949318,11800,11850,11800,27452,3,27,564931,317270,90,27362
114800,272210,11850,2,200,1.72,85.57,990750,847786,-142964,2924,4609,1685,1950272,11850,11850,11800,733,2,7,565803,311675,363,370
114800,272210,11850,2,200,1.72,85.52,992030,848379,-143651,2930,4615,1685,1952145,11850,11850,11800,2606,8,13,565537,316076,1643,963
114900,272210,11850,2,200,1.72,85.5,992405,848530,-143875,2933,4618,1685,1952671,11800,11850,11800,526,3,3,566338,316955,375,151
115000,272210,11850,2,200,1.72,85.52,992554,848796,-143758,2935,4622,1687,1953086,11850,11850,11850,0,0,0,567424,314573,0,0
115000,272210,11850,2,200,1.72,85.5,992876,848908,-143968,2939,4627,1688,1953520,11800,11850,11800,434,4,5,571357,317118,322,112
115100,272210,11800,2,150,1.29,85.48,993094,848908,-144186,2942,4627,1685,1953738,11800,11800,11800,4,1,0,572276,316736,4,0
115100,272210,11850,2,200,1.72,85.47,993644,849277,-144367,2944,4632,1688,1954657,11800,11850,11800,923,3,5,572353,316626,554,369
115200,272210,11850,2,200,1.72,85.51,993670,849699,-143971,2946,4636,1690,1955105,11850,11850,11850,0,0,0,572114,317378,0,0
115200,272210,11850,2,200,1.72,85.63,993788,850984,-142804,2948,4643,1695,1956508,11800,11850,11800,1403,2,7,573522,315396,118,1285
115300,272210,11800,2,150,1.29,85.61,994139,851077,-143062,2951,4644,1693,1956952,11850,11850,11800,393,1,1,574240,317334,300,93
115300,272210,11800,2,150,1.29,85.65,994568,851833,-142735,2954,4659,1705,1958137,11850,11850,11800,1578,4,16,574322,336412,729,849
115400,272210,11900,2,250,2.15,89.57,995164,891334,-103830,2955,4676,1721,1998234,11850,11900,11850,36572,1,9,601776,313475,596,35976
115400,272210,11900,2,250,2.15,91.21,995164,907736,-87428,2955,4727,1772,2014636,11850,11900,11850,52974,1,60,586151,303808,596,52378
115500,272210,11950,2,300,2.58,93.44,995255,929975,-65280,2957,4810,1853,2036966,11900,11950,11850,12240,1,38,631174,276047,71,12169
115500,272210,11900,2,250,2.15,93.26,1002182,934590,-67592,2968,4851,1883,2048508,11900,11950,11850,23782,12,79,629916,269504,6998,16784
115600,272210,11950,2,300,2.58,93.38,1006527,939899,-66628,2974,4894,1920,2058162,11900,11950,11850,4491,5,15,630615,272998,1655,2836
115600,272210,11900,2,250,2.15,93.53,1007397,942217,-65180,2978,4928,1950,2061350,11900,11950,11850,7679,9,49,628978,286873,2525,5154
115700,272210,11900,2,250,2.15,93.78,1007613,944932,-62681,2983,4953,1970,2064281,11950,11950,11900,2706,3,15,629700,293260,200,2506
115700,272210,11950,2,300,2.58,94.08,1007813,948153,-59660,2984,4992,2008,2067702,11950,11950,11900,6127,4,54,632077,295372,400,5727
115800,272210,11950,2,300,2.58,94.12,1009385,950011,-59374,2988,5023,2035,2071132,11950,11950,11900,3320,4,22,631733,294441,1572,1748
115800,272210,11950,2,300,2.58,94.12,1010374,950959,-59415,2996,5044,2048,2073069,11950,11950,11900,5257,12,43,631466,303882,2561,2696
115900,272210,11950,2,300,2.58,94.23,1010550,952252,-58298,3000,5054,2054,2074538,11950,11950,11900,1074,1,7,634351,304520,1,1073
115900,272210,11950,2,300,2.58,94.29,1010737,952988,-57749,3007,5066,2059,2075461,11950,11950,11900,1997,8,19,634315,300470,188,1809
120000,272210,11900,2,250,2.15,94.41,1011071,954507,-56564,3011,5074,2063,2077314,11950,11950,11900,1606,3,7,632684,299624,234,1372
120000,272210,11900,2,250,2.15,94.4,1011235,954654,-56581,3017,5077,2060,2077625,11950,11950,11900,1917,9,10,633580,302095,398,1519
120100,272210,11900,2,250,2.15,94.32,1012351,954816,-57535,3023,5079,2056,2078903,11900,11950,11900,1191,6,1,634292,301306,1116,75
120200,272210,11900,2,250,2.15,92.34,1035442,956090,-79352,3039,5083,2044,2103268,11900,11900,11900,89,0,1,589374,310113,0,89
120200,272210,11850,2,200,1.72,92.11,1040242,958141,-82101,3054,5091,2037,2110119,11900,11900,11850,6940,15,9,588099,307628,4800,2140
120300,272210,11850,2,200,1.72,91.95,1042049,958142,-83907,3069,5092,2023,2111927,11850,11850,11850,101,2,0,588336,308598,101,0
120300,272210,11850,2,200,1.72,91.93,1042826,958648,-84178,3080,5099,2019,2113210,11850,11900,11850,1384,13,7,588709,309814,878,506
120400,272210,11800,2,150,1.29,91.46,1048259,958687,-89572,3087,5101,2014,2118682,11900,11900,11800,3656,4,1,529242,323226,3621,35
120400,272210,11850,2,200,1.72,91.46,1048421,958936,-89485,3089,5107,2018,2119093,11900,11900,11800,4067,6,7,525419,323886,3783,284
120500,272210,11850,2,200,1.72,91.55,1048560,959911,-88649,3092,5113,2021,2120207,11850,11850,11850,975,0,6,524169,326881,0,975
120500,272210,11850,2,200,1.72,91.74,1048888,962255,-86633,3095,5122,2027,2122879,11850,11850,11800,3647,3,15,588865,309220,328,3319
120600,272210,11900,2,250,2.15,91.73,1049078,962361,-86717,3099,5125,2026,2123175,11900,11900,11850,265,3,2,588114,315964,160,105
120600,272210,11800,2,150,1.29,91.31,1054439,962761,-91678,3103,5126,2023,2128936,11900,11900,11800,6026,7,3,523945,335704,5521,505
120700,272210,11850,2,200,1.72,91.3,1054761,963035,-91726,3108,5130,2022,2129532,11800,11850,11800,425,4,2,526409,337004,276,149
120700,272210,11850,2,200,1.72,91.35,1054761,963523,-91238,3108,5137,2029,2130020,11800,11850,11800,913,4,9,526953,346510,276,637
120800,272210,11850,2,200,1.72,91.4,1054761,964102,-90659,3108,5147,2039,2130599,11850,11850,11850,579,0,10,527346,347183,0,579
120900,272210,11850,2,200,1.72,91.36,1055663,964421,-91242,3113,5151,2038,2131820,11800,11850,11800,958,2,2,528304,345633,800,158
120900,272210,11850,2,200,1.72,91.38,1055688,964725,-90963,3114,5153,2039,2132149,11800,11850,11800,1287,3,4,528337,348279,825,462
121000,272210,11800,2,150,1.29,91.33,1056378,964772,-91606,3121,5154,2033,2132886,11800,11850,11800,727,6,1,529341,348917,680,47
121000,272210,11850,2,200,1.72,91.22,1057944,965102,-92842,3123,5159,2036,2134782,11800,11850,11800,2623,8,6,528879,348841,2246,377
121100,272210,11850,2,200,1.72,91.15,1059071,965340,-93731,3126,5161,2035,2136147,11800,11850,11800,365,2,2,529656,350154,127,238
121100,272210,11800,2,150,1.29,91.22,1059282,966319,-92963,3129,5169,2040,2137337,11800,11850,11800,1555,5,10,529401,351219,338,1217
121200,272210,11800,2,150,1.29,91.21,1059688,966526,-93162,3132,5173,2041,2137950,11850,11850,11800,209,1,4,528275,350405,2,207
121200,272210,11900,2,250,2.15,92.01,1059788,975156,-84632,3133,5179,2046,2146680,11850,11900,11800,8939,2,10,586507,339809,102,8837
121300,272210,11850,2,200,1.72,92.01,1060010,975338,-84672,3138,5182,2044,2147084,11850,11900,11850,404,5,3,579577,345292,222,182
121400,272210,11900,2,250,2.15,92.09,1060010,976181,-83829,3138,5189,2051,2147927,11900,11900,11900,0,0,0,578991,345676,0,0
121400,272210,11900,2,250,2.15,92.12,1060056,976501,-83555,3139,5199,2060,2148293,11900,11900,11850,366,1,10,579115,346140,46,320
121500,272210,11900,2,250,2.15,92.11,1060305,976689,-83616,3144,5203,2059,2148730,11900,11900,11900,0,0,0,578892,346871,0,0
121500,272210,11900,2,250,2.15,92.23,1060305,977943,-82362,3144,5214,2070,2149984,11900,11900,11900,1254,0,11,578369,347072,0,1254
121600,272210,11850,2,200,1.72,92.23,1060580,978126,-82454,3146,5221,2075,2150442,11900,11900,11850,371,2,3,579626,347049,275,96
121600,272210,11900,2,250,2.15,92.24,1060940,978564,-82376,3149,5225,2076,2151240,11900,11900,11850,1169,5,7,579336,347443,635,534
121700,272210,11850,2,200,1.72,92.23,1061225,978736,-82489,3151,5227,2076,2151697,11850,11850,11850,260,1,0,579749,349656,260,0
121700,272210,11900,2,250,2.15,92.27,1061288,979207,-82081,3152,5235,2083,2152231,11850,11900,11850,794,2,8,579710,349627,323,471
121800,272210,11950,2,300,2.58,93.52,1061354,992537,-68817,3154,5248,2094,2165627,11950,11950,11950,123,0,1,636193,310326,0,123
121800,272210,11900,2,250,2.15,93.55,1061553,993045,-68508,3156,5255,2099,2166334,11950,11950,11900,830,2,8,635748,312003,199,631
121900,272210,11950,2,300,2.58,93.62,1062738,994906,-67832,3162,5266,2104,2169380,11900,11950,11900,2777,3,7,635264,311174,1025,1752
121900,272210,11900,2,250,2.15,93.43,1066449,996403,-70046,3167,5277,2110,2174588,11900,11950,11900,7985,8,18,634175,307536,4736,3249
122000,272210,11950,2,300,2.58,93.34,1068413,997307,-71106,3170,5287,2117,2177456,11900,11950,11900,2498,3,6,634425,308085,1964,534
122000,272210,11900,2,250,2.15,93.31,1068939,997383,-71556,3178,5293,2115,2178058,11900,11950,11900,3100,11,12,634837,305667,2490,610
122100,272210,11950,2,300,2.58,93.32,1068943,997527,-71416,3179,5296,2117,2178206,11950,11950,11900,128,1,2,635827,306348,4,124
122100,272210,11900,2,250,2.15,92.57,1077814,997732,-80082,3188,5300,2112,2187282,11950,11950,11900,9204,10,6,636160,301021,8875,329
122200,272210,11850,2,200,1.72,92.59,1077902,998038,-79864,3191,5305,2114,2187676,11900,11900,11850,247,3,2,575151,333714,88,159
122200,272210,11900,2,250,2.15,92.61,1077902,998197,-79705,3191,5310,2119,2187835,11900,11900,11850,406,3,7,576301,336420,88,318
122300,272210,11900,2,250,2.15,92.96,1077914,1002053,-75861,3192,5324,2132,2191703,11900,11900,11850,3868,1,14,575517,337310,12,3856
122300,272210,11900,2,250,2.15,93.04,1077979,1002899,-75080,3193,5337,2144,2192614,11900,11900,11850,4779,2,27,575510,337460,77,4702
122400,272210,11900,2,250,2.15,93.1,1078004,1003620,-74384,3194,5343,2149,2193360,11900,11900,11850,646,1,5,579344,337075,25,621
122400,272210,11900,2,250,2.15,93.11,1078074,1003832,-74242,3196,5349,2153,2193642,11900,11900,11850,928,3,11,579913,337506,95,833
122500,272210,11900,2,250,2.15,93.12,1078193,1003989,-74204,3198,5354,2156,2193918,11850,11900,11850,276,2,5,580258,338963,119,157
122600,272210,11850,2,200,1.72,93.23,1078608,1005563,-73045,3200,5359,2159,2195907,11850,11850,11850,0,0,0,577635,342089,0,0
122600,272210,11900,2,250,2.15,93.24,1078608,1005669,-72939,3200,5366,2166,2196013,11900,11900,11900,106,0,7,578296,343070,0,106
122700,272210,11900,2,250,2.15,93.24,1078722,1005852,-72870,3202,5370,2168,2196310,11900,11900,11900,123,0,2,579276,342306,0,123
122700,272210,11900,2,250,2.15,93.26,1078850,1006146,-72704,3205,5378,2173,2196732,11900,11900,11850,545,3,10,579464,346168,128,417
122800,272210,11900,2,250,2.15,93.28,1078875,1006369,-72506,3206,5383,2177,2196980,11900,11900,11900,0,0,0,579294,347243,0,0
122800,272210,11900,2,250,2.15,93.29,1078947,1006587,-72360,3207,5388,2181,2197270,11900,11900,11850,290,1,5,579820,346472,72,218
122900,272210,11900,2,250,2.15,93.31,1078993,1006841,-72152,3208,5394,2186,2197570,11900,11900,11900,135,0,3,582777,344637,0,135
122900,272210,11850,2,200,1.72,93.27,1079753,1007133,-72620,3213,5404,2191,2198622,11900,11900,11850,1187,5,13,582760,344100,760,427
123000,272210,11900,2,250,2.15,93.3,1079917,1007563,-72354,3216,5412,2196,2199216,11850,11900,11850,403,2,5,583959,343859,114,289
123000,272210,11900,2,250,2.15,93.05,1082904,1007683,-75221,3254,5415,2161,2202323,11850,11900,11850,3510,40,8,581027,341053,3101,409
123100,272210,11900,2,250,2.15,93.04,1083128,1007737,-75391,3258,5419,2161,2202601,11850,11900,11850,130,3,2,583633,330329,126,4
123100,272210,11850,2,200,1.72,93.03,1083343,1007814,-75529,3260,5421,2161,2202893,11850,11900,11850,422,5,4,583971,331104,341,81
123200,272210,11850,2,200,1.72,93.01,1083519,1007816,-75703,3263,5422,2159,2203071,11850,11900,11850,78,2,1,586317,332491,76,2
123200,272210,11900,2,250,2.15,92.9,1085053,1008011,-77042,3267,5429,2162,2204800,11850,11900,11850,1807,6,8,586326,332145,1610,197
123300,272210,11900,2,250,2.15,92.87,1085595,1008179,-77416,3269,5432,2163,2205510,11850,11900,11850,708,2,2,585410,332536,542,166
123300,272210,11900,2,250,2.15,92.91,1085595,1008660,-76935,3269,5439,2170,2205991,11850,11900,11850,1189,2,9,585266,338135,542,647
123400,272210,11900,2,250,2.15,92.94,1085678,1008997,-76681,3271,5444,2173,2206411,11900,11900,11850,408,1,4,585935,341817,73,335
123400,272210,11850,2,200,1.72,92.89,1086913,1009607,-77306,3274,5451,2177,2208256,11900,11900,11850,2253,4,11,585883,343369,1308,945
123500,272210,11900,2,250,2.15,92.91,1087022,1009994,-77028,3288,5462,2174,2208752,11850,11900,11850,496,14,11,586780,343592,109,387
123600,272210,11850,2,200,1.72,92.85,1087716,1009996,-77720,3300,5463,2163,2209448,11850,11850,11850,46,1,0,586705,344340,46,0
123600,272210,11850,2,200,1.72,92.96,1087735,1011120,-76615,3306,5469,2163,2210591,11850,11900,11850,1189,7,6,586570,343068,65,1124
123700,272210,11900,2,250,2.15,92.91,1088443,1011294,-77149,3320,5475,2155,2211473,11850,11900,11850,429,5,2,587276,336434,318,111
123700,272210,11900,2,250,2.15,92.91,1088543,1011371,-77172,3328,5477,2149,2211650,11850,11900,11850,606,13,4,589212,342474,418,188
123800,272210,11900,2,250,2.15,92.95,1088559,1011870,-76689,3334,5484,2150,2212165,11900,11900,11850,224,2,4,589155,343200,6,218
123800,272210,11850,2,200,1.72,92.97,1088690,1012187,-76503,3344,5492,2148,2212613,11900,11900,11850,672,12,12,590902,343522,137,535
123900,272210,11900,2,250,2.15,93.01,1089031,1012891,-76140,3354,5497,2143,2213658,11900,11900,11850,579,2,2,591295,337561,4,575
123900,272210,11900,2,250,2.15,93.02,1089102,1013110,-75992,3363,5502,2139,2213948,11900,11900,11850,869,11,7,590742,340594,75,794
124000,272210,11900,2,250,2.15,93.11,1089877,1014753,-75124,3372,5507,2135,2216366,11850,11900,11850,2337,9,3,589294,340551,775,1562
124000,272210,11850,2,200,1.72,93.08,1090457,1014955,-75502,3380,5509,2129,2217148,11850,11900,11850,3119,17,5,589150,350969,1355,1764
124100,272210,11850,2,200,1.72,93.06,1090729,1015032,-75697,3392,5511,2119,2217497,11850,11900,11850,35,6,1,590252,351391,33,2
124100,272210,11850,2,200,1.72,93.06,1090947,1015268,-75679,3402,5520,2118,2217951,11850,11900,11850,489,16,10,590369,352105,251,238
124200,272210,11900,2,250,2.15,93.04,1091273,1015362,-75911,3413,5523,2110,2218371,11850,11900,11850,150,10,3,591319,352860,56,94
124300,272210,11850,2,200,1.72,93.09,1091585,1016112,-75473,3425,5535,2110,2219433,11850,11900,11850,80,5,1,591715,352942,78,2
124300,272210,11850,2,200,1.72,93.02,1092612,1016323,-76289,3433,5538,2105,2220671,11850,11900,11850,1318,13,4,591824,352023,1105,213
124400,272210,11900,2,250,2.15,93.02,1092755,1016463,-76292,3445,5541,2096,2220954,11850,11900,11850,52,5,1,596109,352716,37,15
124400,272210,11900,2,250,2.15,93.03,1092849,1016711,-76138,3456,5548,2092,2221296,11850,11900,11850,394,16,8,596268,352416,131,263
124500,272210,11900,2,250,2.15,93.29,1092860,1019535,-73325,3461,5555,2094,2224131,11900,11900,11850,2714,5,5,602925,352159,11,2703
124600,272210,11850,2,200,1.72,93.01,1096316,1019668,-76648,3516,5558,2042,2227720,11850,11850,11850,4,2,0,599443,350613,4,0
124600,272210,11850,2,200,1.72,92.99,1096629,1019769,-76860,3527,5561,2034,2228134,11850,11900,11850,418,13,3,599718,352380,317,101
124700,272210,11900,2,250,2.15,93.08,1096790,1020885,-75905,3536,5567,2031,2229411,11850,11900,11850,138,2,1,599229,350902,22,116
124700,272210,11850,2,200,1.72,93.11,1097100,1021509,-75591,3551,5575,2024,2230345,11850,11900,11850,1072,17,9,599700,350499,332,740
124800,272210,11850,2,200,1.72,93.12,1097241,1021765,-75476,3559,5579,2020,2230742,11900,11900,11850,93,7,1,600278,350649,91,2
124800,272210,11900,2,250,2.15,93.14,1097331,1022012,-75319,3566,5586,2020,2231079,11900,11900,11850,430,14,8,599739,350496,181,249
124900,272210,11900,2,250,2.15,93.06,1098356,1022154,-76202,3584,5593,2009,2232246,11850,11900,11850,868,13,4,602672,350585,862,6
125000,272210,11850,2,200,1.72,92.94,1100356,1022714,-77642,3599,5598,1999,2234806,11850,11900,11850,928,4,2,601504,349253,590,338
125000,272210,11850,2,200,1.72,92.9,1101122,1022974,-78148,3613,5608,1995,2235832,11850,11900,11850,1954,18,12,601782,348874,1356,598
125100,272210,11900,2,250,2.15,92.92,1101152,1023194,-77958,3621,5614,1993,2236082,11850,11900,11850,30,6,2,601951,349063,23,7
125100,272210,11900,2,250,2.15,93.0,1101177,1024082,-77095,3629,5622,1993,2236995,11850,11900,11850,943,14,10,601345,350128,48,895
125200,272210,11850,2,200,1.72,93.02,1101273,1024386,-76887,3639,5629,1990,2237395,11900,11900,11850,300,7,6,601405,350237,88,212
125300,272210,11850,2,200,1.72,93.09,1102612,1026425,-76187,3657,5635,1978,2240773,11900,11900,11850,880,5,2,600801,348056,60,820
125300,272210,11850,2,200,1.72,92.84,1106195,1026944,-79251,3667,5643,1976,2244875,11900,11900,11850,4982,15,10,532405,359256,3643,1339
125400,272210,11850,2,200,1.72,92.68,1108133,1027023,-81110,3676,5646,1970,2246892,11800,11850,11800,2012,7,3,535367,356858,1933,79
125500,272210,11850,2,200,1.72,92.7,1108181,1027300,-80881,3688,5656,1968,2247217,11850,11850,11850,4,0,2,538912,357458,0,4
125500,272210,11800,2,150,1.29,92.64,1109804,1028091,-81713,3697,5660,1963,2249631,11850,11850,11800,2418,9,6,537795,357459,1623,795
125600,272210,11800,2,150,1.29,92.89,1110464,1031509,-78955,3715,5665,1950,2253709,11850,11850,11800,3957,8,3,538726,356300,577,3380
125600,272210,11850,2,200,1.72,92.83,1111580,1031844,-79736,3726,5675,1949,2255160,11850,11850,11800,5408,19,13,538205,359389,1693,3715
125700,272210,11850,2,200,1.72,92.91,1111584,1032811,-78773,3728,5680,1952,2256131,11850,11850,11800,971,2,5,538841,360063,4,967
125800,272210,11850,2,200,1.72,93.2,1113832,1038077,-75755,3746,5690,1944,2263645,11850,11850,11800,90,2,2,535398,358955,14,76
125800,272210,11900,2,250,2.15,93.37,1113920,1040095,-73825,3753,5701,1948,2265751,11850,11900,11800,2196,9,13,603488,358147,102,2094
125900,272210,11850,2,200,1.72,93.3,1115448,1040714,-74734,3766,5705,1939,2267898,11900,11900,11850,204,2,1,604650,356671,4,200
125900,272210,11850,2,200,1.72,93.29,1115581,1040765,-74816,3774,5709,1935,2268082,11900,11900,11850,388,10,5,605387,352851,137,251
130000,272210,11850,2,200,1.72,93.26,1116193,1040991,-75202,3787,5713,1926,2268920,11900,11900,11850,263,7,3,604764,361642,112,151
130000,272210,11850,2,200,1.72,93.29,1116333,1041468,-74865,3795,5715,1920,2269537,11900,11900,11850,880,15,5,605688,362386,252,628
130100,272210,11900,2,250,2.15,93.3,1116707,1041917,-74790,3808,5723,1915,2270360,11900,11900,11850,819,11,8,606214,367475,370,449
130100,272210,11850,2,200,1.72,93.3,1116808,1042012,-74796,3820,5727,1907,2270556,11900,11900,11850,1015,23,12,607646,367897,471,544
130200,272210,11900,2,250,2.15,93.13,1119167,1042246,-76921,3829,5734,1905,2273149,11850,11900,11850,1287,7,6,615473,368006,1115,172
130200,272210,11900,2,250,2.15,93.12,1119545,1042573,-76972,3841,5738,1897,2273854,11850,11900,11850,1992,19,10,567524,367595,1493,499
130300,272210,11850,2,200,1.72,92.74,1124526,1042851,-81675,3856,5740,1884,2279113,11850,11900,11850,5259,15,2,566636,362914,4981,278
130400,272210,11850,2,200,1.72,92.74,1124691,1043086,-81605,3869,5743,1874,2279513,11850,11850,11850,6,2,0,566486,363121,6,0
130400,272210,11850,2,200,1.72,92.72,1125276,1043381,-81895,3876,5749,1873,2280393,11850,11900,11800,886,9,6,498620,378562,591,295
130500,272210,11800,2,150,1.29,92.78,1125380,1044154,-81226,3889,5759,1870,2281270,11800,11850,11800,160,3,1,498086,384931,60,100
130500,272210,11850,2,200,1.72,92.75,1126235,1044586,-81649,3901,5768,1867,2282557,11800,11850,11800,1447,15,10,497599,384168,915,532
130600,272210,11850,2,200,1.72,92.75,1126368,1044670,-81698,3907,5770,1863,2282774,11800,11850,11800,88,2,2,497369,384927,4,84
130600,272210,11850,2,200,1.72,92.91,1126397,1046492,-79905,3914,5777,1863,2284625,11800,11850,11800,1939,9,9,497175,385173,33,1906
130700,272210,11850,2,200,1.72,93.02,1126440,1047867,-78573,3925,5783,1858,2286043,11850,11850,11850,7,2,0,562277,378637,7,0
130700,272210,11850,2,200,1.72,92.95,1127614,1048085,-79529,3937,5786,1849,2287435,11850,11900,11850,1399,14,3,562328,379121,1181,218
130800,272210,11850,2,200,1.72,92.95,1127780,1048308,-79472,3946,5788,1842,2287824,11850,11850,11850,15,5,0,571052,384310,15,0
130800,272210,11850,2,200,1.72,92.97,1127924,1048576,-79348,3955,5794,1839,2288236,11850,11900,11850,427,14,6,572139,385197,159,268
130900,272210,11900,2,250,2.15,93.03,1127974,1049337,-78637,3965,5798,1833,2289047,11850,11900,11850,801,6,4,573910,384553,40,761
130900,272210,11850,2,200,1.72,92.99,1128612,1049514,-79098,3977,5801,1824,2289862,11850,11900,11850,1616,18,7,573308,384274,678,938
131000,272210,11850,2,200,1.72,93.04,1129310,1050740,-78570,3989,5803,1814,2291786,11850,11900,11850,282,9,1,571601,384145,156,126
131000,272210,11850,2,200,1.72,92.76,1133024,1051010,-82014,4003,5806,1803,2295770,11850,11900,11850,4266,23,4,571839,381495,3870,396
131100,272210,11900,2,250,2.15,92.71,1133892,1051192,-82700,4013,5812,1799,2296820,11850,11900,11850,969,9,5,572521,379351,843,126
131100,272210,11900,2,250,2.15,92.72,1134025,1051482,-82543,4020,5815,1795,2297243,11850,11900,11850,1392,16,8,572160,375552,976,416
131200,272210,11850,2,200,1.72,92.7,1134322,1051567,-82755,4035,5816,1781,2297625,11850,11900,11850,373,11,1,572881,375261,288,85
131200,272210,11850,2,200,1.72,92.72,1134342,1051786,-82556,4041,5818,1777,2297864,11850,11900,11850,612,17,3,571424,379931,308,304
131300,272210,11850,2,200,1.72,92.73,1134502,1052024,-82478,4051,5823,1772,2298262,11900,11900,11850,398,10,5,571706,385796,160,238
131300,272210,11900,2,250,2.15,92.67,1135423,1052214,-83209,4059,5827,1768,2299373,11900,11900,11850,1509,18,9,571840,386109,1081,428
131400,272210,11900,2,250,2.15,92.69,1135466,1052440,-83026,4070,5832,1762,2299642,11900,11900,11850,269,11,5,572363,387315,43,226
131500,272210,11900,2,250,2.15,92.66,1136075,1052652,-83423,4079,5837,1758,2300463,11850,11900,11850,81,2,1,572335,386646,6,75
131500,272210,11850,2,200,1.72,92.66,1136107,1052725,-83382,4087,5838,1751,2300568,11850,11900,11850,186,10,2,565523,386824,38,148
131600,272210,11900,2,250,2.15,92.69,1136194,1053162,-83032,4093,5843,1750,2301092,11900,11900,11900,129,0,1,566350,388762,0,129
131600,272210,11850,2,200,1.72,92.7,1136302,1053321,-82981,4102,5845,1743,2301359,11900,11900,11850,396,9,3,570953,389397,108,288
131700,272210,11900,2,250,2.15,92.72,1136417,1053630,-82787,4113,5851,1738,2301783,11900,11900,11850,185,5,3,570978,389873,10,175
131700,272210,11850,2,200,1.72,92.75,1136450,1054096,-82354,4121,5862,1741,2302282,11900,11900,11850,684,13,14,570503,391240,43,641
131800,272210,11850,2,200,1.72,92.74,1136854,1054269,-82585,4130,5864,1734,2302859,11900,11900,11850,200,2,1,574075,390739,195,5
131800,272210,11900,2,250,2.15,92.7,1137450,1054471,-82979,4142,5868,1726,2303657,11900,11900,11850,998,14,5,575474,387178,791,207
131900,272210,11850,2,200,1.72,92.72,1137477,1054646,-82831,4150,5870,1720,2303859,11850,11850,11850,23,6,0,577135,384845,23,0
131900,272210,11850,2,200,1.72,92.71,1137927,1054977,-82950,4164,5873,1709,2304640,11850,11900,11850,804,20,3,577049,385482,473,331
132000,272210,11850,2,200,1.72,92.54,1140159,1055137,-85022,4174,5875,1701,2307032,11850,11900,11850,405,5,1,575229,387870,305,100
132000,272210,11900,2,250,2.15,92.57,1140217,1055473,-84744,4181,5883,1702,2307426,11850,11900,11850,799,12,9,575224,388996,363,436
132100,272210,11900,2,250,2.15,92.56,1140398,1055535,-84863,4191,5885,1694,2307669,11850,11900,11850,77,4,1,575227,388986,17,60
132100,272210,11850,2,200,1.72,92.57,1140544,1055807,-84737,4200,5889,1689,2308087,11850,11900,11850,495,13,5,573669,390162,163,332
132200,272210,11850,2,200,1.72,92.53,1141209,1055931,-85278,4212,5890,1678,2308876,11850,11850,11850,498,8,0,574639,389795,498,0
132200,272210,11850,2,200,1.72,92.49,1142158,1056419,-85739,4224,5895,1671,2310313,11850,11900,11850,1935,20,5,574285,388446,1447,488
132300,272210,11850,2,200,1.72,92.5,1142313,1056639,-85674,4233,5898,1665,2310688,11850,11900,11850,109,6,1,574791,385791,89,20
132300,272210,11850,2,200,1.72,92.45,1142990,1056690,-86300,4244,5902,1658,2311416,11850,11900,11850,837,17,5,574688,384341,766,71
132400,272210,11900,2,250,2.15,92.48,1143182,1057171,-86011,4255,5906,1651,2312089,11850,11900,11850,488,10,3,576279,384395,67,421
132400,272210,11850,2,200,1.72,92.49,1143454,1057626,-85828,4261,5911,1650,2312816,11850,11900,11850,1215,16,8,575797,383973,339,876
132500,272210,11850,2,200,1.72,92.37,1145043,1057686,-87357,4276,5912,1636,2314465,11850,11900,11850,1643,13,1,576070,383855,1583,60
132500,272210,11850,2,200,1.72,92.11,1148500,1057887,-90613,4287,5914,1627,2318123,11850,11900,11850,5301,24,3,576802,383391,5040,261
132600,272210,11850,2,200,1.72,91.41,1157742,1058308,-99434,4306,5921,1615,2327786,11850,11900,11800,9659,17,7,512059,390009,9238,421
132600,272210,11900,2,250,2.15,91.61,1157859,1060730,-97129,4312,5933,1621,2330325,11850,11900,11800,12198,23,19,580408,377025,9355,2843
132700,272210,11900,2,250,2.15,91.73,1158005,1062234,-95771,4323,5935,1612,2331975,11850,11900,11850,1650,11,2,581134,377018,146,1504
132800,272210,11850,2,200,1.72,91.71,1158298,1062294,-96004,4334,5936,1602,2332328,11850,11900,11850,267,3,1,579021,377556,207,60
132800,272210,11850,2,200,1.72,91.45,1162103,1062690,-99413,4347,5943,1596,2336529,11850,11900,11850,4468,16,8,578941,383071,4012,456
132900,272210,11850,2,200,1.72,91.56,1162206,1064078,-98128,4361,5950,1589,2338020,11900,11900,11850,520,6,6,579296,383194,16,504
133000,272210,11850,2,200,1.72,91.58,1162389,1064494,-97895,4371,5957,1586,2338619,11850,11850,11850,0,0,0,579371,378621,0,0
133000,272210,11850,2,200,1.72,91.29,1166122,1064570,-101552,4378,5959,1581,2342428,11900,11900,11850,3809,7,2,580114,382573,3733,76
133100,272210,11850,2,200,1.72,91.4,1166211,1065931,-100280,4388,5964,1576,2343878,11900,11900,11850,104,2,1,579254,383324,4,100
133100,272210,11850,2,200,1.72,91.41,1166344,1066153,-100191,4402,5966,1564,2344233,11900,11900,11850,459,16,3,577288,386463,137,322
