094800,33626L,11750,2,1200,11.37,115.18,227933,262540,34607,1768,2184,416,509585,11800,11800,11700,1800,7,25,3681,10414,986,814
094900,33626L,11700,2,1150,10.9,114.89,228681,262732,34051,1777,2189,412,510525,11750,11750,11700,250,3,2,3895,10284,183,67
094900,33626L,11700,2,1150,10.9,114.38,229860,262905,33045,1784,2195,411,511877,11750,11750,11650,1602,10,8,2972,9930,1362,240
095000,33626L,11950,2,1400,13.27,114.77,230351,264380,34029,1786,2212,426,513843,11900,11950,11900,445,0,8,4246,7107,0,445
095000,33626L,12150,2,1600,15.17,115.16,232721,268010,35289,1800,2234,434,519843,11900,12200,11900,6445,14,30,6712,5266,2370,4075
095100,33626L,12000,2,1450,13.74,114.79,233861,268457,34596,1810,2242,432,521430,12000,12000,12000,473,7,2,7115,4135,428,45
095100,33626L,11900,2,1350,12.8,114.84,234314,269075,34761,1820,2247,427,522501,12000,12000,11850,1544,17,7,5418,5448,881,663
095200,33626L,11700,2,1150,10.9,113.3,237695,269304,31609,1830,2250,420,526111,11750,11750,11700,1133,2,3,5251,8299,904,229
095200,33626L,11750,2,1200,11.37,112.45,239672,269504,29832,1843,2254,411,528288,11750,11750,11700,3310,15,7,5783,8658,2881,429
095300,33626L,11750,2,1200,11.37,112.24,240360,269779,29419,1850,2257,407,529251,11700,11750,11700,176,2,1,5075,7936,105,71
095300,33626L,11650,2,1100,10.43,112.23,241084,270564,29480,1856,2264,408,530760,11700,11850,11650,1685,8,8,5151,7743,829,856
095400,33626L,11750,2,1200,11.37,112.21,242375,271976,29601,1865,2270,405,533463,11650,11750,11650,1763,3,5,6440,9718,355,1408
095400,33626L,11750,2,1200,11.37,112.23,242449,272091,29642,1867,2276,409,533652,11650,11750,11650,1952,5,11,5176,8302,429,1523
095500,33626L,11750,2,1200,11.37,112.38,243035,273120,30085,1871,2287,416,535267,11750,11750,11700,1098,2,5,5574,7765,156,942
095500,33626L,11900,2,1350,12.8,112.85,243035,274257,31222,1871,2298,427,536404,11750,11900,11700,2235,2,16,6332,7198,156,2079
095600,33626L,11900,2,1350,12.8,112.7,244961,276063,31102,1884,2314,430,540136,11900,11900,11850,2357,8,12,6051,7327,761,1596
095600,33626L,11650,2,1100,10.43,111.89,246863,276209,29346,1890,2320,430,542184,11900,11900,11650,4405,14,18,6192,8128,2663,1742
095700,33626L,11700,2,1150,10.9,111.78,247155,276279,29124,1895,2323,428,542546,11800,11800,11700,160,2,3,6155,8233,90,70
095700,33626L,11750,2,1200,11.37,111.67,247569,276452,28883,1899,2326,427,543133,11800,11800,11700,747,6,6,7524,9284,504,243
095800,33626L,11750,2,1200,11.37,111.24,248598,276544,27946,1911,2327,416,544254,11800,11800,11750,999,11,0,8188,7784,999,0
095800,33626L,11650,2,1100,10.43,111.09,248941,276544,27603,1918,2327,409,544597,11800,11800,11650,1342,18,0,7081,8063,1342,0
095900,33626L,11600,2,1050,9.95,110.97,249554,276927,27373,1928,2330,402,545593,11600,11600,11550,796,9,2,7095,9413,566,230
095900,33626L,11500,2,950,9.0,110.34,251502,277500,25998,1935,2334,399,548114,11600,11650,11500,3317,16,6,6419,9301,2514,803
100000,33626L,11550,2,1000,9.48,109.23,254130,277582,23452,1945,2337,392,550824,11550,11550,11450,1069,7,3,5358,12361,987,82
100000,33626L,11650,2,1100,10.43,108.72,256164,278493,22329,1956,2347,391,553769,11550,11650,11400,4014,18,13,5553,10858,3021,993
100100,33626L,11600,2,1050,9.95,108.61,256714,278824,22110,1965,2357,392,554650,11600,11650,11550,693,6,10,6961,12851,362,331
100100,33626L,11600,2,1050,9.95,108.79,257295,279914,22619,1972,2368,396,556321,11600,11650,11550,2364,13,21,6998,13008,943,1421
100200,33626L,11600,2,1050,9.95,108.62,258490,280767,22277,1980,2373,393,558369,11600,11700,11550,2048,8,5,6779,12235,1195,853
100300,33626L,11650,2,1100,10.43,108.46,258961,280862,21901,1983,2380,397,558994,11650,11650,11650,1,0,1,7510,9470,0,1
100300,33626L,11650,2,1100,10.43,108.45,259062,280950,21888,1985,2381,396,559183,11650,11650,11650,190,2,2,8354,10358,101,89
100400,33626L,11650,2,1100,10.43,108.14,259861,281013,21152,1992,2382,390,560045,11650,11650,11650,0,0,0,9735,9805,0,0
100400,33626L,11600,2,1050,9.95,108.06,260072,281024,20952,1994,2384,390,560267,11600,11650,11550,222,2,2,8036,12341,211,11
100500,33626L,11750,2,1200,11.37,108.82,260333,283296,22963,1999,2399,400,562800,11750,11750,11750,321,0,3,8611,9945,0,321
100500,33626L,11800,2,1250,11.85,109.69,260786,286048,25262,2005,2426,421,566005,11750,11850,11700,3526,6,30,7286,8203,453,3073
100600,33626L,11800,2,1250,11.85,109.77,261640,287211,25571,2010,2458,448,568022,11800,11800,11800,162,0,3,7482,9583,0,162
100600,33626L,11900,2,1350,12.8,110.3,261865,288844,26979,2014,2469,455,569880,11800,11900,11800,2020,4,14,7326,9327,225,1795
100700,33626L,11800,2,1250,11.85,110.1,262560,289081,26521,2019,2474,455,570905,11850,11850,11800,57,2,0,9260,8008,57,0
100700,33626L,11850,2,1300,12.32,110.08,262685,289160,26475,2024,2477,453,571109,11850,11850,11800,261,7,3,9699,9796,182,79
100800,33626L,11950,2,1400,13.27,111.33,263274,293110,29836,2029,2489,460,575648,11850,11950,11850,3708,0,10,6970,9699,0,3708
100800,33626L,11900,2,1350,12.8,112.52,264132,297205,33073,2036,2508,472,580601,11850,12100,11850,8661,7,29,4334,7550,858,7803
100900,33626L,11850,2,1300,12.32,112.34,264784,297464,32680,2041,2512,471,581512,11900,11900,11850,500,2,0,5138,7082,500,0
100900,33626L,12050,2,1500,14.22,112.0,266814,298842,32028,2052,2526,474,584920,11900,12050,11850,3908,13,14,4546,7719,2530,1378
101000,33626L,12150,2,1600,15.17,112.54,267744,301330,33586,2104,2587,483,588338,12050,12150,12050,572,17,22,6528,8611,125,447
101000,33626L,11900,2,1350,12.8,111.4,270559,301412,30853,2148,2616,468,591285,12050,12150,11900,3519,61,51,7448,7558,2940,529
101100,33626L,11700,2,1150,10.9,110.05,273917,301432,27515,2164,2619,455,594663,11850,11850,11700,959,4,3,4236,9082,939,20
101100,33626L,11850,2,1300,12.32,110.18,274431,302375,27944,2199,2655,456,596120,11850,11950,11700,2416,39,39,4958,7540,1453,963
101200,33626L,11800,2,1250,11.85,109.92,275502,302845,27343,2251,2710,459,597661,11900,11900,11750,390,20,23,5473,7328,292,98
101200,33626L,11900,2,1350,12.8,109.92,275602,302951,27349,2281,2741,460,597867,11900,11900,11750,596,50,54,6142,6624,392,204
101300,33626L,11700,2,1150,10.9,109.85,275873,303044,27171,2286,2743,457,598231,11750,11750,11700,183,4,0,5124,8545,183,0
101300,33626L,11600,2,1050,9.95,109.27,277440,303145,25705,2294,2746,452,599899,11750,11750,11600,1851,12,3,6457,8740,1750,101
101400,33626L,11650,2,1100,10.43,109.04,278079,303209,25130,2299,2748,449,600602,11650,11650,11650,404,2,0,9548,9926,404,0
101400,33626L,11600,2,1050,9.95,108.82,278652,303238,24586,2303,2749,446,601204,11650,11650,11600,1006,6,1,7230,9817,977,29
101500,33626L,11650,2,1100,10.43,108.67,279543,303791,24248,2307,2754,447,602648,11650,11650,11650,1237,4,3,9159,9656,891,346
101500,33626L,11650,2,1100,10.43,108.67,280069,304362,24293,2349,2795,446,603745,11650,11750,11600,2334,46,44,9924,10317,1417,917
101600,33626L,11600,2,1050,9.95,108.26,281198,304423,23225,2390,2833,443,604935,11650,11650,11600,299,23,23,7702,11920,253,46
101600,33626L,11600,2,1050,9.95,108.25,281374,304591,23217,2394,2838,444,605279,11650,11650,11550,643,27,28,8502,14374,429,214
101700,33626L,11600,2,1050,9.95,108.04,282110,304787,22677,2397,2842,445,606211,11550,11600,11550,764,3,2,9406,13778,736,28
101700,33626L,11600,2,1050,9.95,108.28,282236,305609,23373,2399,2851,452,607159,11550,11650,11550,1712,5,11,10204,12652,862,850
101800,33626L,11600,2,1050,9.95,108.19,282468,305611,23143,2401,2852,451,607393,11600,11600,11600,232,2,0,9955,11389,232,0
101800,33626L,11650,2,1100,10.43,108.18,282694,305818,23124,2404,2855,451,607826,11600,11650,11600,665,5,3,11915,11910,458,207
101900,33626L,11550,2,1000,9.48,107.76,283916,305939,22023,2409,2857,448,609169,11600,11600,11550,1276,5,1,10492,11202,1222,54
101900,33626L,11500,2,950,9.0,107.53,284522,305939,21417,2425,2857,432,609775,11600,11600,11500,1882,21,1,10199,12684,1828,54
102000,33626L,11550,2,1000,9.48,106.07,288536,306038,17502,2449,2862,413,613888,11500,11550,11400,4113,24,5,6135,13592,4014,99
102000,33626L,11500,2,950,9.0,105.83,289206,306058,16852,2457,2863,406,614748,11500,11550,11400,4973,32,6,6366,13155,4684,119
102100,33626L,11550,2,1000,9.48,106.03,289221,306672,17451,2458,2870,412,615377,11550,11600,11550,629,1,7,8191,12555,15,614
102200,33626L,11600,2,1050,9.95,105.9,289693,306773,17080,2463,2874,411,615950,11600,11600,11600,1,0,1,8368,13706,0,1
102200,33626L,11550,2,1000,9.48,105.68,290336,306823,16487,2465,2878,413,616643,11600,11600,11550,694,2,5,6469,13488,643,51
102300,33626L,11500,2,950,9.0,105.12,292119,307075,14956,2468,2879,411,618678,11500,11500,11500,0,0,0,5185,13009,0,0
102300,33626L,11450,2,900,8.53,105.01,292414,307075,14661,2471,2879,408,618973,11500,11500,11450,295,3,0,4376,11177,295,0
102400,33626L,11500,2,950,9.0,104.9,292794,307143,14349,2476,2881,405,619421,11500,11500,11500,222,2,0,4952,10704,222,0
102400,33626L,11500,2,950,9.0,104.82,293171,307292,14121,2483,2882,399,619947,11500,11500,11500,748,9,1,4894,12000,599,149
102500,33626L,11400,2,850,8.06,104.01,295452,307297,11845,2488,2883,395,622233,11450,11450,11400,2281,5,0,3483,12279,2281,0
102500,33626L,11350,2,800,7.58,103.8,296095,307343,11248,2501,2885,384,622922,11450,11450,11350,2970,18,2,2727,13854,2924,46
102600,33626L,11350,2,800,7.58,103.46,297699,307996,10297,2509,2889,380,625179,11350,11400,11350,1455,4,3,3609,14944,809,646
102600,33626L,11350,2,800,7.58,103.32,298510,308412,9902,2522,2896,374,626406,11350,11400,11350,2682,17,10,2186,13556,1620,1062
102700,33626L,11450,2,900,8.53,103.45,298515,308823,10308,2524,2902,378,626822,11400,11450,11350,242,1,4,4071,14896,4,238
102700,33626L,11350,2,800,7.58,103.17,299344,308824,9480,2528,2903,375,627652,11400,11450,11350,1072,5,5,4239,15034,833,239
102800,33626L,11450,2,900,8.53,103.23,299558,309236,9678,2529,2908,379,628278,11400,11450,11350,620,1,3,3481,14561,214,406
102800,33626L,11450,2,900,8.53,103.25,299558,309289,9731,2529,2911,382,628331,11400,11450,11350,673,1,6,4889,13276,214,459
102900,33626L,11400,2,850,8.06,103.27,299606,309390,9784,2532,2913,381,628480,11400,11400,11400,47,2,0,5467,13516,47,0
102900,33626L,11450,2,900,8.53,103.17,299929,309443,9514,2535,2917,382,628856,11400,11450,11400,423,5,4,5455,13951,370,53
103000,33626L,11450,2,900,8.53,103.17,300057,309557,9500,2536,2918,382,629098,11450,11450,11450,0,0,0,6598,13593,0,0
103000,33626L,11400,2,850,8.06,102.63,301741,309684,7943,2551,2922,371,630909,11450,11450,11400,1811,15,4,5906,12164,1684,127
103100,33626L,11350,2,800,7.58,102.23,302915,309684,6769,2559,2922,363,632083,11350,11350,11350,1037,7,0,4430,12642,1037,0
103100,33626L,11350,2,800,7.58,102.22,302956,309684,6728,2561,2922,361,632124,11350,11350,11350,1078,9,0,4430,12614,1078,0
103200,33626L,11400,2,850,8.06,102.17,303127,309714,6587,2563,2923,360,632325,11350,11400,11350,112,1,1,3676,12504,82,30
103200,33626L,11450,2,900,8.53,102.22,303127,309870,6743,2563,2926,363,632481,11350,11450,11350,268,1,4,5284,9933,82,186
103300,33626L,11450,2,900,8.53,102.23,303137,309906,6769,2564,2928,364,632527,11450,11450,11450,46,1,2,5351,9840,10,36
103400,33626L,11400,2,850,8.06,102.1,303588,309964,6376,2567,2930,363,633036,11400,11400,11400,0,0,0,5199,9743,0,0
103400,33626L,11400,2,850,8.06,102.1,303588,309964,6376,2567,2930,363,633036,11400,11400,11400,0,0,0,5199,9743,0,0
103500,33626L,11400,2,850,8.06,102.02,303871,310019,6148,2569,2931,362,633374,11400,11400,11400,0,0,0,4644,10145,0,0
103500,33626L,11350,2,800,7.58,101.72,304764,310020,5256,2580,2932,352,634268,11350,11350,11300,894,11,1,2690,9591,893,1
103600,33626L,11350,2,800,7.58,101.58,305259,310079,4820,2583,2934,351,634822,11350,11350,11350,0,0,0,3713,9662,0,0
103600,33626L,11300,2,750,7.11,101.35,305970,310101,4131,2587,2937,350,635555,11300,11350,11300,733,4,3,2899,9617,711,22
103700,33626L,11300,2,750,7.11,101.03,307120,310275,3155,2595,2938,343,636879,11300,11300,11300,1100,5,1,2935,9535,926,174
103700,33626L,11300,2,750,7.11,101.03,307120,310275,3155,2595,2938,343,636879,11300,11300,11300,1100,5,1,2935,9535,926,174
103800,33626L,11300,2,750,7.11,101.03,307120,310275,3155,2595,2938,343,636879,11300,11300,11300,0,0,0,2935,9535,0,0
103800,33626L,11300,2,750,7.11,101.03,307120,310275,3155,2595,2938,343,636879,11300,11300,11300,0,0,0,2935,9535,0,0
103900,33626L,11300,2,750,7.11,101.03,307120,310275,3155,2595,2938,343,636879,11300,11300,11300,0,0,0,2935,9535,0,0
103900,33626L,11250,2,700,6.64,100.82,307809,310331,2522,2609,2942,333,639411,11200,11250,11150,2532,14,4,4231,11292,689,56
104000,33626L,11150,2,600,5.69,100.51,308938,310503,1565,2616,2945,329,640712,11200,11200,11150,1063,2,2,5213,11738,893,170
104000,33626L,11000,2,450,4.27,99.24,312944,310553,-2391,2628,2946,318,644768,11200,11200,11000,5119,14,3,4013,7384,4899,220
104100,33626L,11050,2,500,4.74,98.75,314612,310676,-3936,2638,2951,313,646559,11050,11050,11050,260,1,0,4467,7907,260,0
104100,33626L,11100,2,550,5.21,98.87,314677,311106,-3571,2641,2957,316,647054,11050,11100,11050,755,4,6,4587,9516,325,430
104200,33626L,11100,2,550,5.21,98.55,316766,312185,-4581,2650,2973,323,650422,11000,11100,11000,1088,3,13,3361,10623,61,1027
104200,33626L,11150,2,600,5.69,98.76,316829,312916,-3913,2652,2991,339,651216,11000,11200,11000,1882,5,31,2800,9483,124,1758
104300,33626L,11100,2,550,5.21,98.81,316882,313121,-3761,2654,3000,346,651474,11150,11150,11100,134,1,6,3930,10482,42,92
104300,33626L,11100,2,550,5.21,98.55,317765,313172,-4593,2659,3002,343,652408,11150,11150,11100,1068,6,8,3915,9655,925,143
104400,33626L,11150,2,600,5.69,98.48,318443,313608,-4835,2663,3006,343,653522,11050,11150,11050,1011,4,3,4019,9780,678,333
104400,33626L,11150,2,600,5.69,98.55,318443,313812,-4631,2663,3008,345,653726,11050,11150,11050,1215,4,5,3951,9532,678,537
104500,33626L,11200,2,650,6.16,98.6,318446,313985,-4461,2664,3012,348,653902,11150,11200,11150,176,1,4,3388,8350,3,173
104500,33626L,11200,2,650,6.16,98.32,319356,313992,-5364,2672,3017,345,654819,11150,11250,11150,1093,9,9,3838,8304,913,180
104600,33626L,11250,2,700,6.64,98.4,319555,314432,-5123,2677,3025,348,655458,11200,11300,11200,639,5,8,4034,8103,199,440
104700,33626L,11250,2,700,6.64,98.52,319661,314929,-4732,2680,3032,352,656061,11250,11250,11250,0,0,0,4149,8577,0,0
104700,33626L,11250,2,700,6.64,98.27,320793,315235,-5558,2685,3034,349,657499,11200,11250,11200,1438,5,2,4393,7404,1132,306
104800,33626L,11250,2,700,6.64,98.36,320911,315640,-5271,2688,3040,352,658022,11250,11250,11250,0,0,0,3953,7349,0,0
104800,33626L,11150,2,600,5.69,97.66,323437,315870,-7567,2697,3044,347,660778,11250,11250,11150,2756,9,4,4301,7404,2526,230
104900,33626L,11050,2,500,4.74,97.39,324332,315876,-8456,2702,3046,344,661679,11050,11050,11050,0,0,0,4118,9976,0,0
104900,33626L,11100,2,550,5.21,97.4,324383,315942,-8441,2704,3049,345,661796,11050,11100,11050,117,2,3,3409,10466,51,66
105000,33626L,11050,2,500,4.74,97.28,324822,315989,-8833,2708,3050,342,662282,11050,11050,11050,345,2,0,3383,9777,345,0
105000,33626L,11000,2,450,4.27,97.08,325570,316059,-9511,2711,3054,343,663100,11050,11050,11000,1163,5,4,2038,10530,1093,70
105100,33626L,10900,2,350,3.32,97.05,326568,316930,-9638,2721,3060,339,664969,10950,10950,10900,1414,3,2,3058,10367,687,727
105100,33626L,11000,2,450,4.27,96.94,327545,317512,-10033,2729,3068,339,666528,10950,11000,10900,2973,11,10,3151,9815,1664,1309
105200,33626L,10950,2,400,3.79,96.78,328079,317513,-10566,2734,3069,335,667063,10950,10950,10950,105,2,0,2968,9932,105,0
105200,33626L,11000,2,450,4.27,96.75,328551,317884,-10667,2739,3074,335,667906,10950,11000,10900,948,7,5,3616,11183,577,371
105300,33626L,11000,2,450,4.27,96.84,328715,318336,-10379,2742,3079,337,668522,10950,11000,10950,470,1,3,3207,11401,25,445
105300,33626L,10950,2,400,3.79,96.67,329327,318347,-10980,2747,3080,333,669145,10950,11000,10950,1093,6,4,3114,11138,637,456
105400,33626L,10900,2,350,3.32,96.66,329347,318347,-11000,2748,3080,332,669165,10900,10900,10900,0,0,0,3103,12110,0,0
105400,33626L,11000,2,450,4.27,96.81,329360,318867,-10493,2750,3083,333,669698,10900,11000,10900,533,2,3,2612,12465,13,520
105500,33626L,11050,2,500,4.74,96.84,329368,318949,-10419,2751,3087,336,669788,11000,11050,11000,31,0,2,4736,11641,0,31
105500,33626L,11050,2,500,4.74,96.98,329584,319631,-9953,2752,3090,338,670686,11000,11050,11000,929,1,5,4341,11729,216,713
105600,33626L,11050,2,500,4.74,96.99,329584,319661,-9923,2752,3092,340,670716,11050,11050,11050,20,0,1,4478,11247,0,20
105600,33626L,11050,2,500,4.74,96.99,329584,319665,-9919,2752,3093,341,670720,11050,11050,11050,24,0,2,4480,11390,0,24
105700,33626L,10950,2,400,3.79,96.71,330612,319720,-10892,2756,3095,339,671803,10950,10950,10950,257,1,0,3326,12444,257,0
105700,33626L,10950,2,400,3.79,96.61,330962,319732,-11230,2758,3098,340,672165,10950,11000,10950,619,3,3,3377,12430,607,12
105800,33626L,10950,2,400,3.79,96.48,331576,319892,-11684,2765,3099,334,672939,10950,10950,10950,272,4,0,3468,13366,272,0
105800,33626L,10950,2,400,3.79,96.48,331576,319892,-11684,2765,3099,334,672939,10950,10950,10950,272,4,0,3468,13366,272,0
105900,33626L,11000,2,450,4.27,96.47,331645,319941,-11704,2768,3102,334,673057,10950,11000,10950,101,2,2,3309,14688,62,39
105900,33626L,11050,2,500,4.74,96.5,331645,320041,-11604,2768,3103,335,673157,10950,11050,10950,201,2,3,4473,11328,62,139
110000,33626L,11000,2,450,4.27,96.54,331774,320286,-11488,2771,3104,333,673531,11000,11000,11000,344,2,1,3312,15386,99,245
110000,33626L,11050,2,500,4.74,96.28,332656,320287,-12369,2776,3105,329,674414,11000,11050,10950,1227,7,2,4338,11267,981,246
110100,33626L,11000,2,450,4.27,96.29,332806,320456,-12350,2779,3107,328,674733,11000,11000,11000,285,2,2,3326,15694,116,169
110100,33626L,11000,2,450,4.27,96.3,332854,320548,-12306,2780,3109,329,674873,11000,11000,11000,425,3,4,4386,12120,164,261
110200,33626L,11000,2,450,4.27,96.28,333643,321228,-12415,2793,3114,321,676342,11000,11050,10950,1469,13,5,4284,12373,789,680
110200,33626L,11000,2,450,4.27,96.19,334106,321392,-12714,2797,3115,318,676969,11000,11050,10950,2096,17,6,4158,12245,1252,844
110300,33626L,11050,2,500,4.74,96.23,334106,321522,-12584,2797,3119,322,677099,11050,11050,11050,130,0,4,4040,12470,0,130
110400,33626L,11050,2,500,4.74,96.2,334260,321552,-12708,2798,3121,323,677283,11050,11050,11050,0,0,0,4055,12653,0,0
110400,33626L,11000,2,450,4.27,96.21,334485,321794,-12691,2800,3124,324,677750,11050,11050,11000,467,2,3,3412,16611,225,242
110500,33626L,10950,2,400,3.79,95.85,335742,321820,-13922,2805,3127,322,679033,10950,10950,10950,0,0,0,3322,15214,0,0
110500,33626L,10900,2,350,3.32,95.63,336888,322172,-14716,2808,3134,326,680531,10950,10950,10850,1498,3,7,3273,14283,1146,352
110600,33626L,10900,2,350,3.32,95.53,337270,322197,-15073,2810,3137,327,680938,10950,10950,10900,365,1,1,3708,14632,350,15
110600,33626L,10850,2,300,2.84,94.85,339993,322487,-17506,2826,3138,312,683951,10950,10950,10800,3378,17,2,4105,11551,3073,305
110700,33626L,10750,2,200,1.9,93.96,343226,322491,-20735,2838,3142,304,687188,10700,10750,10700,2,1,1,4927,10179,1,1
110700,33626L,10750,2,200,1.9,93.9,343626,322650,-20976,2839,3147,308,687747,10700,10850,10700,561,2,6,5154,11759,401,160
110800,33626L,10750,2,200,1.9,93.78,344160,322765,-21395,2846,3151,305,688396,10750,10800,10750,395,2,1,5259,11104,313,82
110800,33626L,10750,2,200,1.9,93.67,344575,322765,-21810,2850,3151,301,688811,10750,10800,10750,810,6,1,5452,10664,728,82
110900,33626L,10750,2,200,1.9,93.7,344576,322872,-21704,2851,3154,303,688919,10750,10750,10750,67,0,2,5143,11132,0,67
110900,33626L,10850,2,300,2.84,93.86,344709,323535,-21174,2855,3162,307,689715,10750,10850,10750,863,4,10,5458,10936,133,730
111000,33626L,10850,2,300,2.84,93.39,346524,323612,-22912,2864,3165,301,691607,10750,10850,10750,502,3,2,6344,9908,426,76
111000,33626L,10800,2,250,2.37,93.67,346536,324604,-21932,2865,3168,303,692611,10750,10850,10750,1506,4,5,5164,13220,438,1068
111100,33626L,10850,2,300,2.84,93.73,346574,324835,-21739,2866,3172,306,692880,10850,10900,10850,268,1,3,6209,15204,38,230
111100,33626L,10850,2,300,2.84,93.75,346619,324944,-21675,2867,3175,308,693034,10850,10900,10850,422,2,6,6160,15336,83,339
111200,33626L,10850,2,300,2.84,93.68,346858,324947,-21911,2869,3177,308,693276,10850,10850,10850,3,0,2,5088,15181,0,3
111200,33626L,10850,2,300,2.84,93.71,346910,325088,-21822,2870,3179,309,693469,10850,10850,10850,196,1,4,5231,16361,52,144
111300,33626L,10800,2,250,2.37,93.59,347360,325088,-22272,2873,3179,306,693919,10800,10800,10800,450,3,0,5076,16781,450,0
111300,33626L,10800,2,250,2.37,93.49,347929,325272,-22657,2877,3185,308,694672,10800,10800,10750,1203,7,6,5315,16342,1019,184
111400,33626L,10800,2,250,2.37,93.51,348023,325432,-22591,2881,3187,306,694926,10800,10800,10800,217,3,2,5063,16377,57,160
111400,33626L,10800,2,250,2.37,93.45,348347,325532,-22815,2884,3188,304,695350,10800,10850,10800,641,6,3,5036,15794,381,260
111500,33626L,10800,2,250,2.37,93.45,348595,325762,-22833,2885,3191,306,695828,10800,10800,10800,478,1,3,5392,15969,248,230
111500,33626L,10800,2,250,2.37,93.48,348600,325883,-22717,2886,3193,307,695954,10800,10800,10800,604,2,5,5153,16011,253,351
111600,33626L,10800,2,250,2.37,93.45,348735,325883,-22852,2888,3193,305,696089,10800,10800,10800,135,2,0,5186,16192,135,0
111700,33626L,10800,2,250,2.37,93.42,348845,325883,-22962,2890,3193,303,696199,10800,10800,10800,0,0,0,5186,15113,0,0
111700,33626L,10800,2,250,2.37,93.38,348976,325883,-23093,2891,3193,302,696330,10800,10800,10800,131,1,0,5086,12952,131,0
111800,33626L,10800,2,250,2.37,93.35,349114,325883,-23231,2893,3193,300,696468,10800,10800,10800,0,0,0,5375,11954,0,0
111800,33626L,10800,2,250,2.37,93.25,349472,325883,-23589,2895,3193,298,696826,10800,10800,10800,358,2,0,5575,11876,358,0
111900,33626L,10850,2,300,2.84,93.22,349570,325884,-23686,2898,3194,296,696925,10850,10850,10850,0,0,0,6040,12174,0,0
111900,33626L,10800,2,250,2.37,92.9,350804,325884,-24920,2906,3194,288,698159,10800,10800,10800,1234,8,0,5839,11577,1234,0
112000,33626L,10750,2,200,1.9,92.56,352070,325884,-26186,2910,3194,284,699425,10750,10750,10750,174,1,0,5473,11001,174,0
112000,33626L,10800,2,250,2.37,92.26,353286,325933,-27353,2917,3196,279,700690,10750,10800,10700,1439,8,2,5863,9793,1390,49
112100,33626L,10800,2,250,2.37,92.26,353286,325933,-27353,2917,3196,279,700690,10800,10800,10800,0,0,0,5863,9793,0,0
112100,33626L,10750,2,200,1.9,92.18,353593,325933,-27660,2920,3196,276,700997,10750,10750,10750,307,3,0,5814,9726,307,0
112200,33626L,10700,2,150,1.42,92.18,353700,326029,-27671,2923,3198,275,701200,10750,10750,10700,97,1,1,3730,10098,2,95
112200,33626L,10750,2,200,1.9,92.11,354001,326057,-27944,2926,3199,273,701529,10750,10750,10700,426,4,2,3830,9447,303,123
112300,33626L,10750,2,200,1.9,92.11,354022,326086,-27936,2927,3200,273,701579,10750,10750,10750,0,0,0,3800,10096,0,0
112300,33626L,10750,2,200,1.9,92.1,354062,326086,-27976,2928,3200,272,701619,10750,10750,10750,40,1,0,3880,10964,40,0
112400,33626L,10800,2,250,2.37,92.15,354064,326277,-27787,2929,3202,273,701812,10800,10800,10800,190,0,1,3931,11465,0,190
112400,33626L,10800,2,250,2.37,92.14,354129,326305,-27824,2930,3205,275,701905,10800,10800,10800,283,1,4,3971,10763,65,218
112500,33626L,10850,2,300,2.84,92.14,354129,326306,-27823,2930,3206,276,701906,10850,10850,10850,0,0,0,3971,10704,0,0
112500,33626L,10850,2,300,2.84,92.14,354129,326306,-27823,2930,3206,276,701906,10850,10850,10850,0,0,0,3971,10704,0,0
112600,33626L,10950,2,400,3.79,92.48,354129,327482,-26647,2930,3209,279,703082,10850,10950,10850,1176,0,3,3997,10344,0,1176
112600,33626L,10900,2,350,3.32,92.49,354129,327548,-26581,2930,3211,281,703148,10850,10950,10850,1242,0,5,3149,9316,0,1242
112700,33626L,10900,2,350,3.32,92.52,354129,327648,-26481,2930,3212,282,703248,10900,10900,10900,0,0,0,3774,9621,0,0
112700,33626L,10800,2,250,2.37,92.46,354384,327659,-26725,2932,3214,282,703514,10850,10850,10800,266,2,2,4530,10021,255,11
112800,33626L,10900,2,350,3.32,92.58,354428,328141,-26287,2933,3216,283,704040,10850,10900,10850,482,0,2,4580,9730,0,482
112800,33626L,10850,2,300,2.84,92.59,354428,328175,-26253,2933,3217,284,704074,10850,10900,10850,516,0,3,5569,9855,0,516
112900,33626L,10750,2,200,1.9,92.54,354713,328238,-26475,2936,3219,283,704422,10800,10800,10750,348,3,2,3505,9979,285,63
112900,33626L,10800,2,250,2.37,92.54,354713,328250,-26463,2936,3224,288,704434,10800,10800,10750,360,3,7,3497,10193,285,75
113000,33626L,10800,2,250,2.37,92.67,354729,328739,-25990,2938,3225,287,704939,10750,10800,10750,505,2,1,5344,10086,16,489
113100,33626L,10750,2,200,1.9,92.59,355043,328739,-26304,2939,3225,286,705253,10750,10750,10750,0,0,0,5756,11362,0,0
113100,33626L,10750,2,200,1.9,92.57,355143,328739,-26404,2940,3225,285,705353,10750,10750,10750,100,1,0,5637,10345,100,0
113200,33626L,10750,2,200,1.9,92.56,355144,328739,-26405,2941,3225,284,705354,10750,10750,10750,0,0,0,5637,10413,0,0
113200,33626L,10800,2,250,2.37,92.51,355362,328739,-26623,2942,3225,283,705572,10800,10800,10800,218,1,0,5514,10357,218,0
113300,33626L,10850,2,300,2.84,91.69,359886,329979,-29907,2945,3236,291,711336,10750,10850,10750,1238,0,9,5184,9118,0,1238
113300,33626L,10850,2,300,2.84,91.72,359886,330079,-29807,2945,3237,292,711436,10750,10850,10750,1338,0,10,5641,7946,0,1338
113400,33626L,10900,2,350,3.32,91.8,359886,330362,-29524,2945,3244,299,711719,10900,10900,10900,1,0,1,5749,9239,0,1
113400,33626L,10900,2,350,3.32,91.85,360041,330711,-29330,2948,3249,301,712223,10900,10950,10850,505,3,6,6112,8477,155,350
113500,33626L,10900,2,350,3.32,91.86,360170,330843,-29327,2950,3254,304,712484,10900,10900,10900,31,0,1,5984,8867,0,31
113500,33626L,10900,2,350,3.32,91.9,360170,331002,-29168,2950,3259,309,712643,10900,10900,10900,190,0,6,5949,9143,0,190
113600,33626L,10900,2,350,3.32,91.9,360170,331003,-29167,2950,3260,310,712644,10900,10900,10900,0,0,0,5949,9972,0,0
113600,33626L,10900,2,350,3.32,91.97,360170,331238,-28932,2950,3262,312,712879,10900,10900,10900,235,0,2,5414,10022,0,235
113700,33626L,10900,2,350,3.32,91.92,360347,331239,-29108,2952,3263,311,713057,10900,10900,10900,0,0,0,5151,9935,0,0
113700,33626L,10900,2,350,3.32,91.92,360577,331450,-29127,2954,3264,310,713498,10850,10900,10850,441,2,1,5443,10308,230,211
113800,33626L,10900,2,350,3.32,91.92,360577,331450,-29127,2954,3264,310,713498,10900,10900,10900,0,0,0,5443,10308,0,0
113800,33626L,10900,2,350,3.32,91.92,360577,331450,-29127,2954,3264,310,713498,10900,10900,10900,0,0,0,5443,10308,0,0
113900,33626L,10900,2,350,3.32,91.93,360577,331481,-29096,2954,3265,311,713529,10900,10900,10900,31,0,1,5109,10567,0,31
113900,33626L,10850,2,300,2.84,91.92,360620,331481,-29139,2955,3265,310,713572,10900,10900,10850,74,1,1,5088,10397,43,31
114000,33626L,10800,2,250,2.37,91.48,362366,331481,-30885,2959,3265,306,715318,10850,10850,10800,1746,4,0,5123,9086,1746,0
114000,33626L,10800,2,250,2.37,91.48,362366,331481,-30885,2959,3265,306,715318,10850,10850,10800,1746,4,0,5123,9086,1746,0
114100,33626L,10800,2,250,2.37,91.48,362366,331481,-30885,2959,3265,306,715318,10800,10800,10800,0,0,0,5123,9086,0,0
114200,33626L,10850,2,300,2.84,91.48,362366,331482,-30884,2959,3266,307,715319,10850,10850,10850,0,0,0,5023,7732,0,0
114200,33626L,10850,2,300,2.84,91.5,362366,331560,-30806,2959,3267,308,715397,10850,10850,10850,78,0,1,4975,7835,0,78
114300,33626L,10850,2,300,2.84,91.5,362366,331560,-30806,2959,3267,308,715397,10850,10850,10850,0,0,0,4975,7835,0,0
114300,33626L,10850,2,300,2.84,91.5,362366,331560,-30806,2959,3267,308,715397,10850,10850,10850,0,0,0,4960,8324,0,0
114400,33626L,10900,2,350,3.32,91.51,362366,331604,-30762,2959,3269,310,715441,10900,10900,10900,0,0,0,4917,8355,0,0
114400,33626L,10900,2,350,3.32,91.52,362366,331637,-30729,2959,3270,311,715474,10900,10900,10900,33,0,1,5286,8949,0,33
114500,33626L,10900,2,350,3.32,91.55,362366,331748,-30618,2959,3271,312,715585,10900,10900,10900,0,0,0,5253,8949,0,0
114500,33626L,10850,2,300,2.84,91.31,363313,331754,-31559,2963,3272,309,716538,10850,10900,10850,953,4,1,5266,8726,947,6
114600,33626L,10900,2,350,3.32,91.32,363313,331770,-31543,2963,3273,310,716554,10900,10900,10900,0,0,0,4767,7737,0,0
114600,33626L,10900,2,350,3.32,91.35,363313,331895,-31418,2963,3275,312,716679,10900,10900,10900,125,0,2,4444,7785,0,125
114700,33626L,10900,2,350,3.32,91.36,363313,331933,-31380,2963,3278,315,716717,10900,10900,10900,33,0,1,4317,7702,0,33
114700,33626L,10950,2,400,3.79,91.34,363424,331935,-31489,2964,3280,316,716830,10900,10950,10900,146,1,3,4748,7694,111,35
114800,33626L,10950,2,400,3.79,91.34,363424,331938,-31486,2964,3283,319,716833,10950,10950,10950,2,0,2,4790,8159,0,2
114800,33626L,10950,2,400,3.79,91.34,363424,331944,-31480,2964,3285,321,716839,10950,10950,10950,8,0,4,4803,8032,0,8
114900,33626L,10950,2,400,3.79,91.31,363538,331945,-31593,2965,3286,321,716954,10900,10950,10900,115,1,1,4799,7918,114,1
114900,33626L,10900,2,350,3.32,91.18,364042,331945,-32097,2968,3286,318,717458,10900,10950,10900,619,4,1,4772,7489,618,1
115000,33626L,10900,2,350,3.32,91.16,364131,331946,-32185,2970,3287,317,717548,10900,10900,10900,88,1,0,4822,7028,88,0
115000,33626L,10900,2,350,3.32,91.2,364131,332074,-32057,2970,3288,318,717676,10900,10900,10900,216,1,1,4585,8119,88,128
115100,33626L,10900,2,350,3.32,91.2,364131,332074,-32057,2970,3288,318,717676,10900,10900,10900,0,0,0,4585,8119,0,0
115100,33626L,10900,2,350,3.32,91.11,364494,332074,-32420,2972,3288,316,718039,10900,10900,10900,363,2,0,4922,8132,363,0
115200,33626L,10900,2,350,3.32,91.03,364785,332074,-32711,2975,3288,313,718330,10900,10900,10900,291,3,0,4822,8027,291,0
115200,33626L,10900,2,350,3.32,90.9,365335,332074,-33261,2976,3288,312,718880,10900,10900,10900,841,4,0,4823,8155,841,0
115300,33626L,10900,2,350,3.32,90.89,365376,332074,-33302,2978,3288,310,718921,10900,10900,10900,36,1,0,4268,7665,36,0
115300,33626L,10900,2,350,3.32,90.86,365500,332088,-33412,2979,3289,310,719059,10900,10900,10900,174,2,1,4268,8004,160,14
115400,33626L,10850,2,300,2.84,90.85,365533,332088,-33445,2980,3289,309,719092,10850,10850,10850,33,1,0,3957,8791,33,0
115400,33626L,10850,2,300,2.84,90.63,366434,332091,-34343,2984,3290,306,719996,10850,10850,10800,937,5,1,3139,10720,934,3
115500,33626L,10850,2,300,2.84,90.64,366438,332155,-34283,2985,3292,307,720064,10850,10850,10850,58,1,1,4322,11485,4,54
115600,33626L,10850,2,300,2.84,90.64,366438,332155,-34283,2985,3292,307,720064,10850,10850,10850,0,0,0,4322,11485,0,0
115600,33626L,10900,2,350,3.32,90.8,366438,332725,-33713,2985,3294,309,720634,10900,10900,10900,570,0,2,4325,8643,0,570
115700,33626L,10950,2,400,3.79,90.92,366467,333185,-33282,2987,3295,308,721123,10950,10950,10950,0,0,0,4677,8597,0,0
115700,33626L,10950,2,400,3.79,90.87,366742,333251,-33491,2989,3297,308,721464,10950,10950,10900,341,2,2,4286,8666,275,66
115800,33626L,10950,2,400,3.79,90.87,366742,333251,-33491,2989,3297,308,721464,10950,10950,10950,0,0,0,4286,8666,0,0
115800,33626L,10950,2,400,3.79,90.87,366742,333271,-33471,2989,3298,309,721484,10950,10950,10950,20,0,1,4408,8836,0,20
115900,33626L,11000,2,450,4.27,90.88,366846,333380,-33466,2991,3302,311,721697,11000,11000,11000,0,0,0,4369,8784,0,0
115900,33626L,11000,2,450,4.27,90.87,366919,333402,-33517,2993,3305,312,721792,10950,11000,10950,95,2,3,4665,8746,73,22
120000,33626L,10900,2,350,3.32,90.89,367107,333672,-33435,2995,3307,312,722250,10900,10900,10900,56,1,0,4416,8792,56,0
120000,33626L,10900,2,350,3.32,90.84,367307,333672,-33635,2996,3307,311,722450,10900,10900,10900,256,2,0,4087,8886,256,0
120100,33626L,10900,2,350,3.32,90.84,367307,333672,-33635,2996,3307,311,722450,10900,10900,10900,0,0,0,4087,8886,0,0
120100,33626L,10850,2,300,2.84,90.61,368234,333672,-34562,2999,3307,308,723377,10900,10900,10850,927,3,0,4183,9042,927,0
120200,33626L,10850,2,300,2.84,90.61,368234,333672,-34562,2999,3307,308,723377,10850,10850,10850,0,0,0,4183,9042,0,0
120200,33626L,10850,2,300,2.84,90.59,368324,333672,-34652,3000,3307,307,723467,10850,10850,10850,90,1,0,4203,10241,90,0
120300,33626L,10900,2,350,3.32,90.57,368424,333672,-34752,3001,3307,306,723567,10900,10900,10900,100,1,0,4075,9750,100,0
120300,33626L,10900,2,350,3.32,90.56,368434,333672,-34762,3002,3307,305,723577,10900,10900,10900,110,2,0,4069,9713,110,0
120400,33626L,10900,2,350,3.32,90.56,368434,333672,-34762,3002,3307,305,723577,10900,10900,10900,0,0,0,4664,9762,0,0
120500,33626L,10900,2,350,3.32,90.56,368434,333672,-34762,3002,3307,305,723577,10900,10900,10900,0,0,0,4127,9742,0,0
120500,33626L,10900,2,350,3.32,90.56,368434,333672,-34762,3002,3307,305,723577,10900,10900,10900,0,0,0,4128,9721,0,0
120600,33626L,10900,2,350,3.32,90.56,368454,333672,-34782,3003,3307,304,723597,10900,10900,10900,20,1,0,5202,12870,20,0
120600,33626L,10900,2,350,3.32,90.5,368706,333674,-35032,3006,3308,302,723851,10900,10950,10900,274,4,1,5200,12783,272,2
120700,33626L,10900,2,350,3.32,90.5,368706,333674,-35032,3006,3308,302,723851,10900,10900,10900,0,0,0,5200,12783,0,0
120700,33626L,10900,2,350,3.32,90.53,368888,333962,-34926,3007,3309,302,724321,10900,10900,10900,470,1,1,4765,12914,182,288
120800,33626L,10900,2,350,3.32,90.53,368921,333972,-34949,3008,3310,302,724364,10900,10900,10900,0,0,0,4333,13012,0,0
120800,33626L,10900,2,350,3.32,90.51,369021,333987,-35034,3009,3311,302,724479,10900,10900,10900,115,1,1,4836,13830,100,15
120900,33626L,10900,2,350,3.32,90.5,369027,333987,-35040,3010,3311,301,724485,10900,10900,10900,6,1,0,4836,22488,6,0
121000,33626L,10900,2,350,3.32,90.48,369143,333987,-35156,3012,3311,299,724601,10900,10900,10900,0,0,0,4836,24937,0,0
121000,33626L,10900,2,350,3.32,90.48,369143,333987,-35156,3012,3311,299,724601,10900,10900,10900,0,0,0,4836,24937,0,0
121100,33626L,10900,2,350,3.32,90.36,369628,333997,-35631,3013,3312,299,725096,10900,10900,10900,0,0,0,4876,22366,0,0
121100,33626L,10950,2,400,3.79,90.36,369648,333998,-35650,3014,3313,299,725117,10900,10950,10900,21,1,1,4875,21442,20,1
121200,33626L,11000,2,450,4.27,90.64,369648,335066,-34582,3014,3318,304,726185,10950,11000,10950,1001,0,4,4165,21999,0,1001
121200,33626L,11000,2,450,4.27,90.65,369648,335088,-34560,3014,3321,307,726207,10950,11000,10950,1023,0,7,4435,21999,0,1023
121300,33626L,11050,2,500,4.74,90.74,369692,335441,-34251,3016,3326,310,726604,11050,11050,11050,250,0,1,6209,21375,0,250
121300,33626L,11000,2,450,4.27,90.87,370188,336392,-33796,3021,3333,312,728051,11050,11100,11000,1697,5,8,5821,19862,496,1201
121400,33626L,11050,2,500,4.74,90.97,370222,336802,-33420,3025,3337,312,728495,11050,11050,11050,254,4,2,5613,19794,34,220
121400,33626L,11050,2,500,4.74,90.95,370558,337024,-33534,3030,3340,310,729053,11050,11050,11050,812,9,5,5529,19847,370,442
121500,33626L,11050,2,500,4.74,91.09,370567,337556,-33011,3031,3345,314,729594,11050,11050,11050,467,0,4,6029,21096,0,467
121500,33626L,11100,2,550,5.21,91.26,370567,338182,-32385,3031,3351,320,730220,11050,11100,11050,1093,0,10,5621,20875,0,1093
121600,33626L,11050,2,500,4.74,91.29,370784,338489,-32295,3033,3353,320,730744,11100,11100,11050,324,1,2,6307,21279,17,307
121700,33626L,11000,2,450,4.27,91.27,370884,338489,-32395,3034,3353,319,730844,11000,11000,11000,0,0,0,6407,20827,0,0
121700,33626L,11050,2,500,4.74,91.24,371135,338620,-32515,3036,3357,321,731226,11000,11050,11000,382,2,4,6498,21035,251,131
121800,33626L,11100,2,550,5.21,91.55,371205,339824,-31381,3106,3434,328,732500,11100,11150,11100,11,6,5,5389,16684,6,5
121800,33626L,11150,2,600,5.69,91.73,371860,341111,-30749,3190,3522,332,734442,11100,11250,11100,1953,90,93,4825,16058,661,1292
121900,33626L,11200,2,650,6.16,91.92,372269,342180,-30089,3273,3609,336,735920,11200,11250,11150,511,13,13,4740,16591,155,356
121900,33626L,11250,2,700,6.64,92.0,372347,342541,-29806,3351,3696,345,736359,11200,11250,11150,950,91,100,4696,16015,233,717
122000,33626L,11250,2,700,6.64,92.11,372441,343069,-29372,3434,3785,351,736981,11200,11250,11200,31,15,16,4607,16899,15,16
122000,33626L,11450,2,900,8.53,92.68,372709,345409,-27300,3523,3890,367,739589,11200,11450,11200,2639,104,121,6851,6356,283,2356
122100,33626L,11350,2,800,7.58,92.46,375425,347125,-28300,3588,3974,386,744021,11350,11350,11250,490,2,8,5521,14775,162,328
122100,33626L,11250,2,700,6.64,92.39,375945,347323,-28622,3596,3977,381,744739,11350,11350,11200,1208,10,11,3484,13801,682,526
122200,33626L,11350,2,800,7.58,92.43,376072,347591,-28481,3600,3982,382,745134,11350,11350,11350,0,0,0,6893,13317,0,0
122200,33626L,11300,2,750,7.11,92.49,376072,347826,-28246,3600,3985,385,745369,11300,11300,11300,235,0,3,4716,17518,0,235
122300,33626L,11300,2,750,7.11,92.49,376072,347826,-28246,3600,3985,385,745369,11300,11300,11300,0,0,0,4716,17518,0,0
122300,33626L,11250,2,700,6.64,92.44,376345,347899,-28446,3602,3986,384,745715,11200,11300,11200,346,2,1,4846,17338,273,73
122400,33626L,11200,2,650,6.16,92.32,376848,347899,-28949,3604,3986,382,746218,11200,11200,11200,0,0,0,4846,17190,0,0
122400,33626L,11350,2,800,7.58,92.35,376848,348035,-28813,3604,3991,387,746354,11250,11350,11250,136,0,5,6454,17250,0,136
122500,33626L,11350,2,800,7.58,92.4,376848,348202,-28646,3604,3995,391,746521,11350,11350,11350,137,0,1,6492,16909,0,137
122500,33626L,11300,2,750,7.11,92.41,377044,348426,-28618,3609,3999,390,746941,11350,11350,11300,557,5,5,6761,13124,196,361
122600,33626L,11300,2,750,7.11,92.46,377076,348662,-28414,3610,4001,391,747209,11300,11300,11300,268,1,2,4455,17075,32,236
122600,33626L,11300,2,750,7.11,92.32,377684,348662,-29022,3612,4001,389,747817,11300,11300,11300,876,3,2,6961,12937,640,236
122700,33626L,11350,2,800,7.58,92.41,377794,349107,-28687,3614,4006,392,748372,11300,11350,11250,555,2,5,6660,10773,110,445
122700,33626L,11400,2,850,8.06,92.52,377794,349519,-28275,3614,4009,395,748784,11300,11400,11250,967,2,8,6564,11968,110,857
122800,33626L,11400,2,850,8.06,92.59,377809,349829,-27980,3617,4015,398,749109,11400,11400,11350,325,3,6,6611,14007,15,310
122800,33626L,11350,2,800,7.58,92.65,377963,350171,-27792,3619,4021,402,749605,11400,11400,11300,821,5,12,5918,13426,169,652
122900,33626L,11450,2,900,8.53,93.05,377969,351693,-26276,3620,4028,408,751133,11350,11450,11350,1528,1,7,6449,13264,6,1522
123000,33626L,11300,2,750,7.11,93.09,378262,352126,-26136,3625,4033,408,751859,11300,11300,11300,0,0,0,5762,13123,0,0
123000,33626L,11300,2,750,7.11,92.9,379491,352549,-26942,3672,4083,411,753511,11300,11300,11200,1652,47,50,5065,16911,1229,423
123100,33626L,11250,2,700,6.64,92.93,379568,352724,-26844,3749,4178,429,753763,11250,11350,11250,27,13,13,7192,16391,13,14
123100,33626L,11500,2,950,9.0,93.18,379651,353757,-25894,3829,4303,474,754879,11250,11500,11250,1143,93,138,6993,10589,96,1047
123200,33626L,11600,2,1050,9.95,93.6,380866,356505,-24361,3920,4455,535,758843,11500,11650,11500,830,21,28,10071,6684,220,610
123200,33626L,11500,2,950,9.0,93.6,381396,356995,-24401,4010,4567,557,759864,11500,11650,11450,1851,111,140,7800,8257,750,1100
123300,33626L,11650,2,1100,10.43,94.22,381957,359870,-22087,4089,4665,576,763300,11600,11650,11550,1538,17,19,13186,6182,278,1260
123300,33626L,11600,2,1050,9.95,94.43,382380,361077,-21303,4095,4673,578,765102,11600,11700,11550,3340,23,27,13292,6366,701,2467
123400,33626L,11600,2,1050,9.95,94.38,383149,361601,-21548,4104,4680,576,766395,11650,11650,11600,538,3,4,11525,6304,344,194
123400,33626L,11550,2,1000,9.48,93.95,385260,361944,-23316,4114,4683,569,768849,11650,11650,11550,2992,13,7,10606,7195,2455,537
123500,33626L,11600,2,1050,9.95,94.04,385617,362628,-22989,4118,4691,573,769890,11500,11600,11500,480,2,6,10017,7957,90,390
123500,33626L,11600,2,1050,9.95,94.13,385747,363102,-22645,4121,4694,573,770494,11500,11600,11500,1084,5,9,11540,7242,220,864
123600,33626L,11700,2,1150,10.9,94.31,386617,364609,-22008,4125,4707,582,772871,11600,11700,11600,1430,1,12,15841,5991,23,1407
123600,33626L,11750,2,1200,11.37,94.6,387304,366381,-20923,4131,4732,601,775330,11600,11750,11600,3889,7,37,14197,5349,710,3179
123700,33626L,11600,2,1050,9.95,94.02,390672,367322,-23350,4152,4736,584,779639,11750,11750,11600,4023,18,4,12764,5603,3082,941
123700,33626L,11650,2,1100,10.43,93.95,391117,367463,-23654,4160,4741,581,780225,11750,11750,11600,4609,26,9,12663,7459,3527,1082
123800,33626L,11450,2,900,8.53,93.2,394409,367603,-26806,4175,4745,570,783657,11600,11600,11400,3432,15,4,9291,8998,3292,140
123900,33626L,11450,2,900,8.53,93.1,394899,367666,-27233,4181,4746,565,784210,11450,11450,11450,71,1,0,6852,10087,71,0
123900,33626L,11350,2,800,7.58,93.24,395707,368970,-26737,4188,4753,565,786322,11450,11700,11350,2183,8,7,6615,12070,879,1304
124000,33626L,11350,2,800,7.58,93.25,395966,369258,-26708,4193,4758,565,787142,11450,11450,11350,413,2,1,9809,12369,139,1
124000,33626L,11500,2,950,9.0,93.28,396042,369427,-26615,4195,4763,568,787387,11450,11550,11350,658,4,6,7950,12410,215,170
124100,33626L,11400,2,850,8.06,93.1,396877,369488,-27389,4199,4767,568,788283,11450,11450,11400,835,4,0,6890,12131,835,0
124100,33626L,11350,2,800,7.58,93.05,397127,369509,-27618,4202,4770,568,788554,11450,11450,11350,1106,7,3,4891,13103,1085,21
124200,33626L,11250,2,700,6.64,92.6,399017,369509,-29508,4212,4770,558,790444,11300,11300,11250,813,8,0,7432,14859,813,0
124200,33626L,11300,2,750,7.11,92.87,399315,370836,-28479,4215,4775,560,792069,11300,11300,11250,2438,11,5,7752,12439,1111,1327
124300,33626L,11300,2,750,7.11,92.84,399437,370849,-28588,4218,4779,561,792204,11300,11300,11300,133,2,4,6508,15490,120,13
124400,33626L,11200,2,650,6.16,92.52,400919,370942,-29977,4231,4781,550,793779,11200,11200,11200,582,3,0,5885,15963,582,0
124400,33626L,11200,2,650,6.16,92.38,401785,371169,-30616,4234,4785,551,794872,11200,11250,11150,1675,6,4,2667,15875,1448,227
124500,33626L,11200,2,650,6.16,92.25,402374,371186,-31188,4237,4791,554,795478,11200,11200,11200,1,0,1,2562,15876,0,1
124500,33626L,11250,2,700,6.64,92.29,402524,371496,-31028,4240,4797,557,795938,11200,11250,11200,461,3,7,3700,12245,150,311
124600,33626L,11250,2,700,6.64,92.3,402527,371533,-30994,4242,4799,557,795978,11200,11250,11200,38,1,2,3884,13369,1,37
124600,33626L,11300,2,750,7.11,92.48,402604,372321,-30283,4245,4812,567,796843,11200,11300,11200,903,4,15,7155,11643,78,825
124700,33626L,11200,2,650,6.16,92.45,402852,372448,-30404,4249,4816,567,797218,11300,11300,11200,341,4,2,4634,12617,248,93
124800,33626L,11250,2,700,6.64,92.45,402982,372570,-30412,4250,4817,567,797470,11250,11250,11250,0,0,0,4483,13316,0,0
124800,33626L,11250,2,700,6.64,92.45,403369,372910,-30459,4255,4819,564,798197,11250,11250,11250,727,5,2,4444,13348,387,340
124900,33626L,11250,2,700,6.64,92.4,403663,372970,-30693,4259,4820,561,798551,11200,11250,11200,354,4,1,4163,13022,294,60
124900,33626L,11250,2,700,6.64,92.37,403768,372974,-30794,4263,4822,559,798660,11200,11250,11200,463,8,3,8192,13069,399,64
125000,33626L,11250,2,700,6.64,92.36,403818,372976,-30842,4264,4824,560,798712,11250,11250,11250,2,0,2,4765,13545,0,2
125100,33626L,11250,2,700,6.64,92.41,403821,373190,-30631,4265,4829,564,798929,11250,11250,11250,0,0,0,4647,13582,0,0
125100,33626L,11250,2,700,6.64,92.41,403833,373190,-30643,4267,4829,562,798941,11250,11250,11250,12,2,0,8347,13157,12,0
125200,33626L,11250,2,700,6.64,92.39,403943,373190,-30753,4269,4829,560,799051,11250,11250,11250,110,2,0,8340,12779,110,0
125300,33626L,11250,2,700,6.64,92.3,404327,373193,-31134,4274,4830,556,799438,11250,11250,11250,0,0,0,7869,12652,0,0
125300,33626L,11250,2,700,6.64,92.3,404328,373194,-31134,4275,4831,556,799440,11300,11300,11250,2,1,1,7868,12576,1,1
125400,33626L,11250,2,700,6.64,92.3,404328,373194,-31134,4275,4831,556,799440,11250,11250,11250,0,0,0,7868,12576,0,0
125400,33626L,11250,2,700,6.64,92.2,404790,373204,-31586,4278,4832,554,799912,11250,11250,11200,472,3,1,5114,12828,462,10
125500,33626L,11200,2,650,6.16,92.16,404950,373204,-31746,4279,4832,553,800072,11200,11200,11200,160,1,0,5390,11792,160,0
125600,33626L,11200,2,650,6.16,92.04,405958,373638,-32320,4280,4833,553,801514,11200,11200,11200,0,0,0,2460,15442,0,0
125600,33626L,11250,2,700,6.64,92.07,405961,373785,-32176,4281,4834,553,801664,11250,11250,11250,150,1,1,4843,16255,3,147
125700,33626L,11400,2,850,8.06,92.27,406043,374647,-31396,4284,4841,557,802608,11400,11400,11400,208,3,1,7836,13860,82,126
125700,33626L,11450,2,900,8.53,92.32,406186,375011,-31175,4286,4845,559,803115,11400,11450,11400,715,5,5,8448,11967,225,490
125800,33626L,11400,2,850,8.06,92.22,406655,375014,-31641,4292,4848,556,803587,11500,11500,11400,17,1,2,8592,13053,15,2
125800,33626L,11400,2,850,8.06,92.16,407156,375241,-31915,4297,4853,556,804315,11500,11500,11400,745,6,7,7896,14217,516,229
125900,33626L,11400,2,850,8.06,92.16,407156,375242,-31914,4297,4854,557,804316,11400,11400,11400,1,0,1,7940,14598,0,1
130000,33626L,11400,2,850,8.06,91.95,408125,375286,-32839,4301,4855,554,805329,11400,11400,11400,899,3,0,9216,14144,899,0
130000,33626L,11450,2,900,8.53,91.91,408431,375374,-33057,4306,4865,559,805723,11400,11450,11400,1293,8,10,8831,13518,1205,88
130100,33626L,11400,2,850,8.06,91.87,408642,375402,-33240,4310,4870,560,805962,11400,11450,11400,88,3,4,7631,14798,61,27
130100,33626L,11250,2,700,6.64,91.52,410328,375520,-34808,4319,4873,554,807766,11400,11450,11250,1892,12,7,7305,15701,1747,145
130200,33626L,11300,2,750,7.11,91.54,410328,375622,-34706,4319,4876,557,807868,11300,11300,11300,101,0,2,7274,15873,0,101
130200,33626L,11250,2,700,6.64,91.47,410673,375652,-35021,4320,4877,557,808243,11300,11300,11250,476,1,3,7964,15384,345,131
130300,33626L,11400,2,850,8.06,91.55,410750,376039,-34711,4321,4881,560,808707,11400,11400,11350,201,0,3,7449,16018,0,201
130300,33626L,11350,2,800,7.58,91.52,410863,376040,-34823,4322,4882,560,808821,11400,11400,11250,315,1,4,7081,15182,113,202
130400,33626L,11300,2,750,7.11,91.5,411093,376153,-34940,4344,4906,562,809164,11300,11350,11300,343,22,24,6847,15434,230,113
130400,33626L,11400,2,850,8.06,91.53,411172,376357,-34815,4422,4994,572,809447,11300,11400,11300,626,100,112,7473,15447,309,317
130500,33626L,11400,2,850,8.06,91.75,411255,377313,-33942,4505,5094,589,810486,11400,11450,11300,1006,67,84,8887,12830,67,939
130500,33626L,11400,2,850,8.06,91.69,411661,377451,-34210,4592,5201,609,811030,11400,11450,11300,1550,154,191,7524,14655,473,1077
130600,33626L,11350,2,800,7.58,91.7,411741,377550,-34191,4672,5282,610,811209,11350,11400,11350,163,72,73,7664,14659,72,91
130700,33626L,11350,2,800,7.58,91.66,411971,377627,-34344,4745,5356,611,811516,11350,11400,11350,3,2,1,7546,14438,2,1
130700,33626L,11350,2,800,7.58,91.65,412149,377721,-34428,4796,5425,629,811788,11350,11400,11300,275,53,70,7744,15180,180,95
130800,33626L,11250,2,700,6.64,91.41,413233,377728,-35505,4801,5431,630,812879,11300,11300,11250,59,1,1,6426,13741,58,1
130800,33626L,11250,2,700,6.64,91.41,413233,377731,-35502,4801,5434,633,812882,11300,11300,11250,62,1,4,6152,14310,58,4
130900,33626L,11200,2,650,6.16,91.37,413438,377757,-35681,4802,5438,636,813113,11200,11200,11200,0,0,0,5592,14120,0,0
130900,33626L,11300,2,750,7.11,90.93,415447,377766,-37681,4805,5444,639,815131,11200,11350,11100,2018,3,6,6196,13544,2009,9
131000,33626L,11300,2,750,7.11,90.93,415447,377767,-37680,4805,5445,640,815132,11300,11300,11300,0,0,0,6195,13363,0,0
131000,33626L,11300,2,750,7.11,90.93,415447,377767,-37680,4805,5445,640,815132,11300,11300,11300,0,0,0,6195,13363,0,0
131100,33626L,11150,2,600,5.69,91.0,415817,378398,-37419,4808,5448,640,816133,11200,11200,11150,224,2,1,6705,13958,200,24
131100,33626L,11200,2,650,6.16,90.96,415995,378400,-37595,4810,5450,640,816313,11200,11250,11150,404,4,3,6416,15682,378,26
131200,33626L,11150,2,600,5.69,90.85,416514,378400,-38114,4812,5450,638,816832,11150,11150,11150,519,2,0,4016,15655,519,0
131200,33626L,11100,2,550,5.21,90.58,417768,378400,-39368,4816,5450,634,818086,11150,11150,11100,1773,6,0,4016,15366,1773,0
131300,33626L,11150,2,600,5.69,90.57,417785,378400,-39385,4817,5450,633,818103,11150,11150,11150,0,0,0,4016,12243,0,0
131300,33626L,11150,2,600,5.69,90.57,417786,378400,-39386,4818,5450,632,818104,11150,11150,11150,1,1,0,4016,12589,1,0
131400,33626L,11100,2,550,5.21,90.5,418143,378400,-39743,4820,5450,630,818461,11150,11150,11100,357,2,0,3659,15498,357,0
131400,33626L,11150,2,600,5.69,90.47,418268,378427,-39841,4822,5451,629,818613,11150,11150,11100,509,4,1,3661,16325,482,27
131500,33626L,11150,2,600,5.69,90.44,418425,378438,-39987,4826,5452,626,818781,11150,11150,11150,157,4,0,6089,15334,157,0
131500,33626L,11150,2,600,5.69,90.44,418425,378438,-39987,4826,5452,626,818781,11150,11150,11150,157,4,0,6089,15334,157,0
131600,33626L,11150,2,600,5.69,90.44,418445,378438,-40007,4828,5452,624,818801,11150,11150,11150,0,0,0,6089,15979,0,0
131600,33626L,11250,2,700,6.64,90.48,418610,378749,-39861,4832,5454,622,819277,11150,11250,11100,476,4,2,6089,17166,165,311
131700,33626L,11250,2,700,6.64,90.48,418610,378750,-39860,4832,5455,623,819278,11250,11250,11250,0,0,0,6088,17166,0,0
131700,33626L,11250,2,700,6.64,90.59,418610,379199,-39411,4832,5456,624,819727,11250,11250,11250,449,0,1,6267,17075,0,449
131800,33626L,11250,2,700,6.64,90.59,418610,379199,-39411,4832,5456,624,819727,11250,11250,11250,0,0,0,6267,17075,0,0
131800,33626L,11300,2,750,7.11,90.57,418740,379249,-39491,4833,5457,624,819907,11300,11300,11300,180,1,1,7992,16100,130,50
131900,33626L,11300,2,750,7.11,90.53,418921,379268,-39653,4835,5458,623,820107,11300,11300,11300,200,2,1,8095,16143,181,19
132000,33626L,11300,2,750,7.11,90.51,419122,379368,-39754,4837,5459,622,820408,11300,11300,11300,103,1,0,7715,13413,103,0
132000,33626L,11350,2,800,7.58,90.55,419122,379517,-39605,4837,5462,625,820557,11300,11350,11300,252,1,3,7714,13828,103,149
132100,33626L,11350,2,800,7.58,90.5,419470,379617,-39853,4839,5464,625,821005,11350,11350,11350,1,0,1,7716,13576,0,1
132100,33626L,11350,2,800,7.58,90.51,419544,379719,-39825,4841,5466,625,821181,11350,11400,11350,177,2,3,7816,13877,74,103
132200,33626L,11350,2,800,7.58,90.54,419633,379930,-39703,4843,5467,624,821481,11350,11350,11350,0,0,0,7771,13897,0,0
132200,33626L,11350,2,800,7.58,90.54,419633,379930,-39703,4843,5467,624,821481,11350,11350,11350,0,0,0,7771,13897,0,0
132300,33626L,11300,2,750,7.11,90.45,420332,380177,-40155,4846,5469,623,822427,11300,11300,11300,0,0,0,8944,14185,0,0
132300,33626L,11300,2,750,7.11,90.45,420332,380177,-40155,4846,5469,623,822427,11300,11300,11300,0,0,0,8944,14185,0,0
132400,33626L,11300,2,750,7.11,90.45,420332,380177,-40155,4846,5469,623,822427,11300,11300,11300,0,0,0,8966,14245,0,0
132400,33626L,11350,2,800,7.58,90.47,420332,380267,-40065,4846,5471,625,822517,11350,11350,11350,90,0,2,8913,14345,0,90
132500,33626L,11350,2,800,7.58,90.53,420332,380513,-39819,4846,5472,626,822763,11350,11350,11350,0,0,0,8906,14545,0,0
132500,33626L,11350,2,800,7.58,90.53,420332,380513,-39819,4846,5472,626,822763,11350,11350,11350,0,0,0,8906,14545,0,0
132600,33626L,11350,2,800,7.58,90.49,420542,380543,-39999,4847,5473,626,823003,11350,11350,11350,0,0,0,8853,13929,0,0
132600,33626L,11500,2,950,9.0,91.08,420542,383034,-37508,4847,5490,643,825494,11400,11500,11400,2491,0,17,8553,10303,0,2491
132700,33626L,11500,2,950,9.0,91.2,420853,383808,-37045,4850,5498,648,826579,11500,11500,11500,73,0,1,8721,11751,0,73
132700,33626L,11400,2,850,8.06,91.11,421401,383932,-37469,4854,5502,648,827251,11500,11500,11400,745,4,5,8786,10527,548,197
132800,33626L,11500,2,950,9.0,91.24,421827,384860,-36967,4862,5509,647,828605,11500,11500,11400,555,5,4,10804,8999,301,254
132900,33626L,11500,2,950,9.0,91.36,421886,385423,-36463,4865,5516,651,829227,11500,11500,11500,342,2,1,8441,10592,56,286
132900,33626L,11500,2,950,9.0,91.4,421903,385637,-36266,4866,5520,654,829458,11500,11500,11500,573,3,5,8407,10694,73,500
133000,33626L,11500,2,950,9.0,91.56,421914,386315,-35599,4868,5529,661,830147,11500,11500,11500,461,0,5,8775,10513,0,461
133000,33626L,11550,2,1000,9.48,91.65,422131,386889,-35242,4870,5536,666,830938,11500,11550,11500,1252,2,12,10965,9645,217,1035
133100,33626L,11500,2,950,9.0,91.85,422412,387990,-34422,4873,5540,667,832320,11550,11550,11500,282,3,1,10390,7929,281,1
133100,33626L,11500,2,950,9.0,91.86,422583,388187,-34396,4874,5542,668,832688,11550,11550,11450,650,4,3,8238,10774,452,198
