090200,001060,30800,2,250,0.82,13.05,1578,206,-1372,23,9,-14,2996,31000,31000,30800,1230,15,3,2626,3142,1188,42
090300,001060,30850,2,300,0.98,12.27,1801,221,-1580,30,10,-20,3234,31000,31000,30800,238,7,1,2293,2978,223,15
090500,001060,30950,2,400,1.31,17.98,1802,324,-1478,31,16,-15,3338,30950,30950,30950,0,0,0,1969,3329,0,0
090600,001060,31000,2,450,1.47,36.17,1902,688,-1214,38,22,-16,3812,31000,31000,31000,0,0,0,3354,3502,0,0
090700,001060,31050,2,500,1.64,40.46,2101,850,-1251,44,28,-16,4173,31050,31050,31050,0,0,0,2368,3593,0,0
090800,001060,31000,2,450,1.47,41.47,2187,907,-1280,49,31,-18,4316,31000,31000,31000,3,2,0,3309,3703,3,0
090900,001060,31000,2,450,1.47,42.06,2449,1030,-1419,53,35,-18,4701,31000,31000,31000,124,1,4,3613,3788,1,123
091000,001060,31000,2,450,1.47,40.89,2595,1061,-1534,56,37,-19,4878,31000,31000,31000,21,1,0,3633,3596,21,0
091100,001060,30850,2,300,0.98,36.63,2913,1067,-1846,67,39,-28,5202,31050,31050,30850,169,6,1,1787,1639,168,1
091200,001060,30900,2,350,1.15,37.77,2923,1104,-1819,68,42,-26,5249,30900,30900,30900,47,1,3,2047,1758,10,37
091400,001060,30850,2,300,0.98,40.73,2973,1211,-1762,72,44,-28,5406,30850,30850,30850,0,0,0,1308,1694,0,0
091500,001060,30850,2,300,0.98,33.32,3689,1229,-2460,80,46,-34,6140,30800,30850,30800,18,1,1,1347,1176,1,17
091600,001060,30650,2,100,0.33,30.86,4093,1263,-2830,85,48,-37,6578,30800,30800,30650,302,3,1,1238,1532,300,2
091700,001060,30750,2,200,0.65,35.89,4151,1490,-2661,88,54,-34,6863,30750,30750,30750,2,0,1,1081,1214,0,2
091800,001060,30700,2,150,0.49,35.61,4221,1503,-2718,91,56,-35,6946,30700,30700,30700,50,1,0,918,1492,50,0
091900,001060,30800,2,250,0.82,38.39,4280,1643,-2637,92,64,-28,7145,30900,30900,30800,131,1,2,2053,2229,59,72
092000,001060,30750,2,200,0.65,36.11,4553,1644,-2909,97,65,-32,7419,30750,30750,30750,2,1,1,2213,1972,1,1
092100,001060,30700,2,150,0.49,36.02,4564,1644,-2920,98,65,-33,7430,30700,30700,30700,11,1,0,2202,2003,11,0
092200,001060,30650,2,100,0.33,34.76,4729,1644,-3085,101,65,-36,7595,30650,30650,30650,25,1,0,2686,1919,25,0
092300,001060,30650,2,100,0.33,35.07,4976,1745,-3231,103,68,-35,7943,30650,30650,30600,348,2,3,2688,1494,247,101
092400,001060,30600,2,50,0.16,38.56,5091,1963,-3128,105,74,-31,8276,30650,30650,30600,203,2,5,2435,1433,115,88
092500,001060,30600,2,50,0.16,39.52,5091,2012,-3079,105,76,-29,8325,30600,30600,30600,49,0,2,2391,1332,0,49
092600,001060,30650,2,100,0.33,40.02,5092,2038,-3054,106,81,-25,8352,30650,30700,30650,23,1,3,2394,2363,1,22
092800,001060,30650,2,100,0.33,39.7,5133,2038,-3095,111,81,-30,8393,30650,30650,30650,10,1,0,2073,2438,10,0
092900,001060,30650,2,100,0.33,34.16,5993,2047,-3946,115,83,-32,9262,30600,30650,30600,101,1,1,2160,2355,100,1
093000,001060,30600,2,50,0.16,36.08,5995,2163,-3832,116,85,-31,9380,30600,30600,30600,0,0,0,2575,2368,0,0
093100,001060,30600,2,50,0.16,35.17,6151,2163,-3988,119,85,-34,9536,30600,30600,30600,12,1,0,2454,2434,12,0
093200,001060,30650,2,100,0.33,35.11,6186,2172,-4014,120,87,-33,9580,30650,30650,30650,8,0,1,2556,2350,0,8
093300,001060,30650,2,100,0.33,35.11,6186,2172,-4014,120,87,-33,9580,30650,30650,30650,0,0,0,2556,2350,0,0
093400,001060,30600,2,50,0.16,34.08,6514,2220,-4294,123,91,-32,9956,30600,30600,30600,2,0,2,1674,2262,0,2
093500,001060,30600,2,50,0.16,35.22,6516,2295,-4221,125,94,-31,10033,30550,30600,30550,2,1,1,1798,1732,1,1
093600,001060,30600,2,50,0.16,36.02,6616,2383,-4233,126,97,-29,10221,30600,30600,30600,79,0,1,2397,1745,0,79
093700,001060,30600,2,50,0.16,36.55,6659,2434,-4225,129,99,-30,10315,30600,30600,30600,50,0,1,2408,1793,0,50
093800,001060,30600,2,50,0.16,37.06,6972,2584,-4388,132,102,-30,10778,30550,30600,30550,150,0,3,2561,1615,0,150
093900,001060,30550,3,0,0.0,37.8,6985,2640,-4345,133,105,-28,10847,30550,30550,30550,51,0,2,2682,1891,0,51
094000,001060,30500,5,50,-0.16,37.73,7024,2650,-4374,135,106,-29,10896,30500,30550,30500,49,2,1,2671,2026,39,10
094100,001060,30500,5,50,-0.16,39.94,7761,3100,-4661,145,108,-37,12083,30500,30500,30450,494,4,1,3042,1657,484,10
094200,001060,30500,5,50,-0.16,41.44,7771,3220,-4551,146,111,-35,12213,30400,30500,30400,130,1,3,2669,1758,10,120
094300,001060,30400,5,150,-0.49,45.85,8220,3769,-4451,153,114,-39,13211,30450,30450,30400,848,3,2,1746,1834,309,539
094400,001060,30400,5,150,-0.49,44.91,8419,3781,-4638,159,115,-44,13422,30400,30400,30400,191,4,1,1324,2084,179,12
094500,001060,30450,5,100,-0.33,46.19,8419,3889,-4530,159,120,-39,13530,30400,30450,30400,108,0,5,1579,2535,0,108
094600,001060,30550,3,0,0.0,46.34,8454,3918,-4536,162,123,-39,13594,30450,30550,30450,64,3,3,2422,2175,35,29
094700,001060,30550,3,0,0.0,46.3,8480,3926,-4554,164,125,-39,13628,30600,30600,30500,34,2,2,2192,2329,26,8
094800,001060,30550,3,0,0.0,46.49,8480,3942,-4538,164,126,-38,13644,30550,30550,30550,16,0,1,2189,2437,0,16
094900,001060,30500,5,50,-0.16,46.44,8512,3953,-4559,166,130,-36,13687,30500,30550,30500,43,2,4,2180,2499,32,11
095100,001060,30450,5,100,-0.33,45.55,8678,3953,-4725,170,130,-40,13853,30450,30450,30450,0,0,0,1922,2893,0,0
095200,001060,30400,5,150,-0.49,44.42,8922,3963,-4959,174,131,-43,14107,30400,30400,30400,20,1,0,1931,2930,20,0
095300,001060,30400,5,150,-0.49,44.2,8967,3963,-5004,178,131,-47,14152,30400,30400,30400,0,0,0,1924,3011,0,0
095400,001060,30450,5,100,-0.33,43.99,9056,3984,-5072,183,133,-50,14262,30450,30450,30450,0,0,0,2146,7225,0,0
095500,001060,30450,5,100,-0.33,44.05,9072,3996,-5076,185,135,-50,14290,30450,30450,30450,0,0,0,2285,7443,0,0
095600,001060,30550,3,0,0.0,43.94,9176,4032,-5144,187,137,-50,14430,30550,30550,30550,0,0,0,2512,7353,0,0
095700,001060,30550,3,0,0.0,43.64,9241,4033,-5208,190,138,-52,14496,30550,30550,30550,0,0,0,2429,7140,0,0
095800,001060,30550,3,0,0.0,43.65,9266,4045,-5221,191,140,-51,14533,30550,30550,30550,0,0,0,2469,8114,0,0
095900,001060,30500,5,50,-0.16,43.56,9300,4051,-5249,192,141,-51,14573,30500,30500,30500,0,0,0,2453,7358,0,0
100000,001060,30600,2,50,0.16,41.93,9842,4127,-5715,194,144,-50,15191,30600,30600,30600,7,0,1,2678,7241,0,7
100100,001060,30550,3,0,0.0,41.5,9944,4127,-5817,197,144,-53,15293,30550,30550,30550,1,1,0,2739,7150,1,0
100200,001060,30650,2,100,0.33,44.04,10099,4448,-5651,201,147,-54,15769,30650,30650,30650,24,0,2,2638,8856,0,24
100300,001060,30650,2,100,0.33,44.18,10099,4462,-5637,201,148,-53,15783,30650,30650,30650,0,0,0,2627,8828,0,0
100400,001060,30700,2,150,0.49,46.53,10120,4709,-5411,203,151,-52,16051,30700,30700,30700,151,1,1,2764,8902,20,131
100500,001060,30650,2,100,0.33,46.44,10141,4709,-5432,205,151,-54,16072,30650,30650,30650,20,1,0,2867,7054,20,0
100600,001060,30700,2,150,0.49,48.38,10142,4907,-5235,206,155,-51,16271,30700,30700,30650,133,1,2,2846,6983,1,132
100700,001060,30700,2,150,0.49,48.48,10143,4917,-5226,207,156,-51,16282,30700,30700,30700,10,0,1,2849,6982,0,10
100800,001060,30700,2,150,0.49,48.48,10143,4917,-5226,207,156,-51,16282,30700,30700,30700,0,0,0,2849,6982,0,0
100900,001060,30650,2,100,0.33,48.47,10144,4917,-5227,208,156,-52,16283,30650,30650,30650,0,0,0,3024,7025,0,0
101000,001060,30650,2,100,0.33,48.33,10176,4918,-5258,211,157,-54,16316,30650,30650,30650,0,0,0,3101,7092,0,0
101100,001060,30650,2,100,0.33,48.21,10201,4918,-5283,213,157,-56,16341,30650,30650,30650,25,2,0,3332,7105,25,0
101200,001060,30650,2,100,0.33,47.55,10705,5090,-5615,218,159,-59,17017,30650,30650,30650,172,0,2,3221,7012,0,172
101300,001060,30650,2,100,0.33,48.2,10705,5160,-5545,218,160,-58,17087,30650,30650,30650,70,0,1,3307,7030,0,70
101400,001060,30650,2,100,0.33,49.21,10735,5283,-5452,220,161,-59,17240,30600,30650,30600,139,1,1,3350,7057,16,123
101500,001060,30650,2,100,0.33,49.26,10735,5288,-5447,220,162,-58,17245,30650,30650,30650,5,0,1,3368,7075,0,5
101600,001060,30600,2,50,0.16,41.93,12688,5320,-7368,227,163,-64,19230,30600,30600,30600,106,3,1,3143,5461,74,32
101700,001060,30550,3,0,0.0,41.39,12853,5320,-7533,231,163,-68,19395,30550,30550,30550,165,4,0,3148,5314,165,0
101800,001060,30550,3,0,0.0,39.77,13581,5401,-8180,238,165,-73,20204,30600,30600,30550,734,6,1,3257,5216,690,44
101900,001060,30550,3,0,0.0,35.65,15180,5412,-9768,242,166,-76,21814,30550,30550,30550,1610,4,1,3145,3609,1599,11
102000,001060,30500,5,50,-0.16,33.43,16190,5413,-10777,249,167,-82,22825,30500,30500,30450,967,6,1,2512,3599,966,1
102100,001060,30450,5,100,-0.33,32.95,16433,5415,-11018,254,169,-85,23070,30450,30500,30450,244,4,2,2322,3547,242,2
102200,001060,30450,5,100,-0.33,32.9,16459,5415,-11044,255,169,-86,23096,30450,30450,30450,26,1,0,2322,3649,26,0
102300,001060,30450,5,100,-0.33,32.59,16614,5415,-11199,258,169,-89,23251,30450,30450,30450,155,3,0,2333,3476,155,0
102400,001060,30450,5,100,-0.33,32.59,16615,5415,-11200,259,169,-90,23252,30450,30450,30450,1,1,0,2333,3186,1,0
102500,001060,30450,5,100,-0.33,32.53,16651,5416,-11235,261,170,-91,23289,30500,30500,30450,37,2,1,2395,3194,36,1
102600,001060,30450,5,100,-0.33,32.0,16924,5416,-11508,269,170,-99,23562,30450,30450,30450,272,7,0,2395,2965,272,0
102700,001060,30400,5,150,-0.49,31.86,16997,5416,-11581,271,170,-101,23635,30400,30400,30400,31,1,0,1978,3274,31,0
102800,001060,30400,5,150,-0.49,31.85,17013,5419,-11594,273,171,-102,23654,30450,30450,30400,19,2,1,1975,3251,16,3
103000,001060,30400,5,150,-0.49,31.73,17081,5419,-11662,277,171,-106,23722,30400,30400,30400,20,1,0,1994,3207,20,0
103100,001060,30450,5,100,-0.33,31.75,17083,5424,-11659,278,173,-105,23729,30450,30450,30450,1,0,1,1990,3356,0,1
103200,001060,30400,5,150,-0.49,31.69,17114,5424,-11690,280,173,-107,23760,30400,30400,30400,0,0,0,1989,3365,0,0
103300,001060,30400,5,150,-0.49,31.66,17131,5424,-11707,281,173,-108,23777,30400,30400,30400,0,0,0,2010,3342,0,0
103400,001060,30400,5,150,-0.49,31.57,17180,5424,-11756,283,173,-110,23826,30400,30400,30400,24,1,0,2064,3332,24,0
103500,001060,30300,5,250,-0.82,29.41,18749,5514,-13235,293,177,-116,25485,30300,30300,30300,1,0,1,1725,2056,0,1
103600,001060,30300,5,250,-0.82,29.4,18771,5518,-13253,295,179,-116,25511,30250,30300,30250,23,2,1,1735,2161,22,1
103700,001060,30250,5,300,-0.98,29.07,19198,5580,-13618,306,182,-124,26000,30250,30250,30250,14,0,1,722,2540,0,14
103800,001060,30200,5,350,-1.15,28.97,19262,5580,-13682,309,182,-127,26064,30200,30200,30200,10,1,0,948,3051,10,0
103900,001060,30200,5,350,-1.15,28.52,19568,5580,-13988,314,182,-132,26370,30200,30200,30200,0,0,0,657,3866,0,0
104000,001060,30250,5,300,-0.98,28.44,19624,5581,-14043,316,183,-133,26427,30250,30250,30250,1,0,1,672,3835,0,1
104100,001060,30200,5,350,-1.15,28.38,19664,5581,-14083,318,183,-135,26467,30200,30200,30200,0,0,0,644,3697,0,0
104200,001060,30200,5,350,-1.15,28.31,19712,5581,-14131,321,183,-138,26515,30200,30200,30200,21,2,0,626,3495,21,0
104300,001060,30250,5,300,-0.98,28.82,19727,5686,-14041,323,185,-138,26635,30250,30250,30250,14,1,0,1000,3367,14,0
104400,001060,30250,5,300,-0.98,28.8,20025,5768,-14257,326,187,-139,27015,30300,30300,30250,297,2,0,1178,3408,297,0
104500,001060,30250,5,300,-0.98,28.8,20025,5768,-14257,326,187,-139,27015,30250,30250,30250,0,0,0,1178,3408,0,0
104600,001060,30400,5,150,-0.49,29.06,20067,5831,-14236,327,191,-136,27120,30450,30450,30400,88,1,2,2469,4279,42,46
104700,001060,30450,5,100,-0.33,30.91,20067,6203,-13864,327,196,-131,27492,30400,30450,30400,372,0,5,2691,4309,0,372
104800,001060,30500,5,50,-0.16,31.15,20115,6266,-13849,329,198,-131,27603,30450,30500,30450,70,1,2,2494,4034,7,63
104900,001060,30500,5,50,-0.16,31.24,20115,6284,-13831,329,199,-130,27621,30500,30500,30500,18,0,1,2490,3963,0,18
105000,001060,30500,5,50,-0.16,31.41,20115,6319,-13796,329,201,-128,27656,30500,30500,30500,33,0,1,2494,3984,0,33
105100,001060,30400,5,150,-0.49,31.41,20116,6319,-13797,330,201,-129,27657,30400,30400,30400,1,1,0,2461,4003,1,0
105200,001060,30400,5,150,-0.49,31.4,20126,6319,-13807,331,201,-130,27667,30400,30400,30400,10,1,0,2461,4054,10,0
105300,001060,30400,5,150,-0.49,31.4,20126,6319,-13807,331,201,-130,27667,30400,30400,30400,0,0,0,2462,4067,0,0
105400,001060,30450,5,100,-0.33,31.41,20126,6322,-13804,331,202,-129,27670,30450,30450,30450,3,0,1,1986,4661,0,3
105500,001060,30400,5,150,-0.49,31.39,20137,6322,-13815,334,202,-132,27681,30400,30400,30400,11,3,0,2003,4677,11,0
105600,001060,30450,5,100,-0.33,31.42,20137,6328,-13809,334,204,-130,27687,30450,30450,30450,6,0,2,2015,4678,0,6
105700,001060,30450,5,100,-0.33,31.47,20137,6338,-13799,334,206,-128,27697,30450,30450,30450,10,0,2,2038,5288,0,10
105800,001060,30500,5,50,-0.16,31.74,20137,6391,-13746,334,210,-124,27750,30450,30500,30450,41,0,2,2498,5404,0,41
105900,001060,30500,5,50,-0.16,31.89,20137,6422,-13715,334,211,-123,27781,30500,30500,30500,0,0,0,2495,5056,0,0
110000,001060,30500,5,50,-0.16,31.89,20143,6424,-13719,336,212,-124,27789,30450,30500,30450,7,1,1,2494,5090,5,2
110100,001060,30500,5,50,-0.16,31.9,20143,6425,-13718,336,213,-123,27790,30500,30500,30500,1,0,1,2695,5099,0,1
110200,001060,30500,5,50,-0.16,31.86,20167,6425,-13742,337,213,-124,27814,30500,30500,30500,24,1,0,2950,4014,24,0
110300,001060,30450,5,100,-0.33,31.72,20254,6425,-13829,341,213,-128,27901,30500,30500,30450,86,3,0,2752,5078,86,0
110400,001060,30450,5,100,-0.33,31.72,20254,6425,-13829,341,213,-128,27901,30450,30450,30450,0,0,0,2752,5078,0,0
110500,001060,30450,5,100,-0.33,31.72,20257,6425,-13832,342,213,-129,27904,30450,30450,30450,3,1,0,2793,5064,3,0
110600,001060,30450,5,100,-0.33,31.72,20258,6425,-13833,343,213,-130,27905,30450,30450,30450,1,1,0,2793,5080,1,0
110700,001060,30450,5,100,-0.33,31.71,20259,6425,-13834,344,213,-131,27906,30450,30450,30450,1,1,0,2793,5088,1,0
110800,001060,30450,5,100,-0.33,31.71,20260,6425,-13835,345,213,-132,27907,30450,30450,30450,1,1,0,2793,5222,1,0
111000,001060,30450,5,100,-0.33,31.69,20275,6425,-13850,346,213,-133,27922,30450,30450,30450,0,0,0,2793,5242,0,0
111100,001060,30450,5,100,-0.33,31.66,20294,6425,-13869,348,213,-135,27941,30450,30450,30450,0,0,0,2793,5245,0,0
111200,001060,30450,5,100,-0.33,31.66,20294,6425,-13869,348,213,-135,27941,30450,30450,30450,0,0,0,2793,5238,0,0
111300,001060,30450,5,100,-0.33,31.6,20334,6425,-13909,350,213,-137,27981,30450,30450,30450,0,0,0,2867,5236,0,0
111400,001060,30500,5,50,-0.16,31.49,20404,6426,-13978,353,214,-139,28052,30500,30500,30500,1,0,1,2867,5196,0,1
111500,001060,30500,5,50,-0.16,31.5,20404,6427,-13977,353,215,-138,28053,30500,30500,30500,0,0,0,2866,5196,0,0
111600,001060,30450,5,100,-0.33,31.39,20479,6428,-14051,354,216,-138,28129,30450,30450,30450,75,1,0,2874,5226,75,0
111700,001060,30400,5,150,-0.49,31.49,20480,6450,-14030,355,218,-137,28152,30400,30400,30400,0,0,0,2163,5537,0,0
111800,001060,30450,5,100,-0.33,31.45,20512,6452,-14060,359,220,-139,28186,30400,30450,30400,2,1,1,2164,5532,1,1
111900,001060,30500,5,50,-0.16,32.09,20522,6586,-13936,360,226,-134,28330,30400,30500,30400,122,1,4,2748,5193,10,112
112000,001060,30550,3,0,0.0,32.09,20524,6587,-13937,361,227,-134,28333,30550,30550,30550,0,0,0,3006,4115,0,0
112100,001060,30550,3,0,0.0,32.19,20525,6607,-13918,362,230,-132,28354,30550,30550,30550,18,0,1,3224,4137,0,18
112200,001060,30650,2,100,0.33,32.51,20525,6673,-13852,362,232,-130,28420,30650,30650,30650,2,0,1,3527,4270,0,2
112300,001060,30650,2,100,0.33,32.61,20525,6693,-13832,362,235,-127,28440,30650,30650,30650,19,0,2,3511,3710,0,19
112400,001060,30600,2,50,0.16,32.92,20554,6766,-13788,363,239,-124,28542,30650,30650,30600,101,1,3,3255,3912,29,72
112500,001060,30550,3,0,0.0,32.92,20555,6767,-13788,364,240,-124,28544,30550,30550,30550,1,1,0,3205,4022,1,0
112600,001060,30600,2,50,0.16,32.85,20605,6769,-13836,365,242,-123,28596,30600,30600,30600,2,0,2,3383,4002,0,2
112700,001060,30550,3,0,0.0,32.86,20606,6771,-13835,366,243,-123,28599,30600,30600,30550,3,1,1,3393,4012,1,2
112800,001060,30550,3,0,0.0,32.87,20607,6773,-13834,367,245,-122,28602,30600,30600,30550,2,1,1,3412,4021,1,1
112900,001060,30600,2,50,0.16,32.88,20608,6775,-13833,368,247,-121,28605,30600,30600,30550,3,1,2,3399,4538,1,2
113000,001060,30600,2,50,0.16,32.88,20608,6776,-13832,368,248,-120,28606,30600,30600,30600,1,0,1,3398,4544,0,1
113100,001060,30600,2,50,0.16,32.89,20608,6778,-13830,368,250,-118,28608,30600,30600,30600,2,0,2,3396,4563,0,2
113200,001060,30600,2,50,0.16,32.89,20608,6779,-13829,368,251,-117,28609,30600,30600,30600,1,0,1,3537,5459,0,1
113300,001060,30550,3,0,0.0,32.9,20609,6780,-13829,369,252,-117,28611,30600,30600,30550,2,1,1,3449,5488,1,1
113500,001060,30600,2,50,0.16,33.12,20610,6826,-13784,370,256,-114,28658,30600,30600,30600,0,0,0,3404,5657,0,0
113600,001060,30600,2,50,0.16,33.12,20610,6826,-13784,370,256,-114,28658,30600,30600,30600,0,0,0,3552,5673,0,0
113700,001060,30550,3,0,0.0,32.95,20723,6829,-13894,373,259,-114,28774,30550,30550,30550,101,2,0,3550,5678,101,0
113800,001060,30550,3,0,0.0,32.95,20723,6829,-13894,373,259,-114,28774,30550,30550,30550,0,0,0,3550,5678,0,0
113900,001060,30600,2,50,0.16,32.92,20756,6833,-13923,374,262,-112,28811,30600,30600,30600,2,0,1,3548,5608,0,2
114000,001060,30600,2,50,0.16,32.93,20756,6834,-13922,374,263,-111,28812,30600,30600,30600,1,0,1,3552,5699,0,1
114100,001060,30600,2,50,0.16,32.96,20757,6842,-13915,375,266,-109,28821,30550,30600,30550,2,1,1,3544,5669,1,1
114200,001060,30550,3,0,0.0,32.97,20758,6843,-13915,376,267,-109,28823,30550,30550,30550,1,1,0,3622,5661,1,0
114300,001060,30600,2,50,0.16,32.98,20758,6845,-13913,376,269,-107,28825,30600,30600,30600,1,0,1,3651,5663,0,1
114400,001060,30550,3,0,0.0,33.19,20759,6890,-13869,377,271,-106,28871,30600,30600,30550,45,1,1,3575,5638,1,44
114500,001060,30600,2,50,0.16,33.2,20759,6892,-13867,377,273,-104,28873,30600,30600,30600,1,0,1,3605,5646,0,1
114600,001060,30600,2,50,0.16,33.21,20759,6894,-13865,377,274,-103,28875,30600,30600,30600,2,0,1,3645,5718,0,2
114700,001060,30600,2,50,0.16,33.54,20759,6963,-13796,377,277,-100,28944,30600,30600,30600,1,0,1,3580,5888,0,1
114900,001060,30600,2,50,0.16,33.65,20760,6986,-13774,378,281,-97,28968,30600,30600,30600,0,0,0,3571,5906,0,0
115000,001060,30600,2,50,0.16,33.65,20760,6986,-13774,378,281,-97,28968,30600,30600,30600,0,0,0,3570,5839,0,0
115100,001060,30650,2,100,0.33,34.65,20761,7193,-13568,379,287,-92,29177,30650,30650,30650,0,0,0,3598,5752,0,0
115200,001060,30650,2,100,0.33,34.83,20761,7232,-13529,379,288,-91,29216,30650,30650,30650,0,0,0,3617,5026,0,0
115300,001060,30650,2,100,0.33,34.85,20761,7235,-13526,379,291,-88,29219,30650,30650,30650,1,0,1,3575,5066,0,1
115400,001060,30650,2,100,0.33,35.12,20761,7291,-13470,379,296,-83,29275,30650,30650,30650,1,0,1,3532,5054,0,1
115500,001060,30650,2,100,0.33,35.12,20762,7291,-13471,380,296,-84,29276,30650,30650,30650,1,1,0,3768,4804,1,0
115600,001060,30650,2,100,0.33,35.13,20764,7294,-13470,382,299,-83,29281,30650,30650,30650,1,1,0,3765,4811,1,0
115700,001060,30700,2,150,0.49,35.14,20764,7296,-13468,382,300,-82,29283,30700,30700,30700,2,0,1,3778,4825,0,2
115800,001060,30700,2,150,0.49,35.38,20764,7347,-13417,382,304,-78,29334,30700,30700,30700,50,0,3,3793,4845,0,50
115900,001060,30650,2,100,0.33,35.39,20765,7349,-13416,383,306,-77,29337,30700,30700,30650,3,1,2,3819,4855,1,2
120000,001060,30700,2,150,0.49,35.19,20888,7350,-13538,384,307,-77,29461,30700,30700,30700,1,0,1,3771,4965,0,1
120100,001060,30700,2,150,0.49,35.81,20888,7479,-13409,384,311,-73,29590,30700,30700,30700,2,0,2,3642,4757,0,2
120200,001060,30650,2,100,0.33,35.8,20889,7479,-13410,385,311,-74,29591,30650,30650,30650,1,1,0,3641,4774,1,0
120300,001060,30700,2,150,0.49,35.82,20890,7482,-13408,386,313,-73,29595,30700,30700,30700,1,1,0,3863,4152,1,0
120400,001060,30700,2,150,0.49,35.8,20901,7483,-13418,389,314,-75,29607,30750,30750,30700,2,1,1,3875,4209,1,1
120500,001060,30750,2,200,0.65,35.69,20968,7484,-13484,392,315,-77,29675,30700,30750,30700,67,2,1,3878,5403,66,1
120600,001060,30750,2,200,0.65,35.7,20968,7485,-13483,392,316,-76,29676,30750,30750,30750,1,0,1,3877,4173,0,1
120800,001060,30750,2,200,0.65,35.57,21053,7488,-13565,397,319,-78,29764,30750,30750,30750,1,0,1,3885,4191,0,1
120900,001060,30700,2,150,0.49,35.61,21054,7498,-13556,398,320,-78,29775,30700,30700,30700,1,1,0,3892,4200,1,0
121000,001060,30750,2,200,0.65,35.64,21054,7503,-13551,398,323,-75,29780,30750,30750,30750,2,0,1,3905,4218,0,2
121100,001060,30750,2,200,0.65,35.64,21054,7504,-13550,398,324,-74,29781,30750,30750,30750,1,0,1,3903,4227,0,1
121200,001060,30750,2,200,0.65,35.65,21055,7506,-13549,399,326,-73,29784,30750,30750,30750,0,0,0,3901,4226,0,0
121300,001060,30750,2,200,0.65,35.67,21055,7510,-13545,399,329,-70,29788,30750,30750,30750,1,0,1,4007,4315,0,1
121400,001060,30750,2,200,0.65,35.93,21055,7565,-13490,399,331,-68,29843,30750,30750,30750,0,0,0,4005,4315,0,0
121500,001060,30750,2,200,0.65,35.51,21315,7568,-13747,401,333,-68,30106,30750,30750,30750,0,0,0,3959,4074,0,0
121600,001060,30700,2,150,0.49,35.26,21464,7569,-13895,405,334,-71,30256,30700,30700,30700,148,3,0,4007,4040,148,0
121700,001060,30750,2,200,0.65,35.27,21464,7571,-13893,405,336,-69,30258,30750,30750,30750,1,0,1,4029,4048,0,1
121800,001060,30750,2,200,0.65,35.22,21504,7573,-13931,407,338,-69,30300,30700,30750,30700,20,1,1,4004,4028,19,1
121900,001060,30700,2,150,0.49,35.19,21533,7577,-13956,409,340,-69,30333,30700,30750,30700,33,2,2,3999,4036,29,4
122000,001060,30700,2,150,0.49,35.31,21551,7610,-13941,410,342,-68,30384,30700,30700,30700,51,1,2,3782,5210,18,33
122100,001060,30750,2,200,0.65,35.48,21551,7647,-13904,410,344,-66,30421,30700,30750,30700,37,0,2,3990,4126,0,37
122200,001060,30700,2,150,0.49,35.48,21557,7649,-13908,412,346,-66,30429,30750,30750,30700,7,2,1,3988,4131,6,1
122300,001060,30750,2,200,0.65,35.26,21695,7650,-14045,415,347,-68,30568,30700,30750,30700,138,2,1,3998,5261,137,1
122500,001060,30700,2,150,0.49,35.26,21696,7651,-14045,416,348,-68,30570,30700,30700,30700,0,0,0,3996,4032,0,0
122600,001060,30750,2,200,0.65,35.27,21696,7653,-14043,416,350,-66,30572,30750,30750,30750,0,0,0,4015,4040,0,0
122700,001060,30750,2,200,0.65,35.24,21725,7656,-14069,417,352,-65,30604,30750,30750,30750,0,0,0,4014,4032,0,0
122800,001060,30700,2,150,0.49,35.06,21845,7658,-14187,423,354,-69,30726,30700,30700,30700,0,0,0,3871,5262,0,0
122900,001060,30700,2,150,0.49,35.07,21845,7660,-14185,423,356,-67,30728,30700,30700,30700,1,0,1,3890,5297,0,1
123000,001060,30700,2,150,0.49,35.07,21845,7661,-14184,423,357,-66,30729,30700,30700,30700,0,0,0,3890,5357,0,0
123100,001060,30700,2,150,0.49,35.94,21854,7854,-14000,425,363,-62,30931,30700,30700,30700,0,0,0,3973,4095,0,0
123200,001060,30700,2,150,0.49,35.96,21854,7859,-13995,425,366,-59,30936,30700,30700,30700,1,0,1,3950,5419,0,1
123300,001060,30650,2,100,0.33,35.96,21855,7859,-13996,426,366,-60,30937,30650,30650,30650,1,1,0,3969,5430,1,0
123400,001060,30650,2,100,0.33,35.97,21859,7862,-13997,427,369,-58,30944,30700,30700,30650,6,1,2,3997,5436,4,2
123500,001060,30650,2,100,0.33,35.97,21859,7862,-13997,427,369,-58,30944,30650,30650,30650,0,0,0,3997,5436,0,0
123600,001060,30650,2,100,0.33,35.91,21900,7865,-14035,429,372,-57,30988,30700,30700,30650,43,2,2,4115,5322,41,2
123800,001060,30650,2,100,0.33,35.63,22074,7866,-14208,430,373,-57,31163,30650,30650,30650,0,0,0,3943,5431,0,0
123900,001060,30650,2,100,0.33,35.65,22075,7869,-14206,431,375,-56,31167,30650,30650,30650,0,0,0,3941,5478,0,0
124000,001060,30650,2,100,0.33,35.63,22094,7871,-14223,432,377,-55,31188,30650,30650,30650,1,0,1,3918,5471,0,1
124100,001060,30650,2,100,0.33,35.63,22094,7873,-14221,432,379,-53,31190,30650,30650,30650,2,0,2,3917,4825,0,2
124200,001060,30650,2,100,0.33,35.53,22165,7875,-14290,434,380,-54,31263,30600,30650,30600,72,1,1,3978,4764,70,2
124300,001060,30650,2,100,0.33,35.53,22165,7876,-14289,434,381,-53,31264,30650,30650,30650,0,0,0,3989,4773,0,0
124400,001060,30650,2,100,0.33,35.55,22166,7880,-14286,435,384,-51,31269,30650,30650,30650,2,0,2,4025,4992,0,2
124500,001060,30650,2,100,0.33,35.55,22166,7881,-14285,435,385,-50,31270,30650,30650,30650,0,0,0,4024,4992,0,0
124600,001060,30650,2,100,0.33,35.58,22167,7886,-14281,436,389,-47,31276,30650,30650,30650,4,0,3,4501,5120,0,4
124700,001060,30650,2,100,0.33,35.58,22167,7886,-14281,436,389,-47,31276,30650,30650,30650,0,0,0,4499,5120,0,0
124800,001060,30650,2,100,0.33,35.58,22174,7890,-14284,437,393,-44,31287,30650,30650,30600,11,1,4,4545,5141,7,4
124900,001060,30650,2,100,0.33,35.59,22174,7891,-14283,437,394,-43,31288,30650,30650,30650,1,0,1,4544,5160,0,1
125100,001060,30600,2,50,0.16,35.59,22182,7894,-14288,440,396,-44,31299,30600,30600,30600,0,0,0,4541,5063,0,0
125200,001060,30650,2,100,0.33,37.18,22309,8294,-14015,445,398,-47,31826,30650,30650,30650,421,2,1,4412,4593,22,399
125300,001060,30650,2,100,0.33,37.18,22310,8295,-14015,446,399,-47,31828,30650,30650,30650,1,0,1,4705,4955,0,1
125400,001060,30650,2,100,0.33,39.69,22411,8895,-13516,447,401,-46,32529,30650,30650,30650,700,1,1,4423,4691,101,599
125500,001060,30700,2,150,0.49,39.69,22411,8896,-13515,447,402,-45,32530,30700,30700,30700,1,0,1,4431,4602,0,1
125600,001060,30650,2,100,0.33,39.65,22443,8898,-13545,449,403,-46,32564,30650,30650,30650,0,0,0,4494,4631,0,0
125700,001060,30650,2,100,0.33,39.65,22446,8900,-13546,452,405,-47,32569,30650,30650,30650,2,2,0,4492,4671,2,0
125800,001060,30700,2,150,0.49,39.66,22447,8903,-13544,453,408,-45,32573,30700,30700,30700,2,0,2,4537,4690,0,2
125900,001060,30650,2,100,0.33,39.66,22448,8903,-13545,454,408,-46,32574,30650,30650,30650,0,0,0,4539,4690,0,0
130000,001060,30700,2,150,0.49,39.67,22450,8906,-13544,456,411,-45,32579,30650,30700,30650,5,2,3,4557,4716,2,3
130100,001060,30700,2,150,0.49,39.67,22450,8907,-13543,456,412,-44,32580,30700,30700,30700,0,0,0,4566,4725,0,0
130300,001060,30700,2,150,0.49,39.74,22450,8921,-13529,456,417,-39,32594,30700,30700,30700,0,0,0,4568,4744,0,0
130400,001060,30700,2,150,0.49,39.74,22452,8922,-13530,458,418,-40,32597,30700,30700,30700,0,0,0,5074,4955,0,0
130500,001060,30700,2,150,0.49,39.83,22453,8944,-13509,459,422,-37,32620,30700,30700,30700,11,0,2,5054,5454,0,11
130600,001060,30650,2,100,0.33,39.87,22456,8954,-13502,462,424,-38,32633,30650,30650,30650,2,2,0,5050,5299,2,0
130700,001060,30650,2,100,0.33,39.88,22459,8956,-13503,465,426,-39,32638,30700,30700,30650,2,1,1,5071,5233,1,1
130800,001060,30700,2,150,0.49,39.97,22459,8977,-13482,465,429,-36,32659,30700,30700,30700,19,0,2,5066,5392,0,19
130900,001060,30700,2,150,0.49,40.02,22459,8988,-13471,465,432,-33,32670,30700,30700,30700,1,0,1,5047,5392,0,1
131000,001060,30700,2,150,0.49,40.11,22461,9008,-13453,467,435,-32,32692,30700,30700,30700,9,0,1,4838,5320,0,9
131100,001060,30650,2,100,0.33,40.15,22462,9019,-13443,468,438,-30,32704,30700,30700,30650,10,1,1,4888,5523,1,9
131200,001060,30650,2,100,0.33,39.48,22873,9030,-13843,470,441,-29,33126,30650,30650,30600,422,2,3,4684,5495,411,11
131300,001060,30650,2,100,0.33,39.54,23044,9111,-13933,474,444,-30,33378,30600,30650,30600,241,4,1,4809,5134,171,70
131500,001060,30700,2,150,0.49,39.6,23044,9125,-13919,474,448,-26,33392,30700,30700,30700,0,0,0,4835,5417,0,0
131600,001060,30650,2,100,0.33,39.74,23068,9167,-13901,476,451,-25,33458,30650,30650,30650,0,0,0,5041,5699,0,0
131700,001060,30650,2,100,0.33,39.74,23070,9169,-13901,478,453,-25,33462,30650,30650,30650,1,0,1,5039,5728,0,1
131800,001060,30650,2,100,0.33,39.81,23080,9189,-13891,479,456,-23,33492,30650,30650,30650,0,0,0,5008,5718,0,0
131900,001060,30600,2,50,0.16,39.79,23097,9190,-13907,481,457,-24,33510,30650,30650,30600,17,1,1,4997,5726,16,1
132000,001060,30600,2,50,0.16,39.14,23539,9212,-14327,485,461,-24,33974,30600,30600,30600,449,1,1,4375,5695,439,10
132100,001060,30600,2,50,0.16,39.19,23541,9226,-14315,486,465,-21,33990,30600,30600,30550,16,1,4,4346,5693,2,14
132200,001060,30550,3,0,0.0,39.32,23543,9258,-14285,488,469,-19,34024,30600,30600,30550,24,2,2,4313,5734,2,22
132300,001060,30600,2,50,0.16,39.64,23543,9332,-14211,488,474,-14,34098,30600,30600,30600,73,0,4,4271,5164,0,73
132500,001060,30600,2,50,0.16,39.68,23553,9345,-14208,490,478,-12,34121,30600,30600,30600,0,0,0,4472,4749,0,0
132600,001060,30650,2,100,0.33,39.86,23561,9391,-14170,495,480,-15,34175,30650,30650,30650,42,0,1,4498,5212,0,42
132700,001060,30650,2,100,0.33,39.95,23562,9414,-14148,496,485,-11,34199,30650,30650,30650,12,0,2,4436,4605,0,12
132800,001060,30650,2,100,0.33,40.0,23562,9424,-14138,496,487,-9,34209,30650,30650,30650,1,0,1,4429,4605,0,1
132900,001060,30650,2,100,0.33,40.08,23564,9445,-14119,498,491,-7,34232,30650,30650,30600,14,2,3,4433,4613,2,12
133000,001060,30650,2,100,0.33,40.12,23566,9455,-14111,499,493,-6,34244,30650,30650,30650,9,0,1,4473,4751,0,9
133100,001060,30600,2,50,0.16,40.48,23590,9549,-14041,503,502,-1,34362,30650,30700,30600,108,4,8,4432,4725,24,84
133200,001060,30600,2,50,0.16,40.47,23594,9549,-14045,507,502,-5,34366,30600,30600,30600,4,4,0,4498,4744,4,0
133400,001060,30650,2,100,0.33,40.66,23594,9594,-14000,507,508,1,34411,30650,30650,30650,0,0,0,4462,4721,0,0
133500,001060,30650,2,100,0.33,40.71,23594,9604,-13990,507,510,3,34421,30650,30650,30650,1,0,1,4446,4722,0,1
133600,001060,30650,2,100,0.33,40.76,23596,9618,-13978,509,514,5,34437,30650,30650,30650,2,0,1,4488,4729,0,2
133700,001060,30650,2,100,0.33,40.8,23596,9628,-13968,509,516,7,34447,30650,30650,30650,0,0,0,4479,4735,0,0
133800,001060,30550,3,0,0.0,39.99,24116,9643,-14473,511,520,9,34982,30650,30650,30550,522,2,1,4464,4737,520,2
133900,001060,30600,2,50,0.16,39.99,24120,9645,-14475,515,522,7,34988,30550,30600,30550,2,2,0,4685,4367,2,0
134000,001060,30600,2,50,0.16,40.03,24120,9656,-14464,515,524,9,34999,30600,30600,30600,1,0,1,4502,4797,0,1
134100,001060,30600,2,50,0.16,39.98,24178,9667,-14511,518,527,9,35068,30550,30600,30550,9,2,1,4441,4750,8,1
134200,001060,30600,2,50,0.16,40.43,24185,9779,-14406,522,532,10,35187,30600,30600,30600,66,3,3,4622,4247,6,60
134300,001060,30650,2,100,0.33,40.45,24187,9783,-14404,524,535,11,35193,30650,30650,30650,3,0,2,4713,4338,0,3
134400,001060,30650,2,100,0.33,40.46,24187,9786,-14401,524,537,13,35196,30650,30650,30650,2,0,1,4746,4349,0,2
134500,001060,30650,2,100,0.33,40.56,24189,9810,-14379,526,541,15,35222,30600,30650,30600,24,2,3,4805,4469,2,22
134600,001060,30600,2,50,0.16,40.56,24192,9812,-14380,529,543,14,35227,30600,30600,30600,3,3,0,4844,4442,3,0
134700,001060,30650,2,100,0.33,40.57,24192,9814,-14378,529,545,16,35229,30650,30650,30650,2,0,2,4843,4515,0,2
134800,001060,30600,2,50,0.16,40.57,24194,9816,-14378,531,546,15,35233,30650,30650,30600,4,2,1,4888,4526,2,2
134900,001060,30600,2,50,0.16,40.58,24195,9819,-14376,532,548,16,35237,30650,30650,30600,4,1,2,4892,4562,1,3
135000,001060,30650,2,100,0.33,40.59,24195,9821,-14374,532,550,18,35239,30650,30650,30650,2,0,2,4893,4576,0,2
135100,001060,30600,2,50,0.16,40.26,24398,9822,-14576,536,551,15,35443,30600,30650,30600,204,4,1,5113,4401,203,1
135300,001060,30650,2,100,0.33,40.37,24420,9859,-14561,537,554,17,35502,30650,30650,30650,0,0,0,5077,4412,0,0
135400,001060,30650,2,100,0.33,40.37,24441,9868,-14573,539,556,17,35532,30650,30650,30650,0,0,0,5068,4456,0,0
135500,001060,30550,3,0,0.0,40.2,24709,9933,-14776,547,560,13,35865,30550,30550,30550,1,1,0,4862,4635,1,0
135600,001060,30650,2,100,0.33,40.22,24709,9937,-14772,547,563,16,35869,30650,30650,30650,1,0,1,4951,4317,0,1
135700,001060,30650,2,100,0.33,40.22,24709,9937,-14772,547,563,16,35869,30650,30650,30650,0,0,0,4951,4317,0,0
135800,001060,30600,2,50,0.16,40.25,24712,9947,-14765,550,567,17,35882,30600,30600,30600,2,2,0,4943,4492,2,0
135900,001060,30650,2,100,0.33,40.28,24712,9954,-14758,550,569,19,35889,30650,30650,30650,7,0,2,4952,4541,0,7
140000,001060,30600,2,50,0.16,40.29,24713,9958,-14755,551,571,20,35894,30650,30650,30600,3,1,1,4968,4557,1,2
140100,001060,30600,2,50,0.16,40.3,24715,9959,-14756,553,572,19,35897,30600,30650,30600,3,2,1,4877,4631,2,1
140200,001060,30650,2,100,0.33,40.34,24720,9971,-14749,554,575,21,35914,30650,30650,30650,2,0,2,4967,4692,0,2
140300,001060,30650,2,100,0.33,40.34,24720,9972,-14748,554,576,22,35915,30650,30650,30650,1,0,1,4966,4712,0,1
140400,001060,30650,2,100,0.33,40.52,24722,10017,-14705,556,580,24,35962,30650,30650,30600,47,2,4,4943,4748,2,45
140500,001060,30600,2,50,0.16,40.42,24782,10018,-14764,558,581,23,36023,30600,30600,30600,60,2,0,4970,4735,60,0
140700,001060,30600,2,50,0.16,40.43,24783,10020,-14763,559,583,24,36026,30600,30600,30600,0,0,0,4969,4760,0,0
140800,001060,30600,2,50,0.16,40.43,24816,10032,-14784,563,585,22,36071,30600,30600,30600,0,0,0,4969,4762,0,0
140900,001060,30650,2,100,0.33,40.43,24816,10034,-14782,563,587,24,36073,30650,30650,30650,0,0,0,4968,4765,0,0
141000,001060,30650,2,100,0.33,40.49,24816,10047,-14769,563,592,29,36086,30650,30650,30650,2,0,2,4997,5132,0,2
141100,001060,30600,2,50,0.16,40.5,24818,10052,-14766,565,593,28,36093,30600,30600,30600,1,1,0,5003,5147,1,0
141200,001060,30650,2,100,0.33,40.76,24818,10117,-14701,565,604,39,36158,30650,30650,30650,60,0,9,4945,5367,0,60
141300,001060,30600,2,50,0.16,40.78,24819,10122,-14697,566,605,39,36164,30600,30600,30600,1,1,0,5040,5272,1,0
141400,001060,30650,2,100,0.33,40.81,24821,10129,-14692,568,609,41,36173,30650,30650,30600,3,1,2,5158,5289,1,2
141500,001060,30650,2,100,0.33,40.81,24842,10137,-14705,570,612,42,36202,30650,30650,30600,6,1,2,5171,5283,1,5
141600,001060,30650,2,100,0.33,40.83,24842,10142,-14700,570,614,44,36207,30650,30650,30650,5,0,2,5174,5311,0,5
141700,001060,30600,2,50,0.16,40.83,24843,10144,-14699,571,616,45,36210,30600,30600,30600,1,1,0,5342,5194,1,0
141800,001060,30650,2,100,0.33,40.86,24844,10152,-14692,572,618,46,36219,30650,30650,30650,1,0,1,5343,5223,0,1
141900,001060,30650,2,100,0.33,40.9,24847,10162,-14685,573,621,48,36232,30650,30650,30650,9,0,2,5331,5235,0,9
142000,001060,30600,2,50,0.16,40.93,24850,10170,-14680,576,624,48,36243,30600,30650,30600,11,3,3,5385,5264,3,8
142100,001060,30650,2,100,0.33,40.93,24860,10176,-14684,579,626,47,36259,30600,30650,30600,16,3,2,5398,5317,10,6
142300,001060,30650,2,100,0.33,40.97,24860,10184,-14676,579,629,50,36267,30650,30650,30650,0,0,0,5391,5354,0,0
142400,001060,30600,2,50,0.16,40.99,24865,10192,-14673,583,632,49,36280,30650,30650,30600,3,1,1,5406,5402,1,2
142500,001060,30650,2,100,0.33,41.03,24875,10206,-14669,584,635,51,36304,30650,30650,30650,9,0,1,5401,5451,0,9
142600,001060,30600,2,50,0.16,41.08,24879,10221,-14658,586,638,52,36323,30600,30600,30600,1,1,0,5384,5572,1,0
142700,001060,30600,2,50,0.16,41.14,24881,10237,-14644,588,642,54,36341,30600,30600,30600,1,1,0,5470,5710,1,0
142800,001060,30700,2,150,0.49,45.04,24937,11231,-13706,593,654,61,37391,30700,30700,30700,1,1,0,4918,4210,1,0
142900,001060,30750,2,200,0.65,45.11,24937,11250,-13687,593,659,66,37410,30750,30750,30750,1,0,1,4810,4213,0,1
143000,001060,30700,2,150,0.49,44.59,25264,11264,-14000,596,661,65,37751,30700,30700,30700,1,1,0,4817,3909,1,0
143100,001060,30750,2,200,0.65,44.24,25494,11278,-14216,609,665,56,37995,30700,30750,30700,26,3,2,4753,3742,14,12
143200,001060,30700,2,150,0.49,44.15,25543,11278,-14265,614,665,51,38044,30700,30700,30700,46,4,0,4735,4128,46,0
143300,001060,30650,2,100,0.33,44.0,25691,11305,-14386,620,673,53,38219,30700,30700,30600,59,4,5,4234,5515,43,16
143400,001060,30650,2,100,0.33,44.06,25692,11320,-14372,621,679,58,38235,30650,30650,30650,12,0,4,4223,5515,0,12
143500,001060,30650,2,100,0.33,44.13,25703,11344,-14359,623,686,63,38270,30600,30650,30600,20,2,2,4525,5359,11,9
143600,001060,30750,2,200,0.65,44.69,25799,11530,-14269,629,690,61,38552,30700,30750,30650,268,4,3,4692,4096,84,184
143700,001060,30750,2,200,0.65,44.72,25803,11539,-14264,631,692,61,38565,30700,30750,30700,13,2,2,4685,4111,4,9
143800,001060,30700,2,150,0.49,44.53,25942,11551,-14391,641,695,54,38716,30700,30750,30700,141,10,2,4743,3991,139,2
144000,001060,30650,2,100,0.33,44.55,25957,11563,-14394,645,699,54,38743,30650,30650,30650,0,0,0,4338,5509,0,0
144100,001060,30650,2,100,0.33,44.64,25959,11589,-14370,647,707,60,38771,30650,30650,30650,0,0,0,4305,5516,0,0
144200,001060,30650,2,100,0.33,44.7,25959,11604,-14355,647,712,65,38786,30650,30650,30650,0,0,0,4322,5521,0,0
144300,001060,30650,2,100,0.33,44.77,25961,11622,-14339,649,718,69,38806,30650,30650,30650,1,0,1,4340,5523,0,1
144400,001060,30650,2,100,0.33,44.88,25962,11653,-14309,650,729,79,38838,30650,30650,30650,13,0,3,4313,5518,0,13
144500,001060,30650,2,100,0.33,44.99,25962,11680,-14282,650,739,89,38865,30650,30650,30650,6,0,3,4310,5526,0,6
144600,001060,30700,2,150,0.49,45.19,26032,11765,-14267,652,752,100,39020,30700,30700,30700,18,0,4,4497,5233,0,18
144700,001060,30700,2,150,0.49,45.27,26034,11785,-14249,654,758,104,39042,30700,30700,30700,11,0,3,4479,5241,0,11
144800,001060,30700,2,150,0.49,45.35,26035,11807,-14228,655,766,111,39065,30700,30700,30700,10,0,3,4490,5207,0,10
144900,001060,30700,2,150,0.49,45.44,26038,11831,-14207,658,773,115,39092,30700,30700,30650,11,2,4,4476,5398,2,9
145000,001060,30700,2,150,0.49,45.56,26040,11865,-14175,660,790,130,39128,30700,30700,30650,22,1,12,4741,5528,1,21
145100,001060,30700,2,150,0.49,45.67,26040,11892,-14148,660,798,138,39155,30700,30700,30700,6,0,3,4719,5586,0,6
145200,001060,30700,2,150,0.49,45.87,26041,11944,-14097,661,814,153,39208,30700,30700,30650,20,1,7,4688,5596,1,19
145300,001060,30700,2,150,0.49,46.11,26042,12009,-14033,662,826,164,39274,30700,30700,30650,22,1,6,4663,5606,1,21
145400,001060,30700,2,150,0.49,46.32,26042,12063,-13979,662,839,177,39328,30700,30700,30700,31,0,6,5125,5613,0,31
145500,001060,30650,2,100,0.33,47.26,26044,12309,-13735,664,855,191,39576,30700,30700,30650,134,2,11,4906,5619,2,132
145600,001060,30700,2,150,0.49,46.89,26310,12338,-13972,676,870,194,39871,30700,30700,30650,88,11,9,5370,5363,66,22
145700,001060,30700,2,150,0.49,46.71,26522,12388,-14134,679,889,210,40133,30700,30700,30650,243,3,13,5121,5160,212,31
145800,001060,30700,2,150,0.49,46.81,26527,12417,-14110,682,901,219,40167,30700,30700,30650,29,2,9,5112,5166,4,25
145900,001060,30650,2,100,0.33,46.83,26581,12447,-14134,689,916,227,40251,30700,30700,30650,68,4,9,5101,5159,49,19
150000,001060,30700,2,150,0.49,46.94,26584,12479,-14105,690,931,241,40286,30700,30700,30650,28,1,11,5076,5183,3,25
150100,001060,30700,2,150,0.49,47.52,26639,12660,-13979,695,942,247,40522,30700,30700,30650,233,4,10,4908,4965,54,179
150200,001060,30650,2,100,0.33,47.64,26649,12695,-13954,701,954,253,40567,30650,30700,30650,44,5,12,4891,4984,9,35
150400,001060,30650,2,100,0.33,47.59,26716,12714,-14002,706,964,258,40653,30650,30650,30650,0,0,0,4893,5000,0,0
150500,001060,30700,2,150,0.49,47.71,26728,12752,-13976,708,976,268,40703,30700,30700,30700,0,0,0,4866,5014,0,0
150600,001060,30700,2,150,0.49,47.8,26736,12781,-13955,712,988,276,40740,30700,30700,30650,9,2,3,4843,5047,4,5
150700,001060,30700,2,150,0.49,47.86,26751,12803,-13948,717,998,281,40777,30700,30700,30700,3,0,2,4820,5049,0,3
150800,001060,30700,2,150,0.49,47.96,26754,12830,-13924,718,1008,290,40807,30700,30700,30700,0,0,0,4820,5061,0,0
150900,001060,30650,2,100,0.33,48.05,26771,12864,-13907,723,1020,297,40858,30700,30700,30650,10,1,3,4795,5138,3,7
151000,001060,30700,2,150,0.49,48.17,26776,12899,-13877,726,1036,310,40898,30650,30700,30650,9,1,3,4742,5138,3,6
151100,001060,30700,2,150,0.49,48.2,26845,12938,-13907,733,1047,314,41006,30700,30700,30650,46,3,4,4876,5084,31,15
151200,001060,30700,2,150,0.49,48.38,26850,12991,-13859,736,1066,330,41064,30700,30700,30700,6,0,3,4840,5082,0,6
151300,001060,30700,2,150,0.49,48.5,26876,13035,-13841,741,1081,340,41134,30700,30700,30650,30,2,6,4854,5066,13,17
151400,001060,30650,2,100,0.33,48.38,27030,13078,-13952,750,1094,344,41331,30650,30650,30650,81,4,6,4502,5108,60,21
151500,001060,30650,2,100,0.33,48.56,27037,13130,-13907,753,1111,358,41390,30650,30650,30600,26,1,7,4459,5109,5,21
151600,001060,30650,2,100,0.33,48.65,27094,13181,-13913,756,1131,375,41498,30650,30650,30600,85,1,14,4419,5071,50,35
151700,001060,30700,2,150,0.49,49.46,27154,13430,-13724,760,1169,409,41807,30650,30700,30600,300,3,34,4582,4624,59,241
151800,001060,30700,2,150,0.49,49.38,27261,13462,-13799,764,1184,420,41946,30600,30700,30600,20,1,11,4571,4519,1,19
151900,001060,30700,2,150,0.49,49.42,27264,13475,-13789,767,1189,422,41962,30600,30700,30600,12,1,4,4918,4685,1,11
152000,001060,30600,2,50,0.16,49.43,27303,13496,-13807,774,1190,416,42022,30700,30700,30600,39,6,1,5140,4657,18,21
152000,001060,30600,2,50,0.16,49.43,27303,13496,-13807,774,1190,416,42022,30700,30700,30600,39,6,1,5140,4657,18,21
152000,001060,30600,2,50,0.16,49.43,27303,13496,-13807,774,1190,416,42022,30700,30700,30600,39,6,1,5140,4657,18,21
152000,001060,30600,2,50,0.16,49.43,27303,13496,-13807,774,1190,416,42022,30700,30700,30600,39,6,1,5140,4657,18,21
152000,001060,30600,2,50,0.16,49.43,27303,13496,-13807,774,1190,416,42022,30700,30700,30600,39,6,1,5140,4657,18,21
152000,001060,30600,2,50,0.16,49.43,27303,13496,-13807,774,1190,416,42022,30700,30700,30600,39,6,1,5140,4657,18,21
152000,001060,30600,2,50,0.16,49.43,27303,13496,-13807,774,1190,416,42022,30700,30700,30600,39,6,1,5140,4657,18,21
152000,001060,30600,2,50,0.16,49.43,27303,13496,-13807,774,1190,416,42022,30700,30700,30600,39,6,1,5140,4657,18,21
152000,001060,30600,2,50,0.16,49.43,27303,13496,-13807,774,1190,416,42022,30700,30700,30600,39,6,1,5140,4657,18,21
152000,001060,30600,2,50,0.16,49.43,27303,13496,-13807,774,1190,416,42022,30700,30700,30600,39,6,1,5140,4657,18,21
153000,001060,30600,2,50,0.16,49.43,27303,13496,-13807,774,1190,416,44243,30600,30600,30600,2221,0,0,5138,4655,0,0
153000,001060,30600,2,50,0.16,49.43,27303,13496,-13807,774,1190,416,44243,30600,30600,30600,2221,0,0,5138,4655,0,0
