090200,003780,3995,2,215,5.69,1583.58,4544,71958,67414,10,159,149,91490,3995,3995,3995,0,0,0,9324,7108,0,0
090300,003780,3995,2,215,5.69,1583.58,4544,71958,67414,10,159,149,91490,3995,3995,3995,0,0,0,9324,7108,0,0
090400,003780,3850,2,70,1.85,301.33,27447,82705,55258,87,211,124,151239,3855,3880,3850,13935,20,12,3877,14469,8212,5723
090500,003780,3890,2,110,2.91,227.97,42096,95968,53872,124,243,119,179184,3870,3890,3860,9971,13,9,1212,12841,4453,5518
090600,003780,3880,2,100,2.65,195.77,50295,98461,48166,141,274,133,189876,3860,3890,3850,3178,9,26,4371,17030,2751,427
090700,003780,3875,2,95,2.51,190.17,52833,100475,47642,156,283,127,194428,3880,3880,3855,584,1,3,2660,19514,72,512
090800,003780,3870,2,90,2.38,174.73,57908,101180,43272,164,291,127,200258,3870,3870,3870,1246,4,4,2337,19700,1116,130
090900,003780,3900,2,120,3.17,173.64,59377,103100,43723,169,301,132,203647,3885,3900,3885,587,0,6,2850,14636,0,587
091000,003780,3910,2,130,3.44,179.2,59666,106923,47257,183,324,141,207759,3915,3920,3910,725,11,8,2900,6578,210,515
091100,003780,3860,2,80,2.12,156.26,68753,107436,38683,206,329,123,217360,3900,3900,3860,4542,12,2,3869,19130,4340,202
091200,003780,3870,2,90,2.38,154.57,70740,109341,38601,216,336,120,221252,3870,3890,3870,1511,4,3,6559,17811,1491,20
091300,003780,3890,2,110,2.91,153.69,71678,110162,38484,222,345,123,223013,3880,3890,3880,535,2,7,6745,24859,214,321
091400,003780,3875,2,95,2.51,149.98,73647,110453,36806,230,351,121,225273,3885,3885,3875,665,4,2,7201,23968,663,2
091500,003780,3855,2,75,1.98,130.5,84969,110882,25913,248,354,106,237024,3860,3865,3855,1832,6,0,9778,23853,1832,0
091600,003780,3870,2,90,2.38,126.48,90952,115036,24084,262,360,98,247161,3850,3870,3850,5228,6,3,5337,20574,3076,2152
091700,003780,3810,2,30,0.79,95.9,120052,115127,-4925,309,367,58,276352,3835,3840,3800,19176,26,6,8050,6054,19087,89
091800,003780,3825,2,45,1.19,97.02,121361,117744,-3617,319,414,95,280278,3830,3830,3820,864,3,26,9073,11846,594,270
091900,003780,3820,2,40,1.06,97.17,124035,120527,-3508,334,472,138,285735,3815,3820,3810,3178,3,41,8993,13369,430,2748
092000,003780,3825,2,45,1.19,97.28,124139,120764,-3375,337,520,183,286076,3815,3825,3810,208,1,30,8827,15749,2,206
092100,003780,3820,2,40,1.06,96.46,125626,121175,-4451,346,559,213,287974,3820,3820,3815,1295,4,30,9866,15428,900,395
092200,003780,3820,2,40,1.06,95.81,127507,122164,-5343,356,596,240,290844,3820,3820,3810,1937,5,20,9997,15667,1446,491
092300,003780,3780,3,0,0.0,85.54,143221,122514,-20707,392,615,223,306908,3800,3800,3760,5915,27,11,5318,11096,5602,313
092400,003780,3795,2,15,0.4,86.81,143247,124358,-18889,396,641,245,308778,3790,3800,3790,858,3,19,4150,16535,25,833
092500,003780,3815,2,35,0.93,89.63,143717,128807,-14910,409,689,280,313697,3795,3815,3795,4522,11,43,7572,16907,131,4391
092600,003780,3820,2,40,1.06,89.43,144638,129346,-15292,415,706,291,315157,3820,3820,3800,975,5,7,7226,18077,872,103
092700,003780,3790,2,10,0.26,86.94,148799,129371,-19428,423,707,284,319343,3815,3815,3790,4186,8,1,5302,15139,4161,25
092800,003780,3815,2,35,0.93,87.07,149976,130589,-19387,426,715,289,321738,3785,3815,3785,1470,2,8,11536,16676,252,1218
092900,003780,3790,2,10,0.26,87.08,150088,130703,-19385,431,720,289,321964,3810,3810,3790,214,4,4,5278,19389,102,112
093000,003780,3780,3,0,0.0,86.95,153193,133206,-19987,437,724,287,327572,3810,3810,3780,5604,5,3,5634,19586,3103,2501
093100,003780,3800,2,20,0.53,87.35,153221,133833,-19388,443,731,288,328227,3805,3805,3785,652,5,6,5168,19236,26,626
093200,003780,3795,2,15,0.4,86.95,153914,133834,-20080,447,732,285,328921,3790,3795,3785,694,4,1,4605,20248,693,1
093300,003780,3785,2,5,0.13,84.64,158118,133834,-24284,456,732,276,333125,3780,3785,3780,4204,9,0,6417,16301,4204,0
093400,003780,3795,2,15,0.4,84.51,158498,133951,-24547,459,737,278,333622,3780,3795,3780,497,3,5,6104,16734,380,117
093600,003780,3780,3,0,0.0,84.85,159019,134933,-24086,461,740,279,335125,3780,3780,3780,0,0,0,4881,16745,0,0
093700,003780,3795,2,15,0.4,84.86,159919,135714,-24205,467,744,277,336806,3795,3795,3795,0,0,0,6479,20039,0,0
093800,003780,3800,2,20,0.53,84.67,162219,137352,-24867,470,762,292,340744,3800,3800,3800,117,0,1,5639,19154,0,117
093900,003780,3800,2,20,0.53,84.41,162995,137586,-25409,472,763,291,342027,3800,3800,3800,0,0,0,6660,17763,0,0
094000,003780,3795,2,15,0.4,81.8,168465,137803,-30662,478,769,291,347714,3795,3795,3795,216,0,5,5970,15175,0,216
094100,003780,3795,2,15,0.4,81.36,169630,138005,-31625,482,776,294,349081,3795,3795,3795,17,0,2,5752,14443,0,17
094200,003780,3800,2,20,0.53,82.43,169804,139963,-29841,485,783,298,351213,3800,3800,3800,0,0,0,5547,15324,0,0
094300,003780,3815,2,35,0.93,83.14,170267,141554,-28713,486,792,306,353267,3805,3815,3805,661,0,6,10563,18061,0,661
094400,003780,3815,2,35,0.93,83.15,170267,141583,-28684,486,793,307,353296,3815,3815,3815,0,0,0,10659,18701,0,0
094500,003780,3815,2,35,0.93,83.45,170269,142093,-28176,487,798,311,353808,3815,3815,3815,150,0,2,10144,19742,0,150
094600,003780,3820,2,40,1.06,83.63,170331,142444,-27887,490,812,322,354221,3815,3820,3810,124,1,7,9953,21511,2,122
094700,003780,3805,2,25,0.66,82.51,173417,143089,-30328,498,816,318,357952,3800,3805,3800,1500,2,1,5136,21039,1000,500
094800,003780,3810,2,30,0.79,82.76,173519,143596,-29923,499,820,321,358561,3810,3810,3810,102,0,1,5131,24547,0,102
094900,003780,3810,2,30,0.79,83.03,173542,144090,-29452,501,827,326,359078,3815,3820,3810,139,2,4,12027,18744,23,116
095000,003780,3800,2,20,0.53,82.39,174899,144092,-30807,506,829,323,360437,3805,3805,3800,102,2,0,15473,24929,102,0
095100,003780,3790,2,10,0.26,80.67,179178,144549,-34629,517,830,313,365173,3795,3795,3790,917,4,0,8412,21754,917,0
095200,003780,3760,5,20,-0.53,76.07,191505,145682,-45823,535,840,305,378633,3770,3780,3760,4876,8,7,4999,8067,3757,1119
095300,003780,3760,5,20,-0.53,75.93,191918,145721,-46197,542,843,301,379085,3760,3770,3760,287,4,1,5287,8703,285,2
095400,003780,3780,3,0,0.0,76.24,192062,146423,-45639,543,846,303,379931,3770,3780,3770,202,0,2,5657,10706,0,202
095500,003780,3780,3,0,0.0,76.3,192062,146539,-45523,543,850,307,380047,3780,3780,3780,116,0,4,5866,9812,0,116
095600,003780,3780,3,0,0.0,76.67,192334,147455,-44879,545,854,309,381235,3780,3780,3780,272,2,0,7044,11717,272,0
095700,003780,3790,2,10,0.26,76.67,192368,147483,-44885,547,858,311,381297,3790,3790,3790,27,0,3,4685,12424,0,27
095800,003780,3775,5,5,-0.13,75.4,195842,147657,-48185,553,864,311,384945,3780,3780,3765,3591,6,5,5161,10246,3474,117
095900,003780,3755,5,25,-0.66,73.18,202777,148392,-54385,569,870,301,392615,3775,3775,3750,7363,12,5,4563,8307,6629,734
100000,003780,3775,5,5,-0.13,75.13,203428,152828,-50600,576,879,303,397702,3775,3775,3755,4955,3,6,3945,8475,554,4401
100100,003780,3760,5,20,-0.53,75.47,203728,153746,-49982,578,888,310,398920,3790,3790,3760,1018,2,8,5073,10659,300,718
100200,003780,3785,2,5,0.13,75.56,203728,153927,-49801,578,890,312,399101,3785,3785,3785,180,0,1,5251,11143,0,180
100300,003780,3770,5,10,-0.26,75.55,203730,153928,-49802,579,891,312,399104,3770,3770,3770,2,1,0,6870,6914,2,0
100400,003780,3795,2,15,0.4,75.69,203733,154214,-49519,580,898,318,399393,3795,3795,3790,286,0,7,6783,8610,0,286
100500,003780,3775,5,5,-0.13,75.76,203828,154427,-49401,581,900,319,399725,3795,3795,3775,132,1,1,5771,9386,95,13
100600,003780,3795,2,15,0.4,75.76,203828,154428,-49400,581,901,320,399726,3795,3795,3795,0,0,0,6790,9312,0,0
100700,003780,3780,3,0,0.0,75.81,203935,154606,-49329,582,906,324,400011,3795,3795,3780,285,1,5,6631,9626,107,178
100900,003780,3795,2,15,0.4,75.59,204535,154607,-49928,583,907,324,400612,3795,3795,3795,0,0,0,6665,8980,0,0
101000,003780,3805,2,25,0.66,76.81,204535,157105,-47430,583,917,334,403110,3805,3805,3805,88,0,3,9729,11433,0,88
101100,003780,3805,2,25,0.66,76.65,205008,157136,-47872,584,920,336,403614,3805,3805,3805,2,0,1,11352,10143,0,2
101200,003780,3785,2,5,0.13,76.98,206351,158847,-47504,589,923,334,406668,3800,3800,3785,493,3,1,12088,10124,483,10
101300,003780,3805,2,25,0.66,77.0,206451,158962,-47489,590,927,337,406883,3785,3805,3785,215,1,4,11306,10094,100,115
101400,003780,3805,2,25,0.66,77.0,206451,158962,-47489,590,927,337,406883,3805,3805,3805,0,0,0,10880,13091,0,0
101500,003780,3805,2,25,0.66,77.0,206451,158962,-47489,590,927,337,406883,3805,3805,3805,0,0,0,10980,13141,0,0
101600,003780,3805,2,25,0.66,77.3,206451,159577,-46874,590,932,342,407498,3805,3805,3805,115,0,4,10824,13243,0,115
101700,003780,3805,2,25,0.66,77.3,206451,159577,-46874,590,932,342,407498,3805,3805,3805,0,0,0,10841,11869,0,0
101800,003780,3780,3,0,0.0,76.63,208251,159577,-48674,593,932,339,409298,3790,3790,3780,1800,3,0,11824,12072,1800,0
101900,003780,3800,2,20,0.53,76.68,208251,159693,-48558,593,937,344,409414,3800,3800,3800,115,0,4,10314,11605,0,115
102000,003780,3790,2,10,0.26,77.13,208347,160703,-47644,594,940,346,410520,3785,3790,3785,1096,1,2,9451,13051,96,1000
102100,003780,3815,2,35,0.93,77.63,209738,162812,-46926,595,944,349,414020,3810,3815,3810,500,0,2,11278,12119,0,500
102200,003780,3815,2,35,0.93,78.4,210936,165368,-45568,597,950,353,417774,3815,3815,3815,1754,1,5,15084,8390,605,1149
102300,003780,3810,2,30,0.79,78.43,212520,166685,-45835,600,957,357,420675,3810,3810,3810,180,0,3,11510,11874,0,180
102400,003780,3800,2,20,0.53,77.96,213818,166685,-47133,604,957,353,421973,3805,3805,3800,1298,4,0,11514,12184,1298,0
102500,003780,3800,2,20,0.53,78.01,213820,166801,-47019,605,962,357,422091,3805,3805,3800,117,1,4,11002,11371,2,115
102600,003780,3805,2,25,0.66,77.43,215424,166802,-48622,610,963,353,423696,3800,3805,3800,1405,3,1,9347,12518,1404,1
102700,003780,3805,2,25,0.66,77.43,215424,166802,-48622,610,963,353,423696,3805,3805,3805,0,0,0,9347,12518,0,0
102800,003780,3800,2,20,0.53,77.36,215771,166918,-48853,612,968,356,424159,3800,3800,3800,115,0,4,11060,13603,0,115
102900,003780,3800,2,20,0.53,78.56,215771,169505,-46266,612,969,357,426746,3800,3800,3800,2587,0,1,11033,13803,0,2587
103000,003780,3790,2,10,0.26,78.56,215772,169505,-46267,613,969,356,426747,3790,3790,3790,1,1,0,9069,12615,1,0
103100,003780,3800,2,20,0.53,78.73,215772,169881,-45891,613,974,361,427123,3800,3800,3800,376,0,5,7754,14604,0,376
103200,003780,3795,2,15,0.4,78.75,215772,169929,-45843,613,977,364,427171,3800,3800,3795,48,0,3,6983,15001,0,48
103300,003780,3795,2,15,0.4,78.75,215772,169929,-45843,613,977,364,427171,3795,3795,3795,0,0,0,6983,15001,0,0
103500,003780,3785,2,5,0.13,78.76,215903,170044,-45859,614,981,367,427417,3785,3785,3785,0,0,0,7107,15001,0,0
103600,003780,3805,2,25,0.66,78.97,215903,170504,-45399,614,986,372,427877,3805,3805,3805,0,0,0,8530,14507,0,0
103700,003780,3805,2,25,0.66,78.9,216248,170619,-45629,615,990,375,428337,3805,3805,3805,115,0,4,9264,15680,0,115
103800,003780,3810,2,30,0.79,78.97,216319,170820,-45499,616,992,376,428609,3800,3810,3800,72,1,1,9397,9957,71,1
103900,003780,3810,2,30,0.79,78.97,216328,170826,-45502,617,994,377,428624,3810,3810,3810,6,0,2,9479,9195,0,6
104100,003780,3810,2,30,0.79,79.02,216328,170941,-45387,617,998,381,428739,3810,3810,3810,0,0,0,8617,9249,0,0
104200,003780,3810,2,30,0.79,79.08,216434,171153,-45281,619,1001,382,429057,3810,3810,3800,109,2,2,8406,9945,106,3
104400,003780,3810,2,30,0.79,79.59,216434,172268,-44166,619,1006,387,430172,3810,3810,3810,0,0,0,8492,9813,0,0
104500,003780,3805,2,25,0.66,79.56,216534,172268,-44266,620,1006,386,430272,3805,3805,3805,0,0,0,7484,8337,0,0
104600,003780,3810,2,30,0.79,79.61,216534,172384,-44150,620,1011,391,430388,3810,3810,3810,115,0,4,5718,9913,0,115
104700,003780,3810,2,30,0.79,79.75,216534,172684,-43850,620,1012,392,430688,3810,3810,3810,0,0,0,5788,9928,0,0
104900,003780,3805,2,25,0.66,79.7,216674,172684,-43990,622,1012,390,430828,3805,3805,3805,1,1,0,5398,9053,1,0
105000,003780,3810,2,30,0.79,79.58,217431,173042,-44389,623,1017,394,431943,3810,3810,3810,0,0,0,10595,9809,0,0
105100,003780,3815,2,35,0.93,79.59,217431,173043,-44388,623,1018,395,431944,3815,3815,3815,1,0,1,10502,11067,0,1
105200,003780,3820,2,40,1.06,79.62,217779,173406,-44373,624,1025,401,432655,3815,3820,3815,711,1,7,10456,10642,348,363
105300,003780,3820,2,40,1.06,79.82,218095,174090,-44005,625,1026,401,433655,3820,3820,3820,1000,1,1,10034,8048,316,684
105400,003780,3820,2,40,1.06,79.67,218765,174288,-44477,627,1028,401,434523,3820,3820,3820,198,0,2,10719,10498,0,198
105600,003780,3825,2,45,1.19,79.78,218856,174604,-44252,629,1034,405,434930,3825,3825,3825,0,0,0,10020,9633,0,0
105700,003780,3830,2,50,1.32,80.1,218856,175295,-43561,629,1036,407,435621,3830,3830,3830,0,0,0,9925,8691,0,0
105800,003780,3810,2,30,0.79,79.82,219628,175301,-44327,634,1037,403,436399,3820,3820,3810,3,2,0,9758,8585,3,0
105900,003780,3830,2,50,1.32,79.34,221127,175444,-45683,638,1045,407,438041,3830,3830,3830,0,0,0,10204,8477,0,0
110000,003780,3820,2,40,1.06,79.36,221128,175495,-45633,639,1047,408,438093,3820,3820,3820,50,0,1,10624,9386,0,50
110100,003780,3825,2,45,1.19,79.42,221128,175616,-45512,639,1054,415,438214,3825,3825,3825,115,0,4,10194,7947,0,115
110200,003780,3835,2,55,1.46,80.2,221136,177348,-43788,642,1059,417,439954,3830,3835,3830,1589,2,2,14181,7511,7,1582
110300,003780,3840,2,60,1.59,80.85,221682,179229,-42453,647,1072,425,442381,3845,3850,3840,1282,5,7,17648,10066,546,736
110400,003780,3845,2,65,1.72,80.61,223463,180130,-43333,652,1079,427,445063,3840,3845,3840,1345,1,7,20106,15880,444,901
110500,003780,3850,2,70,1.85,81.17,223463,181391,-42072,652,1088,436,446324,3850,3850,3850,403,0,4,20500,10370,0,403
110600,003780,3860,2,80,2.12,83.74,226443,189628,-36815,655,1104,449,457541,3850,3865,3850,10801,3,12,13952,8380,2980,7821
110700,003780,3865,2,85,2.25,83.64,227272,190088,-37184,657,1115,458,458830,3860,3865,3860,1027,2,7,13963,10716,829,198
110800,003780,3870,2,90,2.38,84.08,227272,191088,-36184,657,1119,462,459830,3860,3870,3860,1000,0,4,15145,12416,0,1000
110900,003780,3850,2,70,1.85,83.55,228886,191228,-37658,660,1122,462,461684,3865,3865,3850,1100,1,2,18942,12928,861,139
111000,003780,3855,2,75,1.98,83.59,229144,191543,-37601,663,1129,466,462257,3855,3865,3850,572,2,7,18540,13111,257,315
111100,003780,3860,2,80,2.12,83.88,229144,192195,-36949,663,1136,473,462909,3855,3860,3855,402,0,4,18478,12871,0,402
111200,003780,3865,2,85,2.25,84.65,229423,194210,-35213,665,1143,478,465203,3865,3865,3865,1502,0,5,19341,12359,0,1502
111300,003780,3860,2,80,2.12,84.69,229679,194526,-35153,667,1150,483,465775,3860,3865,3860,372,2,5,18560,12484,256,116
111400,003780,3860,2,80,2.12,84.69,229929,194731,-35198,668,1157,489,466230,3855,3865,3855,255,1,4,17941,13606,250,5
111500,003780,3865,2,85,2.25,84.92,230141,195433,-34708,672,1162,490,467144,3860,3865,3860,914,4,5,18589,12204,212,702
111600,003780,3870,2,90,2.38,85.52,230187,196854,-33333,674,1173,499,468611,3865,3870,3865,1422,1,11,19553,13267,1,1421
111700,003780,3865,2,85,2.25,85.52,230188,196856,-33332,675,1175,500,468614,3865,3865,3865,1,1,0,18700,11775,1,0
111800,003780,3860,2,80,2.12,84.46,233305,197059,-36246,684,1178,494,471934,3865,3865,3860,729,6,3,16451,12516,526,203
111900,003780,3850,2,70,1.85,84.0,235062,197459,-37603,690,1183,493,474091,3855,3855,3850,1883,5,5,16541,12783,1483,400
112000,003780,3845,2,65,1.72,83.93,235260,197459,-37801,694,1183,489,474289,3850,3850,3845,98,2,0,17051,13825,98,0
112100,003780,3850,2,70,1.85,83.93,235270,197459,-37811,695,1183,488,474299,3850,3850,3850,10,1,0,17151,14086,10,0
112200,003780,3850,2,70,1.85,83.98,235271,197575,-37696,696,1188,492,474416,3860,3860,3850,117,1,5,17763,14127,1,116
112300,003780,3855,2,75,1.98,84.13,235271,197939,-37332,696,1193,497,474780,3855,3855,3855,266,0,4,17034,14790,0,266
112400,003780,3865,2,85,2.25,84.84,235271,199609,-35662,696,1204,508,476450,3855,3865,3855,1670,0,11,15564,14338,0,1670
112500,003780,3860,2,80,2.12,85.76,235272,201773,-33499,697,1214,517,478615,3865,3870,3860,2165,1,10,14437,13926,1,2164
112700,003780,3880,2,100,2.65,88.98,235272,209352,-25920,697,1221,524,486194,3880,3880,3880,0,0,0,8065,13791,0,0
112800,003780,3900,2,120,3.17,92.0,235701,216854,-18847,701,1240,539,494125,3900,3900,3900,269,0,2,3998,8248,0,269
112900,003780,3905,2,125,3.31,92.7,235778,218576,-17202,704,1251,547,495924,3905,3905,3905,0,0,0,4230,6833,0,0
113000,003780,3905,2,125,3.31,93.09,235918,219613,-16305,706,1258,552,497105,3905,3905,3905,0,0,0,3701,10203,0,0
113100,003780,3900,2,120,3.17,92.83,236781,219806,-16975,710,1262,552,498161,3890,3900,3890,37,1,3,4526,11382,30,7
113200,003780,3880,2,100,2.65,91.94,239874,220548,-19326,718,1270,552,501996,3880,3880,3880,0,0,0,5483,8856,0,0
113300,003780,3895,2,115,3.04,91.98,240025,220778,-19247,721,1271,550,502377,3895,3895,3895,0,0,0,5215,7144,0,0
113400,003780,3900,2,120,3.17,91.89,240385,220894,-19491,726,1276,550,502853,3895,3900,3895,125,1,4,5309,6163,10,115
113500,003780,3905,2,125,3.31,93.05,241194,224427,-16767,729,1283,554,507195,3905,3905,3905,1512,0,4,4280,8580,0,1512
113600,003780,3910,2,130,3.44,93.24,241194,224896,-16298,729,1291,562,507664,3910,3910,3910,0,0,0,4418,11099,0,0
113700,003780,3905,2,125,3.31,93.29,241194,225011,-16183,729,1295,566,507779,3905,3905,3905,115,0,4,5889,7255,0,115
113800,003780,3950,2,170,4.5,103.63,241803,250569,8766,740,1323,583,533947,3910,3995,3910,24537,10,24,827,9645,604,23932
113900,003780,3930,2,150,3.97,102.27,246381,251972,5591,753,1334,581,539928,3910,3935,3910,776,2,3,2454,10042,257,519
114000,003780,3930,2,150,3.97,102.76,248094,254953,6859,762,1361,599,544622,3940,3940,3915,2058,7,8,2087,9991,1609,449
114100,003780,3930,2,150,3.97,102.82,248108,255107,6999,764,1364,600,544790,3925,3930,3925,62,0,2,1704,12073,0,62
114200,003780,3910,2,130,3.44,102.55,249072,255423,6351,768,1366,598,546070,3915,3925,3910,295,3,1,2623,12111,294,1
114300,003780,3930,2,150,3.97,102.58,249112,255539,6427,769,1372,603,546226,3925,3930,3925,115,0,5,3502,16841,0,115
114400,003780,3930,2,150,3.97,102.98,249112,256545,7433,769,1377,608,547232,3925,3930,3925,1000,0,2,3723,15550,0,1000
114500,003780,3925,2,145,3.84,102.84,249713,256811,7098,779,1380,601,548099,3915,3925,3915,862,8,3,3765,17263,596,266
114600,003780,3940,2,160,4.23,103.32,250412,258728,8316,782,1390,608,550715,3925,3940,3925,2315,2,8,5573,15142,663,1652
114700,003780,3940,2,160,4.23,102.71,252296,259144,6848,788,1395,607,553015,3940,3945,3925,2175,6,4,5899,15334,1884,291
114800,003780,3945,2,165,4.37,102.95,252316,259758,7442,789,1400,611,553649,3940,3945,3940,614,0,5,5737,13564,0,614
114900,003780,3955,2,175,4.63,103.45,252555,261256,8701,791,1410,619,555386,3945,3955,3935,1637,2,9,23149,13332,239,1398
115000,003780,3955,2,175,4.63,103.5,253063,261913,8850,794,1417,623,556551,3945,3955,3945,1165,3,7,25484,11295,508,657
115100,003780,3950,2,170,4.5,103.63,253063,262250,9187,794,1421,627,556888,3945,3950,3940,337,0,4,11158,13563,0,337
115200,003780,3955,2,175,4.63,103.88,253563,263400,9837,795,1431,636,558538,3950,3955,3940,1650,1,10,28536,16028,500,1150
115300,003780,3960,2,180,4.76,103.93,254155,264155,10000,797,1438,641,559885,3955,3960,3955,1347,2,7,27542,14990,592,755
115500,003780,3950,2,170,4.5,103.55,256263,265355,9092,805,1440,635,563193,3950,3950,3950,0,0,0,16300,11844,0,0
115600,003780,3950,2,170,4.5,105.74,257553,272347,14794,808,1451,643,571475,3950,3950,3950,100,1,0,28727,15950,100,0
115700,003780,3950,2,170,4.5,106.27,258393,274600,16207,815,1456,641,574568,3950,3950,3950,258,0,1,15800,16124,0,258
115800,003780,3945,2,165,4.37,106.24,258479,274600,16121,817,1456,639,574654,3945,3945,3945,33,1,0,18014,16343,33,0
115900,003780,3935,2,155,4.1,105.68,259950,274715,14765,821,1461,640,576240,3935,3935,3935,0,0,0,18779,14048,0,0
120000,003780,3950,2,170,4.5,105.34,260977,274915,13938,824,1462,638,577467,3950,3950,3950,0,0,0,17743,13616,0,0
120100,003780,3940,2,160,4.23,105.01,261800,274921,13121,827,1464,637,578296,3940,3940,3940,0,0,0,13210,14593,0,0
120200,003780,3945,2,165,4.37,105.09,261810,275137,13327,828,1471,643,578522,3945,3945,3945,1,0,1,12927,13607,0,1
120300,003780,3935,2,155,4.1,104.89,262311,275137,12826,831,1471,640,579023,3935,3935,3935,0,0,0,12677,13751,0,0
120400,003780,3945,2,165,4.37,104.94,262312,275263,12951,832,1478,646,579150,3945,3945,3945,115,0,4,12624,14981,0,115
120500,003780,3935,2,155,4.1,104.76,262966,275485,12519,834,1480,646,580026,3935,3935,3935,0,0,0,9549,15666,0,0
120600,003780,3940,2,160,4.23,104.63,263292,275488,12196,836,1482,646,580355,3940,3940,3940,2,0,1,9582,15339,0,2
120700,003780,3955,2,175,4.63,105.72,263295,278345,15050,837,1495,658,583215,3945,3955,3945,2565,0,8,34582,14412,0,2565
120800,003780,3950,2,170,4.5,105.61,264670,279521,14851,890,1566,676,585766,3950,3950,3950,6,0,2,13942,15671,0,6
120900,003780,3945,2,165,4.37,105.54,265120,279809,14689,891,1567,676,586504,3945,3945,3945,450,1,0,14059,14720,450,0
121000,003780,3950,2,170,4.5,105.53,265259,279926,14667,893,1574,681,586760,3945,3950,3945,115,0,5,14605,16743,0,115
121100,003780,3950,2,170,4.5,105.53,265259,279938,14679,893,1575,682,586772,3950,3950,3950,0,0,0,14578,14229,0,0
121200,003780,3945,2,165,4.37,105.55,265271,280005,14734,894,1578,684,586851,3940,3945,3940,67,0,3,12534,17648,0,67
121300,003780,3945,2,165,4.37,105.7,265271,280402,15131,894,1585,691,587248,3945,3945,3945,347,0,6,12865,16305,0,347
121400,003780,3950,2,170,4.5,105.7,265301,280422,15121,895,1588,693,587298,3940,3950,3940,31,1,1,15497,16295,30,1
121500,003780,3950,2,170,4.5,105.7,265301,280422,15121,895,1588,693,587298,3950,3950,3950,0,0,0,15452,19102,0,0
121600,003780,3950,2,170,4.5,104.56,268301,280538,12237,897,1593,696,590414,3945,3950,3940,3116,2,5,15527,17304,3000,116
121700,003780,3945,2,165,4.37,104.48,268501,280539,12038,898,1594,696,590615,3945,3945,3945,0,0,0,12441,17304,0,0
121800,003780,3945,2,165,4.37,103.45,271457,280815,9358,903,1600,697,593847,3945,3945,3935,2681,3,3,12921,17397,2644,37
121900,003780,3930,2,150,3.97,102.93,272930,280931,8001,907,1606,699,595436,3940,3940,3930,1589,4,6,14167,16815,1473,116
122000,003780,3930,2,150,3.97,102.07,275319,281018,5699,914,1607,693,597912,3925,3930,3925,1287,1,1,15071,14425,1200,87
122100,003780,3935,2,155,4.1,102.05,275369,281019,5650,915,1608,693,597963,3935,3935,3935,1,0,1,16032,13095,0,1
122200,003780,3935,2,155,4.1,102.14,275369,281257,5888,915,1614,699,598201,3935,3935,3935,238,0,6,15844,13125,0,238
122300,003780,3935,2,155,4.1,102.16,275899,281847,5948,917,1618,701,599321,3930,3935,3930,1120,2,4,15723,13933,530,590
122400,003780,3945,2,165,4.37,103.13,275899,284527,8628,917,1621,704,602001,3940,3945,3940,2679,0,2,14681,12794,0,2679
122500,003780,3945,2,165,4.37,103.39,276025,285383,9358,918,1628,710,602983,3950,3950,3945,240,1,4,16981,12884,126,114
122600,003780,3945,2,165,4.37,103.19,277316,286150,8834,919,1635,716,605041,3945,3945,3945,2049,1,5,14632,16727,1291,758
122700,003780,3935,2,155,4.1,103.18,277333,286163,8830,920,1637,717,605071,3945,3945,3935,30,1,2,15180,16715,17,13
122800,003780,3940,2,160,4.23,104.06,277825,289115,11290,923,1648,725,608515,3940,3950,3940,3054,3,10,15697,15111,492,2562
122900,003780,3945,2,165,4.37,104.04,277932,289162,11230,924,1653,729,608669,3950,3950,3945,117,1,2,16863,13992,107,10
123000,003780,3935,2,155,4.1,103.39,279701,289172,9471,927,1654,727,610448,3940,3940,3935,1779,3,1,14990,14805,1769,10
123100,003780,3920,2,140,3.7,102.63,282854,290286,7432,932,1659,727,614715,3945,3945,3920,4267,5,5,16046,14067,3153,1114
123300,003780,3925,2,145,3.84,102.74,282948,290692,7744,933,1660,727,615215,3925,3925,3925,0,0,0,13086,16799,0,0
123400,003780,3940,2,160,4.23,102.48,283948,290993,7045,934,1662,728,616516,3940,3940,3940,0,0,0,15446,15989,0,0
123500,003780,3940,2,160,4.23,102.52,283948,291112,7164,934,1667,733,616635,3940,3940,3940,0,0,0,15054,16228,0,0
123600,003780,3925,2,145,3.84,102.21,285048,291358,6310,936,1672,736,618156,3930,3930,3925,1082,1,2,16331,14902,1000,82
123700,003780,3930,2,150,3.97,102.27,285054,291516,6462,937,1674,737,618320,3930,3930,3930,0,0,0,17197,14786,0,0
123800,003780,3945,2,165,4.37,103.04,285054,293732,8678,937,1690,753,620536,3945,3945,3945,121,0,1,16907,15190,0,121
123900,003780,3945,2,165,4.37,103.11,285505,294398,8893,940,1691,751,621653,3945,3945,3945,100,1,0,19289,13961,100,0
124000,003780,3950,2,170,4.5,103.2,285830,294990,9160,944,1696,752,622570,3950,3950,3950,114,0,4,19217,12967,0,114
124100,003780,3945,2,165,4.37,103.19,285871,294992,9121,947,1697,750,622613,3945,3945,3945,0,0,0,19188,12965,0,0
124200,003780,3945,2,165,4.37,102.7,287245,294992,7747,952,1697,745,623987,3945,3945,3945,0,0,0,18371,12937,0,0
124300,003780,3950,2,170,4.5,102.77,287245,295205,7960,952,1702,750,624200,3950,3950,3950,113,0,4,18212,12265,0,113
124400,003780,3950,2,170,4.5,102.89,289327,297680,8353,954,1703,749,628757,3950,3950,3950,0,0,0,36039,11748,0,0
124500,003780,3955,2,175,4.63,102.84,289561,297791,8230,956,1705,749,629102,3945,3955,3945,189,1,2,16147,11991,78,111
124600,003780,3960,2,180,4.76,103.65,292402,303089,10687,960,1717,757,637325,3955,3960,3945,164,2,5,32513,13280,50,114
124700,003780,3965,2,185,4.89,104.73,292487,306327,13840,961,1721,760,640648,3945,3965,3945,86,1,1,30558,12987,85,1
124800,003780,3975,2,195,5.16,106.25,292574,310872,18298,966,1733,767,645284,3955,3985,3955,136,4,2,34328,7534,86,50
124900,003780,3985,2,205,5.42,106.96,292574,312929,20355,966,1747,781,647341,3975,3985,3975,1162,0,9,32534,4524,0,1162
125000,003780,3990,2,210,5.56,113.46,294122,333704,39582,974,1760,786,669664,3980,4010,3975,22072,5,10,17117,6829,1452,20620
125100,003780,4000,2,220,5.82,118.93,298028,354445,56417,990,1786,796,694312,4015,4035,3990,11937,8,19,6167,4935,1663,10274
125200,003780,4010,2,230,6.08,118.79,298724,354857,56133,997,1794,797,695420,4000,4015,4000,771,3,7,7313,6832,374,397
125300,003780,3995,2,215,5.69,118.28,306873,362963,56090,1025,1835,810,711676,4035,4050,3995,12232,26,28,13513,4362,8123,4108
125400,003780,3965,2,185,4.89,116.21,312692,363391,50699,1045,1841,796,717923,3995,4000,3960,5784,16,4,13709,4128,5360,424
125500,003780,3955,2,175,4.63,115.3,315550,363821,48271,1058,1850,792,721211,3950,3965,3950,344,5,8,12542,8373,58,286
125600,003780,3965,2,185,4.89,115.3,315622,363922,48300,1060,1852,792,721384,3955,3965,3955,102,1,1,17402,8862,2,100
125700,003780,3950,2,170,4.5,114.78,317295,364185,46890,1072,1854,782,723320,3950,3950,3940,830,9,2,16312,13150,567,263
125800,003780,3980,2,200,5.29,116.93,317437,371193,53756,1074,1871,797,730470,3965,3980,3965,7149,2,16,16378,8583,142,7007
130000,003780,4000,2,220,5.82,117.84,317437,374053,56616,1074,1887,813,733330,4000,4000,4000,0,0,0,11885,4704,0,0
130100,003780,4000,2,220,5.82,117.94,317562,374544,56982,1077,1894,817,733946,4000,4000,4000,0,0,0,14390,9884,0,0
130200,003780,3995,2,215,5.69,117.44,326772,383752,56980,1085,1903,818,752364,3995,3995,3995,0,0,0,8910,11106,0,0
130300,003780,4005,2,225,5.95,118.14,327299,386660,59361,1091,1908,817,755799,4005,4005,4005,10,2,0,8342,6912,10,0
130400,003780,4025,2,245,6.48,119.66,329623,394416,64793,1183,2008,825,765879,4005,4025,4005,5404,28,37,5816,10838,28,5376
130500,003780,4030,2,250,6.61,120.59,336597,405895,69298,1408,2256,848,784432,4050,4050,4030,3388,45,43,23243,9000,2658,730
130600,003780,4045,2,265,7.01,119.22,342711,408564,65853,1631,2459,828,793215,4025,4045,4015,2139,45,53,9622,13842,45,2094
130700,003780,4025,2,245,6.48,118.83,346751,412051,65300,1828,2665,837,800742,4030,4035,4020,3844,60,60,10479,27446,2415,1429
130800,003780,4030,2,250,6.61,113.46,365957,415221,49264,2027,2870,843,823118,4025,4030,4010,20545,76,66,15740,10752,19071,1474
130900,003780,4010,2,230,6.08,113.08,368560,416755,48195,2047,2881,834,827255,4015,4015,4010,2065,7,4,12637,11452,1031,1034
131000,003780,3985,2,205,5.42,108.49,384529,417181,32652,2082,2890,808,843650,3970,3985,3965,2818,9,7,5559,10784,2492,326
131100,003780,3985,2,205,5.42,108.47,385158,417795,32637,2085,2897,812,844893,3975,3985,3975,550,1,5,5655,14854,215,335
131200,003780,3970,2,190,5.03,106.65,391796,417850,26054,2097,2901,804,851586,3980,3980,3970,5580,8,0,6734,11336,5580,0
131300,003780,3970,2,190,5.03,106.4,392819,417971,25152,2100,2907,807,852730,3985,3985,3970,116,1,4,4893,13809,3,113
131400,003780,3970,2,190,5.03,106.32,394905,419865,24960,2109,2911,802,856710,3960,3970,3960,2606,3,4,8221,12806,712,1894
131500,003780,3960,2,180,4.76,106.1,397809,422064,24255,2118,2914,796,861813,3960,3970,3960,4288,5,3,7642,12754,2089,2199
131600,003780,3980,2,200,5.29,106.13,397958,422359,24401,2121,2919,798,862257,3965,3980,3965,372,2,5,7394,13858,77,295
131700,003780,3985,2,205,5.42,106.43,397958,423527,25569,2121,2925,804,863425,3975,3985,3975,1137,0,4,10964,13278,0,1137
131800,003780,3980,2,200,5.29,106.5,397958,423828,25870,2121,2928,807,863726,3980,3980,3980,301,0,3,12150,12391,0,301
131900,003780,3965,2,185,4.89,106.24,399043,423941,24898,2127,2932,805,864924,3965,3980,3965,1188,5,4,11388,15452,1075,113
132000,003780,3970,2,190,5.03,106.5,399771,425752,25981,2131,2938,807,867463,3960,3970,3960,1911,1,6,11141,20902,100,1811
132200,003780,3980,2,200,5.29,106.65,399918,426514,26596,2133,2943,810,868372,3980,3980,3980,0,0,0,9961,20755,0,0
132300,003780,3975,2,195,5.16,105.56,405980,428568,22588,2137,2958,821,876488,3975,3975,3975,0,0,0,8466,13270,0,0
132400,003780,3975,2,195,5.16,105.41,407318,429344,22026,2256,3129,873,878602,3965,3975,3965,135,18,27,10276,14674,18,117
132500,003780,3975,2,195,5.16,105.65,407545,430559,23014,2383,3291,908,880044,3975,3980,3970,933,22,33,11593,17075,121,812
132600,003780,3990,2,210,5.56,106.43,409781,436140,26359,2515,3510,995,887861,3985,3995,3980,5380,27,45,10542,17191,2025,3355
132700,003780,3970,2,190,5.03,103.61,425549,440892,15343,2603,3615,1012,908381,3975,3975,3970,5809,5,0,10959,15145,5809,0
132800,003780,3980,2,200,5.29,101.67,433995,441232,7237,2616,3623,1007,917167,3980,3980,3980,623,1,6,12344,15635,295,328
132900,003780,3970,2,190,5.03,102.03,434637,443442,8805,2621,3629,1008,920019,3970,3970,3970,550,2,0,12753,19306,550,0
133000,003780,3960,2,180,4.76,100.5,441944,444136,2192,2629,3634,1005,928020,3965,3965,3960,5698,2,3,12120,16210,5017,681
133100,003780,3965,2,185,4.89,99.83,446937,446166,-771,2640,3644,1004,935043,3950,3965,3950,1922,1,7,9718,20303,500,1422
133200,003780,3950,2,170,4.5,99.97,448022,447876,-146,2645,3649,1004,938083,3950,3950,3950,300,1,0,8343,19958,300,0
133300,003780,3975,2,195,5.16,100.4,448677,450482,1805,2646,3655,1009,941344,3975,3975,3975,10,0,1,8643,22654,0,10
133400,003780,3960,2,180,4.76,100.66,448687,451635,2948,2652,3664,1012,942507,3970,3980,3960,149,4,5,10566,27006,6,143
133500,003780,3980,2,200,5.29,100.97,449284,453638,4354,2654,3669,1015,945107,3970,3980,3965,2600,2,5,9372,24337,597,2003
133600,003780,3975,2,195,5.16,101.17,450350,455638,5288,2659,3675,1016,948173,3980,3980,3965,1002,1,3,8818,24020,2,1000
133700,003780,3990,2,210,5.56,101.42,451949,458350,6401,2662,3693,1031,952484,3985,3990,3985,800,2,4,11655,21523,688,112
133800,003780,3975,2,195,5.16,100.64,455442,458350,2908,2667,3693,1026,955977,3975,3975,3975,0,0,0,13437,23293,0,0
133900,003780,3970,2,190,5.03,100.48,457780,459991,2211,2671,3694,1023,959956,3975,3975,3970,2038,3,0,9846,25999,2038,0
134000,003780,3975,2,195,5.16,100.5,458159,460471,2312,2676,3700,1024,960815,3975,3975,3975,114,0,5,9849,27124,0,114
134100,003780,3975,2,195,5.16,99.3,463790,460549,-3241,2680,3704,1024,966524,3975,3975,3975,18,0,1,10039,15292,0,18
134200,003780,3970,2,190,5.03,98.24,468890,460639,-8251,2690,3705,1015,971714,3970,3970,3970,4537,9,0,10212,14997,4537,0
134300,003780,3975,2,195,5.16,98.26,468890,460751,-8139,2690,3710,1020,971826,3970,3975,3970,112,0,5,8855,15486,0,112
134400,003780,3970,2,190,5.03,98.19,469224,460752,-8472,2693,3711,1018,972161,3970,3970,3970,335,3,1,10244,12489,334,1
134500,003780,3965,2,185,4.89,97.81,471090,460752,-10338,2699,3711,1012,974027,3970,3970,3965,650,3,0,7876,14275,650,0
134600,003780,3960,2,180,4.76,97.11,475273,461544,-13729,2707,3718,1011,979002,3965,3970,3960,4974,7,7,7794,11491,4182,792
134700,003780,3950,2,170,4.5,96.38,478881,461544,-17337,2714,3718,1004,982610,3955,3955,3950,3608,7,0,7434,12295,3608,0
134800,003780,3945,2,165,4.37,96.38,479502,462166,-17336,2718,3723,1005,983853,3945,3950,3945,973,4,4,6969,14990,621,352
134900,003780,3950,2,170,4.5,96.51,479594,462874,-16720,2720,3730,1010,984653,3950,3955,3950,750,1,7,6282,15328,42,708
135000,003780,3970,2,190,5.03,96.67,479594,463605,-15989,2720,3734,1014,985384,3960,3970,3960,731,0,4,6962,9676,0,731
135100,003780,3970,2,190,5.03,96.67,479594,463615,-15979,2720,3735,1015,985394,3970,3970,3970,10,0,1,6931,8446,0,10
135300,003780,3975,2,195,5.16,96.69,479594,463738,-15856,2720,3741,1021,985517,3975,3975,3975,0,0,0,8619,8342,0,0
135400,003780,3970,2,190,5.03,96.41,481022,463738,-17284,2721,3741,1020,986945,3970,3970,3970,0,0,0,9044,9534,0,0
135500,003780,3960,2,180,4.76,96.22,481965,463738,-18227,2723,3741,1018,987888,3960,3960,3960,0,0,0,8288,8204,0,0
135600,003780,3970,2,190,5.03,96.28,482050,464107,-17943,2724,3747,1023,988342,3970,3970,3970,0,0,0,9480,10177,0,0
135700,003780,3945,2,165,4.37,96.09,483007,464107,-18900,2728,3747,1019,989299,3945,3945,3945,0,0,0,9694,14373,0,0
135800,003780,3940,2,160,4.23,95.7,484959,464108,-20851,2733,3748,1015,991252,3945,3945,3940,1373,3,0,10260,12874,1373,0
135900,003780,3950,2,170,4.5,95.49,486177,464233,-21944,2734,3753,1019,992621,3935,3955,3935,1257,1,1,10637,11534,1218,13
140000,003780,3935,2,155,4.1,95.34,486931,464233,-22698,2740,3753,1013,993378,3935,3935,3935,451,3,0,9457,14521,451,0
140100,003780,3950,2,170,4.5,95.32,487121,464346,-22775,2742,3758,1016,993681,3950,3950,3950,112,0,4,9232,12533,0,112
140200,003780,3930,2,150,3.97,95.23,487621,464346,-23275,2745,3758,1013,994181,3930,3930,3930,0,0,0,9360,12833,0,0
140300,003780,3930,2,150,3.97,95.52,488031,466170,-21861,2749,3761,1012,996415,3930,3930,3930,31,1,0,6747,15437,31,0
140400,003780,3930,2,150,3.97,95.53,489100,467259,-21841,2751,3766,1015,998573,3950,3950,3930,1965,1,5,7919,16190,876,1089
140500,003780,3940,2,160,4.23,95.52,489167,467262,-21905,2752,3768,1016,998643,3940,3940,3940,3,0,2,7825,14557,0,3
140600,003780,3925,2,145,3.84,95.46,489506,467268,-22238,2756,3771,1015,998988,3945,3945,3925,291,3,1,7936,13439,289,2
140700,003780,3945,2,165,4.37,95.05,491790,467432,-24358,2761,3778,1017,1001436,3945,3945,3945,162,0,5,8575,13961,0,162
140800,003780,3940,2,160,4.23,95.04,491832,467434,-24398,2762,3779,1017,1001480,3945,3945,3940,44,1,1,8673,12970,42,2
140900,003780,3945,2,165,4.37,95.04,491832,467435,-24397,2762,3780,1018,1001481,3945,3945,3945,0,0,0,8673,14139,0,0
141000,003780,3940,2,160,4.23,95.06,491834,467548,-24286,2764,3785,1021,1001596,3940,3940,3930,115,2,5,8724,13012,2,113
141100,003780,3940,2,160,4.23,95.06,491834,467548,-24286,2764,3785,1021,1001596,3940,3940,3940,0,0,0,8724,13012,0,0
141200,003780,3930,2,150,3.97,95.01,492090,467552,-24538,2766,3788,1022,1001856,3930,3940,3930,257,2,1,8655,14237,256,1
141300,003780,3920,2,140,3.7,94.99,492452,467765,-24687,2768,3795,1027,1002431,3925,3925,3920,575,2,7,7094,14157,362,213
141400,003780,3915,2,135,3.57,94.93,492778,467775,-25003,2773,3796,1023,1002767,3920,3920,3915,326,5,0,7887,15759,326,0
141500,003780,3925,2,145,3.84,94.54,494851,467826,-27025,2780,3800,1020,1004891,3910,3925,3910,104,3,4,6810,13772,53,51
141600,003780,3935,2,155,4.1,94.57,494851,467969,-26882,2780,3806,1026,1005034,3925,3935,3925,143,0,6,8089,13716,0,143
141700,003780,3915,2,135,3.57,94.3,496250,467969,-28281,2785,3806,1021,1006433,3915,3915,3915,1219,4,0,8138,15271,1219,0
141800,003780,3920,2,140,3.7,94.26,496456,467970,-28486,2787,3807,1020,1006640,3920,3920,3920,206,2,0,7223,14876,206,0
141900,003780,3940,2,160,4.23,94.29,496456,468085,-28371,2787,3815,1028,1006755,3930,3940,3930,115,0,8,9490,14017,0,115
142000,003780,3940,2,160,4.23,94.29,496570,468202,-28368,2788,3817,1029,1006986,3920,3940,3920,231,1,2,9993,14452,114,117
142100,003780,3940,2,160,4.23,94.29,496570,468204,-28366,2788,3818,1030,1006988,3940,3940,3940,2,0,1,10077,14582,0,2
142300,003780,3940,2,160,4.23,94.31,496579,468331,-28248,2789,3825,1036,1007124,3940,3940,3940,12,0,2,9705,13651,0,12
142400,003780,3940,2,160,4.23,94.47,498041,470491,-27550,2793,3830,1037,1010746,3940,3940,3940,0,0,0,10749,14194,0,0
142500,003780,3925,2,145,3.84,94.47,498041,470511,-27530,2793,3831,1038,1010766,3925,3925,3925,0,0,0,9592,13876,0,0
142600,003780,3940,2,160,4.23,94.61,498041,471206,-26835,2793,3841,1048,1011461,3940,3940,3940,0,0,0,8915,15679,0,0
142700,003780,3940,2,160,4.23,94.62,498042,471238,-26804,2794,3844,1050,1011494,3940,3940,3940,0,0,0,8932,14645,0,0
142800,003780,3920,2,140,3.7,94.58,498252,471267,-26985,2798,3848,1050,1011733,3920,3920,3920,14,0,2,8721,14857,0,14
142900,003780,3930,2,150,3.97,94.64,498252,471541,-26711,2798,3856,1058,1012007,3930,3930,3930,0,0,0,9195,15871,0,0
143000,003780,3930,2,150,3.97,94.51,498952,471569,-27383,2801,3860,1059,1012735,3930,3930,3930,17,0,2,10730,15061,0,17
143100,003780,3925,2,145,3.84,94.47,499377,471769,-27608,2804,3862,1058,1013360,3920,3930,3920,625,3,2,11407,14717,425,200
143200,003780,3920,2,140,3.7,94.47,499404,471776,-27628,2807,3866,1059,1013394,3920,3920,3920,4,0,2,10802,15249,0,4
143300,003780,3910,2,130,3.44,94.3,501084,472521,-28563,2812,3878,1066,1015819,3915,3915,3910,1511,2,5,7740,14151,869,642
143400,003780,3915,2,135,3.57,94.34,501294,472912,-28382,2815,3886,1071,1016420,3915,3915,3915,390,0,7,7779,14368,0,390
143500,003780,3920,2,140,3.7,94.02,503118,473043,-30075,2822,3890,1068,1018375,3920,3920,3915,26,2,2,7201,15193,9,17
143600,003780,3930,2,150,3.97,94.24,503314,474306,-29008,2826,3895,1069,1019834,3915,3930,3915,1459,4,5,7795,15251,196,1263
143700,003780,3945,2,165,4.37,94.34,503314,474816,-28498,2826,3905,1079,1020344,3935,3945,3935,177,0,8,6912,13441,0,177
143800,003780,3945,2,165,4.37,94.32,503449,474855,-28594,2827,3910,1083,1020518,3945,3950,3945,169,1,3,8026,12202,135,34
143900,003780,3920,2,140,3.7,93.89,505886,474953,-30933,2831,3912,1081,1023053,3940,3940,3920,2463,4,1,8059,15586,2437,26
144000,003780,3945,2,165,4.37,94.02,505907,475659,-30248,2832,3925,1093,1023793,3920,3945,3915,640,1,11,9093,17157,21,619
144100,003780,3930,2,150,3.97,93.92,506445,475661,-30784,2833,3926,1093,1024333,3945,3945,3930,540,1,1,7857,15074,538,2
144200,003780,3940,2,160,4.23,93.75,507371,475669,-31702,2835,3929,1094,1025267,3925,3940,3925,932,1,2,8124,14903,925,7
144300,003780,3920,2,140,3.7,93.67,507908,475781,-32127,2837,3933,1096,1025916,3940,3940,3920,649,2,4,8029,15154,537,112
144400,003780,3940,2,160,4.23,93.68,507908,475784,-32124,2837,3934,1097,1025919,3940,3940,3940,0,0,0,8029,14825,0,0
144500,003780,3940,2,160,4.23,93.68,507908,475784,-32124,2837,3934,1097,1025919,3940,3940,3940,0,0,0,8764,14829,0,0
144600,003780,3945,2,165,4.37,93.8,507908,476393,-31515,2837,3941,1104,1026528,3940,3945,3940,609,0,7,8736,14829,0,609
144700,003780,3945,2,165,4.37,93.8,507908,476393,-31515,2837,3941,1104,1026528,3945,3945,3945,0,0,0,8736,14829,0,0
144800,003780,3940,2,160,4.23,93.8,507908,476395,-31513,2837,3942,1105,1026530,3940,3940,3940,2,0,1,8312,14780,0,2
144900,003780,3945,2,165,4.37,93.87,507910,476765,-31145,2839,3951,1112,1026902,3945,3945,3940,372,2,9,9213,13764,2,370
145000,003780,3945,2,165,4.37,93.87,507910,476779,-31131,2839,3954,1115,1026916,3945,3945,3945,4,0,2,9217,13644,0,4
145200,003780,3945,2,165,4.37,93.74,508642,476781,-31861,2841,3955,1114,1027650,3945,3945,3945,0,0,0,10403,13716,0,0
145300,003780,3940,2,160,4.23,94.74,508667,481903,-26764,2842,3965,1123,1032797,3940,3940,3940,0,0,0,12432,11914,0,0
145400,003780,3950,2,170,4.5,94.74,508667,481910,-26757,2842,3968,1126,1032804,3950,3950,3950,0,0,0,10198,22579,0,0
145500,003780,3960,2,180,4.76,95.36,508730,485138,-23592,2845,3978,1133,1036095,3960,3960,3960,0,0,0,12744,20068,0,0
145600,003780,3970,2,190,5.03,95.39,508730,485261,-23469,2845,3985,1140,1036218,3970,3970,3970,0,0,0,12615,22656,0,0
145700,003780,3960,2,180,4.76,95.43,508930,485697,-23233,2846,3988,1142,1036854,3960,3960,3960,0,0,0,11729,5059,0,0
145800,003780,3950,2,170,4.5,95.51,508957,486105,-22852,2850,3996,1146,1037289,3950,3960,3950,87,2,4,10751,20322,2,85
145900,003780,3950,2,170,4.5,95.51,508987,486133,-22854,2851,3999,1148,1037347,3950,3950,3950,0,0,0,6219,23059,0,0
150000,003780,3955,2,175,4.63,95.51,509007,486137,-22870,2852,4003,1151,1037371,3955,3955,3955,0,0,0,12983,23762,0,0
150100,003780,3950,2,170,4.5,95.26,510526,486323,-24203,2858,4010,1152,1039076,3950,3960,3950,81,0,4,12665,22419,0,81
150200,003780,3960,2,180,4.76,95.27,510546,486373,-24173,2863,4015,1152,1039146,3955,3960,3955,4,1,1,13635,18680,1,3
150300,003780,3975,2,195,5.16,95.49,510664,487628,-23036,2869,4023,1154,1040519,3955,3975,3955,1105,0,6,11634,21507,0,1105
150400,003780,3960,2,180,4.76,95.48,510796,487709,-23087,2872,4027,1155,1040732,3960,3970,3960,213,3,4,13161,16062,132,81
150500,003780,3955,2,175,4.63,95.39,511267,487714,-23553,2873,4028,1155,1041208,3955,3955,3955,471,1,0,13103,16062,471,0
150600,003780,3965,2,185,4.89,95.43,512263,488858,-23405,2876,4034,1158,1043348,3965,3965,3965,1137,3,1,13409,15460,996,141
150700,003780,3960,2,180,4.76,95.3,513156,489036,-24120,2880,4041,1161,1044419,3960,3960,3960,849,2,2,14526,18792,842,7
150800,003780,3955,2,175,4.63,95.3,513156,489051,-24105,2880,4044,1164,1044434,3955,3955,3955,15,0,3,14818,17790,0,15
150900,003780,3950,2,170,4.5,95.24,513960,489511,-24449,2885,4050,1165,1045698,3945,3950,3940,660,3,3,10519,21081,612,48
151000,003780,3960,2,180,4.76,95.24,514911,490386,-24525,2893,4056,1163,1047526,3965,3965,3960,3,0,1,14267,13660,0,1
151100,003780,3945,2,165,4.37,94.97,516368,490416,-25952,2901,4059,1158,1049013,3955,3955,3945,1435,7,2,14264,21582,1407,28
151200,003780,3950,2,170,4.5,95.08,516399,490971,-25428,2902,4063,1161,1049599,3945,3950,3945,553,0,3,10676,21093,0,553
151300,003780,3960,2,180,4.76,96.19,516796,497098,-19698,2904,4069,1165,1056123,3955,3960,3950,1834,1,4,10379,20759,317,1517
151400,003780,3955,2,175,4.63,96.29,516796,497604,-19192,2904,4072,1168,1056629,3955,3955,3955,503,0,2,11353,16967,0,503
151500,003780,3960,2,180,4.76,96.69,517568,500450,-17118,2913,4076,1163,1060247,3955,3960,3950,3612,7,4,10929,19241,766,2846
151600,003780,3965,2,185,4.89,96.74,517682,500785,-16897,2916,4083,1167,1060696,3960,3970,3960,449,3,7,11148,17356,114,335
151700,003780,3990,2,210,5.56,97.33,518007,504194,-13813,2920,4103,1183,1064430,3970,3990,3970,3410,1,19,11565,8228,4,3406
151800,003780,3985,2,205,5.42,98.43,518517,510400,-8117,2926,4119,1193,1071146,3990,4005,3985,6452,5,14,11070,8310,509,5943
152000,003780,3965,2,185,4.89,97.63,522856,510455,-12401,2951,4127,1176,1075540,3965,3965,3965,0,0,0,5394,15659,0,0
152000,003780,3975,2,195,5.16,97.64,523557,511221,-12336,2966,4134,1168,1077007,3970,3975,3955,1467,15,7,8178,18924,701,766
152000,003780,3975,2,195,5.16,97.64,523557,511221,-12336,2966,4134,1168,1077007,3970,3975,3955,1467,15,7,8178,18924,701,766
152000,003780,3975,2,195,5.16,97.64,523557,511221,-12336,2966,4134,1168,1077007,3970,3975,3955,1467,15,7,8178,18924,701,766
152000,003780,3975,2,195,5.16,97.64,523557,511221,-12336,2966,4134,1168,1077007,3970,3975,3955,1467,15,7,8178,18924,701,766
152000,003780,3975,2,195,5.16,97.64,523557,511221,-12336,2966,4134,1168,1077007,3970,3975,3955,1467,15,7,8178,18924,701,766
152000,003780,3975,2,195,5.16,97.64,523557,511221,-12336,2966,4134,1168,1077007,3970,3975,3955,1467,15,7,8178,18924,701,766
152000,003780,3975,2,195,5.16,97.64,523557,511221,-12336,2966,4134,1168,1077007,3970,3975,3955,1467,15,7,8178,18924,701,766
152000,003780,3975,2,195,5.16,97.64,523557,511221,-12336,2966,4134,1168,1077007,3970,3975,3955,1467,15,7,8178,18924,701,766
152000,003780,3975,2,195,5.16,97.64,523557,511221,-12336,2966,4134,1168,1077007,3970,3975,3955,1467,15,7,8178,18924,701,766
153000,003780,3975,2,195,5.16,97.64,523557,511221,-12336,2966,4134,1168,1077007,3975,3975,3975,0,0,0,8173,18924,0,0
