090200,012630,12500,2,100,0.81,19.13,2159,413,-1746,12,4,-8,6114,12550,12550,12500,827,1,1,31674,16671,826,1
090200,012630,12500,2,100,0.81,34.59,2174,752,-1422,14,5,-9,6468,12550,12550,12500,1181,3,2,29756,18217,841,340
090300,012630,12450,2,50,0.4,45.65,2239,1022,-1217,15,10,-5,6803,12500,12500,12450,91,1,1,29647,18462,65,26
090300,012630,12500,2,100,0.81,99.29,2240,2224,-16,16,20,4,8006,12500,12500,12450,1294,2,11,29304,18630,66,1228
090400,012630,12500,2,100,0.81,110.26,2241,2471,230,17,23,6,8254,12450,12500,12450,150,1,2,30034,18961,1,149
090400,012630,12500,2,100,0.81,143.42,2241,3214,973,17,28,11,8997,12450,12500,12450,893,1,7,30952,18800,1,892
090500,012630,12550,2,150,1.21,137.92,2397,3306,909,19,30,11,9245,12550,12550,12550,81,0,1,35332,18710,0,81
090500,012630,12500,2,100,0.81,143.18,2397,3432,1035,19,35,16,9371,12550,12550,12500,207,0,6,32337,19476,0,207
090600,012630,12500,2,100,0.81,157.07,2397,3765,1368,19,42,23,9704,12500,12500,12500,109,0,4,31644,20435,0,109
090600,012630,12550,2,150,1.21,171.8,2397,4118,1721,19,44,25,10057,12500,12550,12500,462,0,6,34268,19689,0,462
090700,012630,12500,2,100,0.81,184.79,2499,4618,2119,20,45,25,10659,12550,12550,12500,602,1,1,33951,19984,102,500
090700,012630,12500,2,100,0.81,184.05,2520,4638,2118,22,46,24,10700,12550,12550,12500,643,3,2,34451,19856,123,520
090800,012630,12550,2,150,1.21,189.56,2520,4777,2257,22,50,28,10839,12550,12550,12550,139,0,4,35762,20367,0,139
090800,012630,12550,2,150,1.21,196.83,2520,4960,2440,22,55,33,11022,12550,12550,12550,322,0,9,36361,20512,0,322
090900,012630,12550,2,150,1.21,201.47,2524,5085,2561,23,59,36,11151,12550,12550,12500,129,1,4,37852,20623,4,125
091000,012630,12550,2,150,1.21,203.12,2600,5281,2681,25,63,38,11423,12550,12550,12550,0,0,0,40330,20425,0,0
091000,012630,12550,2,150,1.21,227.59,2635,5997,3362,26,70,44,12174,12550,12550,12500,751,1,7,39653,20407,35,716
091100,012630,12550,2,150,1.21,227.8,2644,6023,3379,27,73,46,12209,12550,12550,12550,0,0,0,45049,20382,0,0
091100,012630,12450,2,50,0.4,91.46,6807,6226,-581,38,78,40,16575,12500,12550,12450,4366,11,5,41700,18094,4163,203
091200,012630,12450,2,50,0.4,92.42,6845,6326,-519,42,79,37,16713,12450,12450,12450,19,2,0,41981,18723,19,0
091200,012630,12450,2,50,0.4,91.99,6877,6326,-551,47,79,32,16745,12450,12450,12450,51,7,0,42069,18935,51,0
091300,012630,12500,2,100,0.81,93.24,7322,6827,-495,53,81,28,17691,12500,12500,12450,536,1,2,43512,18002,35,501
091300,012630,12450,2,50,0.4,90.69,7533,6832,-701,55,82,27,17907,12500,12500,12450,752,3,3,43565,18394,246,506
091400,012630,12450,2,50,0.4,88.35,7808,6898,-910,57,83,26,18248,12500,12500,12450,341,2,1,43465,18262,275,66
091400,012630,12500,2,100,0.81,95.21,7812,7438,-374,58,85,27,18792,12500,12500,12450,885,3,3,44853,18258,279,606
091500,012630,12500,2,100,0.81,96.24,7826,7532,-294,59,89,30,18900,12500,12500,12500,93,0,3,46720,18392,0,93
091500,012630,12500,2,100,0.81,97.51,7826,7631,-195,59,90,31,18999,12500,12500,12500,192,0,4,47384,18418,0,192
091600,012630,12500,2,100,0.81,104.86,7826,8206,380,59,92,33,19574,12500,12500,12500,575,0,2,46991,18444,0,575
091600,012630,12500,2,100,0.81,104.22,7894,8227,333,60,94,34,19663,12500,12500,12450,664,1,4,48705,18326,68,596
091700,012630,12500,2,100,0.81,104.6,7894,8257,363,60,97,37,19693,12500,12500,12500,15,0,1,49825,18375,0,15
091700,012630,12450,2,50,0.4,77.06,10841,8354,-2487,66,102,36,22737,12500,12500,12400,3059,6,6,47260,16766,2947,112
091800,012630,12450,2,50,0.4,77.06,10841,8354,-2487,66,102,36,22737,12450,12450,12450,0,0,0,47260,16766,0,0
091800,012630,12450,2,50,0.4,76.38,10939,8355,-2584,70,103,33,22836,12400,12450,12400,99,4,1,48034,16681,98,1
091900,012630,12450,2,50,0.4,81.89,10939,8958,-1981,70,106,36,23439,12450,12450,12450,603,0,3,47566,16707,0,603
091900,012630,12400,3,0,0.0,72.17,12552,9059,-3493,75,108,33,25153,12450,12450,12400,2317,5,5,42582,17310,1613,704
092000,012630,12400,3,0,0.0,66.14,13977,9244,-4733,76,112,36,26763,12400,12400,12350,1610,1,4,43681,18476,1425,185
092000,012630,12350,5,50,-0.4,70.87,14016,9933,-4083,77,118,41,27491,12400,12400,12350,2338,2,10,38282,17615,1464,874
092100,012630,12350,5,50,-0.4,77.66,14081,10935,-3146,78,122,44,28558,12350,12350,12350,1067,1,4,42048,18174,65,1002
092200,012630,12450,2,50,0.4,86.87,14306,12428,-1878,85,132,47,30277,12450,12450,12450,1,0,1,47800,19795,0,1
092200,012630,12450,2,50,0.4,86.87,14306,12428,-1878,85,132,47,30277,12450,12450,12450,1,0,1,47800,19795,0,1
092300,012630,12450,2,50,0.4,87.0,14306,12446,-1860,85,133,48,30295,12450,12450,12450,0,0,0,48055,20308,0,0
092300,012630,12400,3,0,0.0,87.99,14352,12628,-1724,87,136,49,30523,12400,12400,12400,228,2,3,46051,21251,46,182
092400,012630,12400,3,0,0.0,88.62,14389,12751,-1638,88,139,51,30683,12400,12400,12400,0,0,0,47672,21769,0,0
092400,012630,12400,3,0,0.0,89.41,14389,12865,-1524,88,140,52,30797,12400,12400,12400,114,0,1,47679,22185,0,114
092500,012630,12400,3,0,0.0,106.84,14426,15413,987,89,143,54,33382,12400,12400,12400,1956,0,1,46989,21173,0,1956
092500,012630,12350,5,50,-0.4,106.91,14476,15476,1000,90,144,54,33495,12400,12400,12350,2069,1,2,45104,22341,50,2019
092600,012630,12350,5,50,-0.4,108.35,14600,15819,1219,94,148,54,33962,12350,12350,12350,1,1,0,44482,22256,1,0
092600,012630,12350,5,50,-0.4,107.74,14683,15819,1136,96,148,52,34045,12350,12350,12350,84,3,0,44694,22538,84,0
092700,012630,12350,5,50,-0.4,100.14,15817,15839,22,98,150,52,35225,12350,12350,12350,37,0,1,44710,23611,0,11
092700,012630,12350,5,50,-0.4,103.35,15864,16396,532,99,153,54,35829,12350,12350,12350,641,1,4,42710,23204,47,568
092800,012630,12400,3,0,0.0,106.33,15939,16948,1009,102,159,57,36456,12400,12400,12400,75,3,0,48302,22852,75,0
092800,012630,12550,2,150,1.21,150.88,15939,24049,8110,102,163,61,43557,12400,12550,12400,7176,3,4,48038,25066,75,7101
092900,012630,12550,2,150,1.21,150.88,15939,24049,8110,102,163,61,43557,12550,12550,12550,0,0,0,48038,25066,0,0
092900,012630,12450,2,50,0.4,150.15,16027,24064,8037,104,167,63,43660,12400,12450,12400,103,2,4,43598,24760,88,15
093000,012630,12450,2,50,0.4,151.98,16031,24364,8333,105,175,70,43964,12450,12450,12450,4,1,0,46077,24420,4,0
093000,012630,12450,2,50,0.4,152.04,16068,24429,8361,106,179,73,44066,12450,12450,12400,106,2,4,43104,28737,41,65
093100,012630,12500,2,100,0.81,150.36,16403,24663,8260,109,184,75,44635,12450,12500,12450,337,3,2,46328,28723,335,2
093100,012630,12500,2,100,0.81,146.17,16874,24664,7790,112,185,73,45107,12450,12500,12450,809,6,3,46493,27384,806,3
093200,012630,12450,2,50,0.4,143.49,17238,24734,7496,113,188,75,45541,12450,12450,12450,1,0,1,47385,29156,0,1
093200,012630,12450,2,50,0.4,143.97,17275,24871,7596,114,190,76,45715,12450,12450,12400,175,1,3,47327,29214,37,138
093300,012630,12400,3,0,0.0,143.75,17302,24871,7569,115,190,75,45742,12400,12400,12400,27,1,0,47461,29292,27,0
093300,012630,12450,2,50,0.4,146.07,17357,25354,7997,117,192,75,46280,12400,12450,12400,565,3,2,50107,27901,82,483
093400,012630,12400,3,0,0.0,146.02,17363,25354,7991,118,192,74,46291,12400,12400,12400,6,1,0,50179,29363,6,0
093400,012630,12400,3,0,0.0,144.94,17506,25373,7867,122,193,71,46453,12400,12450,12400,168,5,1,47093,30124,149,19
093500,012630,12450,2,50,0.4,143.99,17739,25543,7804,128,194,66,46856,12450,12450,12450,232,4,1,50144,29619,62,170
093500,012630,12450,2,50,0.4,143.02,17861,25544,7683,130,195,65,46979,12450,12450,12400,355,6,2,47613,30968,184,171
093600,012630,12450,2,50,0.4,143.04,17861,25549,7688,130,196,66,46984,12450,12450,12450,5,0,1,47663,31056,0,5
093600,012630,12450,2,50,0.4,145.55,17898,26050,8152,131,198,67,47522,12450,12450,12400,543,1,3,48971,31059,37,506
093700,012630,12450,2,50,0.4,144.91,17982,26058,8076,132,199,67,47614,12450,12450,12450,0,0,0,48583,31126,0,0
093700,012630,12450,2,50,0.4,144.6,18096,26166,8070,134,200,66,47836,12400,12450,12400,222,2,1,48674,31404,114,108
093800,012630,12450,2,50,0.4,144.73,18096,26190,8094,134,204,70,47860,12450,12450,12450,22,0,3,48470,31552,0,22
093800,012630,12400,3,0,0.0,144.46,18133,26195,8062,135,205,70,47902,12450,12450,12400,64,1,4,48653,31603,37,27
093900,012630,12400,3,0,0.0,144.46,18133,26195,8062,135,205,70,47902,12400,12400,12400,0,0,0,48653,31603,0,0
093900,012630,12450,2,50,0.4,147.18,18138,26695,8557,137,206,69,48407,12400,12450,12400,505,2,1,49545,31454,5,500
094000,012630,12400,3,0,0.0,146.75,18195,26701,8506,140,208,68,48470,12400,12450,12400,26,2,2,49727,31622,20,6
094000,012630,12400,3,0,0.0,144.56,18470,26701,8231,144,208,64,48745,12400,12450,12400,301,6,2,49830,32584,295,6
094100,012630,12450,2,50,0.4,156.04,19093,29792,10699,149,212,63,52459,12400,12500,12400,3714,5,4,49717,30842,623,3091
094100,012630,12450,2,50,0.4,156.04,19093,29792,10699,149,212,63,52459,12400,12500,12400,3714,5,4,49717,30842,623,3091
094200,012630,12450,2,50,0.4,163.55,19448,31807,12359,151,216,65,54829,12450,12500,12450,2370,2,4,50090,32577,355,2015
094300,012630,12500,2,100,0.81,165.77,19594,32481,12887,154,220,66,55649,12500,12500,12500,0,0,0,47422,34776,0,0
094300,012630,12500,2,100,0.81,174.05,19631,34168,14537,155,228,73,57373,12500,12500,12450,1724,1,8,46395,35900,37,1687
094400,012630,12550,2,150,1.21,176.51,19631,34650,15019,155,233,78,57855,12550,12550,12550,1,0,1,50619,34300,0,1
094400,012630,12550,2,150,1.21,175.98,19768,34787,15019,157,235,78,58129,12550,12550,12500,275,2,3,50498,33091,137,138
094500,012630,12550,2,150,1.21,175.99,19768,34790,15022,157,236,79,58132,12550,12550,12550,0,0,0,50505,33304,0,0
094500,012630,12500,2,100,0.81,160.46,21718,34848,13130,162,237,75,60140,12500,12500,12450,2008,5,1,49132,36230,1950,58
094600,012630,12500,2,100,0.81,162.76,21718,35349,13631,162,239,77,60641,12500,12500,12500,0,0,0,49189,36421,0,0
094600,012630,12450,2,50,0.4,161.67,21868,35354,13486,165,240,75,60796,12450,12500,12450,155,3,1,48623,36437,150,5
094700,012630,12500,2,100,0.81,161.71,21868,35363,13495,165,242,77,60805,12500,12500,12500,0,0,0,49041,36403,0,0
094700,012630,12450,2,50,0.4,161.57,21905,35393,13488,166,243,77,60872,12500,12500,12450,67,1,1,49137,35618,37,30
094800,012630,12500,2,100,0.81,161.86,21905,35456,13551,166,245,79,60935,12500,12500,12500,0,0,0,49092,35309,0,0
094800,012630,12500,2,100,0.81,163.9,21942,35962,14020,167,248,81,61478,12500,12500,12450,543,1,3,49408,35465,37,506
094900,012630,12500,2,100,0.81,163.9,21942,35962,14020,167,248,81,61478,12500,12500,12500,0,0,0,49408,35465,0,0
094900,012630,12500,2,100,0.81,163.63,21979,35964,13985,168,250,82,61517,12500,12500,12450,39,1,2,52631,35272,37,2
095000,012630,12500,2,100,0.81,163.65,21979,35969,13990,168,251,83,61522,12500,12500,12500,0,0,0,52553,35772,0,0
095000,012630,12450,2,50,0.4,163.4,22016,35974,13958,169,252,83,61564,12500,12500,12450,42,1,1,52699,36609,37,5
095100,012630,12400,3,0,0.0,134.64,26720,35976,9256,179,253,74,66270,12400,12450,12400,160,4,1,60947,33258,158,2
095100,012630,12400,3,0,0.0,132.21,27613,36507,8894,183,256,73,67694,12400,12450,12400,1584,8,4,60451,32689,1051,533
095200,012630,12400,3,0,0.0,132.15,27625,36507,8882,186,256,70,67706,12400,12400,12400,12,3,0,60577,32739,12,0
095200,012630,12400,3,0,0.0,132.0,27663,36515,8852,188,260,72,67752,12400,12450,12400,58,5,4,60866,33861,50,8
095300,012630,12400,3,0,0.0,131.99,27664,36515,8851,189,260,71,67753,12400,12400,12400,1,1,0,60667,33980,1,0
095400,012630,12400,3,0,0.0,131.82,27701,36515,8814,190,260,70,67790,12400,12400,12400,0,0,0,60753,34065,0,0
095400,012630,12450,2,50,0.4,133.09,27813,37015,9202,191,261,70,68402,12400,12450,12400,612,1,1,60816,33973,112,500
095500,012630,12350,5,50,-0.4,146.54,28938,42406,13468,194,265,71,74918,12350,12350,12350,0,0,0,59231,34709,0,0
095500,012630,12400,3,0,0.0,144.51,29366,42436,13070,195,267,72,75376,12450,12450,12400,458,1,2,53343,33066,428,30
095600,012630,12400,3,0,0.0,153.49,29366,45075,15709,195,270,75,78052,12400,12400,12400,38,0,1,57089,33597,0,1
095600,012630,12400,3,0,0.0,152.84,29566,45189,15623,196,272,76,78366,12400,12400,12350,352,1,3,51378,33840,200,115
095700,012630,12400,3,0,0.0,154.83,29603,45833,16230,197,275,78,79047,12400,12400,12400,37,1,0,57036,36341,37,0
095700,012630,12450,2,50,0.4,156.52,29603,46334,16731,197,277,80,79548,12400,12450,12400,538,1,2,57048,36345,37,501
095800,012630,12400,3,0,0.0,157.96,29640,46818,17178,198,278,80,80069,12450,12450,12400,521,1,1,56181,38052,37,484
095800,012630,12450,2,50,0.4,156.77,29865,46819,16954,200,279,79,80295,12450,12450,12400,747,3,2,56192,37803,262,485
095900,012630,12400,3,0,0.0,147.55,32178,47480,15302,201,284,83,83269,12400,12400,12400,2969,1,4,49778,37113,2313,656
095900,012630,12400,3,0,0.0,147.55,32179,47480,15301,202,284,82,83270,12400,12400,12400,2970,2,4,56221,36001,2314,656
100000,012630,12400,3,0,0.0,147.04,32291,47480,15189,203,284,81,83382,12400,12400,12400,112,1,0,56241,32957,112,0
100000,012630,12400,3,0,0.0,148.28,32358,47980,15622,205,285,80,83949,12400,12450,12400,679,3,1,54912,32748,179,500
100100,012630,12400,3,0,0.0,147.71,32490,47991,15501,209,288,79,84092,12400,12400,12400,10,1,1,48663,33782,9,1
100100,012630,12400,3,0,0.0,147.55,32527,47992,15465,210,289,79,84130,12400,12400,12350,48,2,2,48908,34003,46,2
100200,012630,12400,3,0,0.0,147.72,32527,48049,15522,210,290,80,84187,12400,12400,12400,57,0,1,49070,34029,0,57
100200,012630,12350,5,50,-0.4,148.87,32564,48478,15914,211,291,80,84653,12400,12400,12350,523,1,2,48745,34245,37,486
100300,012630,12400,3,0,0.0,149.29,32746,48886,16140,216,293,77,85243,12350,12400,12350,590,5,2,54934,36704,182,408
100400,012630,12400,3,0,0.0,149.62,32793,49065,16272,219,296,77,85469,12400,12400,12400,0,0,0,54829,37630,0,0
100400,012630,12400,3,0,0.0,149.25,32876,49066,16190,221,297,76,85553,12450,12450,12400,84,2,1,54917,37199,83,1
100500,012630,12400,3,0,0.0,148.95,32976,49118,16142,224,299,75,85705,12400,12400,12400,0,0,0,55718,37318,0,0
100500,012630,12400,3,0,0.0,148.87,32994,49118,16124,226,299,73,85723,12400,12400,12400,18,2,0,55734,37270,18,0
100600,012630,12400,3,0,0.0,148.19,33146,49118,15972,229,299,70,85875,12400,12400,12400,0,0,0,55859,37373,0,0
100600,012630,12400,3,0,0.0,149.67,33151,49618,16467,230,300,70,86380,12450,12450,12400,505,1,1,55339,37367,5,500
100700,012630,12400,3,0,0.0,149.36,33221,49618,16397,233,300,67,86450,12400,12400,12400,0,0,0,55346,36324,0,0
100700,012630,12450,2,50,0.4,149.67,33221,49721,16500,233,301,68,86553,12450,12450,12450,103,0,1,55346,36288,0,103
100800,012630,12400,3,0,0.0,149.5,33259,49721,16462,235,301,66,86591,12400,12400,12400,1,1,0,55364,36529,1,0
100800,012630,12400,3,0,0.0,148.58,33479,49743,16264,240,304,64,86833,12400,12450,12400,243,6,3,55354,37374,221,22
100900,012630,12400,3,0,0.0,148.42,33516,49743,16227,241,304,63,86870,12400,12400,12400,0,0,0,55412,38046,0,0
100900,012630,12400,3,0,0.0,148.78,33770,50243,16473,246,305,59,87624,12400,12450,12400,754,5,1,54889,37829,254,500
101000,012630,12400,3,0,0.0,147.34,34100,50243,16143,252,305,53,87954,12400,12400,12400,43,2,0,55495,37826,43,0
101000,012630,12400,3,0,0.0,145.46,34540,50243,15703,259,305,46,88394,12400,12400,12400,483,9,0,55735,37590,483,0
101100,012630,12400,3,0,0.0,143.91,34912,50243,15331,263,305,42,88766,12400,12400,12400,38,2,0,55425,37509,38,0
101100,012630,12400,3,0,0.0,143.25,35074,50243,15169,265,305,40,88928,12400,12400,12400,200,4,0,55512,37756,200,0
101200,012630,12350,5,50,-0.4,141.42,35572,50305,14733,268,306,38,89488,12350,12350,12350,42,2,0,50571,38718,42,0
101200,012630,12350,5,50,-0.4,142.42,35673,50805,15132,270,307,37,90089,12350,12400,12350,643,4,1,50002,38794,143,500
101300,012630,12350,5,50,-0.4,142.0,35777,50805,15028,273,307,34,90193,12350,12350,12350,97,2,0,50014,38585,97,0
101300,012630,12350,5,50,-0.4,141.12,36002,50805,14803,276,307,31,90418,12350,12350,12350,322,5,0,50051,38683,322,0
101400,012630,12400,3,0,0.0,141.12,36002,50806,14804,276,308,32,90419,12400,12400,12400,1,0,1,49912,38379,0,1
101400,012630,12400,3,0,0.0,141.25,36039,50906,14867,277,309,32,90556,12400,12400,12350,138,1,2,49861,38504,37,101
101500,012630,12400,3,0,0.0,142.58,36053,51406,15353,279,310,31,91070,12350,12400,12350,514,2,1,49761,39648,14,500
101500,012630,12350,5,50,-0.4,141.95,36214,51406,15192,283,310,27,91231,12350,12400,12350,675,6,1,49261,39508,175,500
101600,012630,12350,5,50,-0.4,141.9,36234,51416,15182,287,311,24,91261,12350,12350,12350,14,3,0,49270,39639,14,0
101600,012630,12350,5,50,-0.4,141.71,36283,51416,15133,290,311,21,91310,12350,12350,12350,63,6,0,49400,39583,63,0
101700,012630,12350,5,50,-0.4,141.89,36301,51507,15206,293,313,20,91419,12350,12400,12350,103,2,2,49328,39533,12,91
101700,012630,12350,5,50,-0.4,141.26,36462,51507,15045,297,313,16,91580,12350,12400,12350,264,6,2,49428,39676,173,91
101800,012630,12400,3,0,0.0,137.57,37804,52007,14203,300,314,14,93422,12350,12400,12350,506,1,1,49549,38438,6,500
101800,012630,12350,5,50,-0.4,137.56,37842,52057,14215,302,315,13,93510,12350,12400,12350,594,3,2,49059,38763,44,550
101900,012630,12350,5,50,-0.4,137.05,37984,52057,14073,304,315,11,93652,12350,12350,12350,142,2,0,49156,38886,142,0
101900,012630,12400,3,0,0.0,136.72,38077,52058,13981,306,316,10,93746,12350,12400,12350,236,4,1,49327,40409,235,1
102000,012630,12400,3,0,0.0,136.72,38077,52058,13981,306,316,10,93746,12400,12400,12400,0,0,0,49327,40409,0,0
102000,012630,12400,3,0,0.0,136.29,38197,52060,13863,308,318,10,93868,12350,12400,12350,122,2,2,49351,46952,120,2
102100,012630,12350,5,50,-0.4,138.64,38203,52966,14763,309,320,11,94780,12400,12400,12350,912,1,2,48955,46794,6,906
102100,012630,12400,3,0,0.0,138.11,38351,52967,14616,311,321,10,94929,12400,12400,12350,1061,3,3,48966,47245,154,907
102200,012630,12400,3,0,0.0,138.11,38351,52967,14616,311,321,10,94929,12400,12400,12400,0,0,0,48966,47245,0,0
102200,012630,12350,5,50,-0.4,136.38,38838,52967,14129,313,321,8,95416,12350,12350,12350,487,2,0,49052,47128,487,0
102300,012630,12350,5,50,-0.4,135.86,38992,52975,13983,319,323,4,95578,12400,12400,12350,162,6,2,49026,46890,154,8
102400,012630,12350,5,50,-0.4,135.73,39030,52976,13946,321,324,3,95617,12350,12350,12350,0,0,0,49037,46914,0,0
102400,012630,12400,3,0,0.0,140.88,39030,54984,15954,321,336,15,97625,12400,12400,12400,2008,0,12,47163,48098,0,2008
102500,012630,12400,3,0,0.0,141.58,39030,55260,16230,321,338,17,97901,12400,12400,12400,0,0,0,47161,48020,0,0
102500,012630,12450,2,50,0.4,141.05,39179,55262,16083,323,340,17,98052,12400,12450,12400,151,2,2,54027,48546,149,2
102600,012630,12450,2,50,0.4,141.05,39179,55262,16083,323,340,17,98052,12450,12450,12450,0,0,0,54027,48546,0,0
102600,012630,12400,3,0,0.0,140.92,39216,55263,16047,324,341,17,98090,12450,12450,12400,38,1,1,54038,48723,37,1
102700,012630,12400,3,0,0.0,140.51,39329,55263,15934,325,341,16,98203,12400,12400,12400,0,0,0,54652,48883,0,0
102700,012630,12400,3,0,0.0,141.57,39389,55763,16374,328,342,14,98763,12450,12450,12400,560,3,1,54174,48626,60,500
102800,012630,12400,3,0,0.0,141.57,39390,55763,16373,329,342,13,98764,12400,12400,12400,0,0,0,54186,48779,0,0
102800,012630,12400,3,0,0.0,141.02,39544,55763,16219,333,342,9,98918,12400,12400,12400,154,4,0,54210,48034,154,0
102900,012630,12400,3,0,0.0,140.61,39657,55763,16106,335,342,7,99031,12400,12400,12400,1,1,0,54324,47921,1,0
102900,012630,12400,3,0,0.0,139.46,40019,55811,15792,338,344,6,99441,12400,12450,12400,411,4,2,54276,47621,363,48
103000,012630,12450,2,50,0.4,140.73,40019,56318,16299,338,346,8,99948,12450,12450,12450,500,0,1,56188,47584,0,500
103000,012630,12450,2,50,0.4,140.6,40056,56319,16263,339,347,8,99986,12450,12450,12400,538,1,2,56150,47574,37,501
103100,012630,12450,2,50,0.4,140.6,40056,56319,16263,339,347,8,99986,12450,12450,12450,0,0,0,56150,47574,0,0
103100,012630,12400,3,0,0.0,140.46,40098,56321,16223,341,349,8,100030,12450,12450,12400,44,2,2,56434,45440,42,2
103200,012630,12400,3,0,0.0,140.41,40111,56321,16210,342,349,7,100043,12400,12400,12400,13,1,0,56059,45615,13,0
103200,012630,12400,3,0,0.0,139.88,40263,56321,16058,346,349,3,100195,12400,12400,12400,165,5,0,56193,45341,165,0
103300,012630,12400,3,0,0.0,141.0,40301,56825,16524,347,353,6,100737,12450,12450,12400,541,1,3,55821,45721,38,503
103300,012630,12400,3,0,0.0,140.85,40344,56825,16481,350,353,3,100780,12450,12450,12400,584,4,3,55754,45975,81,503
103400,012630,12400,3,0,0.0,140.82,40353,56825,16472,351,353,2,100789,12400,12400,12400,9,1,0,55754,45997,9,0
103400,012630,12400,3,0,0.0,140.61,40422,56836,16414,355,356,1,100869,12400,12450,12400,89,5,3,55760,46269,78,11
103500,012630,12400,3,0,0.0,140.07,40586,56850,16264,362,357,-5,101047,12400,12400,12400,80,2,0,55757,46061,80,0
103500,012630,12450,2,50,0.4,140.1,40598,56878,16280,364,359,-5,101087,12400,12450,12400,120,4,2,55369,46054,92,28
103600,012630,12450,2,50,0.4,141.22,40647,57403,16756,367,363,-4,101661,12450,12450,12400,31,1,3,55149,46031,6,25
103600,012630,12450,2,50,0.4,141.21,40660,57418,16758,370,365,-5,101689,12450,12450,12400,59,4,5,55241,46055,19,40
103700,012630,12450,2,50,0.4,141.06,40715,57432,16717,374,366,-8,101758,12400,12450,12400,26,2,1,55283,47018,12,14
103700,012630,12450,2,50,0.4,141.06,40728,57450,16722,377,369,-8,101789,12400,12450,12400,57,5,4,55260,46986,25,32
103800,012630,12400,3,0,0.0,140.95,40783,57485,16702,381,372,-9,101879,12400,12450,12400,26,2,1,55325,46035,12,14
103800,012630,12400,3,0,0.0,140.63,41162,57885,16723,390,373,-17,102658,12400,12450,12400,805,11,2,54813,45421,391,414
103900,012630,12450,2,50,0.4,141.87,41199,58448,17249,391,376,-15,103258,12400,12450,12400,100,1,2,54163,45928,37,63
103900,012630,12450,2,50,0.4,140.23,41680,58449,16769,392,377,-15,103740,12400,12450,12400,582,2,3,54226,45485,518,64
104000,012630,12400,3,0,0.0,139.35,41943,58449,16506,396,377,-19,104003,12400,12400,12400,263,4,0,54239,45618,263,0
104000,012630,12450,2,50,0.4,139.35,41944,58450,16506,397,378,-19,104005,12400,12450,12400,265,5,1,54277,45454,264,1
104100,012630,12450,2,50,0.4,139.37,41983,58513,16530,400,380,-20,104107,12400,12450,12400,101,2,2,54249,45511,38,63
104100,012630,12450,2,50,0.4,140.57,41983,59014,17031,400,382,-18,104608,12400,12450,12400,602,2,4,54400,45633,38,564
104200,012630,12450,2,50,0.4,140.68,42021,59114,17093,402,385,-17,104746,12450,12450,12400,43,2,2,53898,45604,38,5
104200,012630,12450,2,50,0.4,140.69,42021,59118,17097,402,387,-15,104750,12450,12450,12400,47,2,4,53941,45647,38,9
104300,012630,12400,3,0,0.0,140.56,42058,59118,17060,403,387,-16,104787,12400,12400,12400,37,1,0,54202,45845,37,0
104300,012630,12450,2,50,0.4,140.71,42061,59182,17121,405,390,-15,104854,12400,12450,12400,104,3,3,54411,45818,40,64
104400,012630,12400,3,0,0.0,140.58,42099,59182,17083,407,390,-17,104892,12400,12400,12400,38,2,0,54579,45948,38,0
104400,012630,12450,2,50,0.4,144.2,42099,60705,18606,407,402,-5,106415,12400,12450,12400,1561,2,12,54093,45633,38,1523
104500,012630,12450,2,50,0.4,142.93,42479,60715,18236,412,405,-7,106805,12450,12500,12450,390,5,3,56681,43618,380,10
104500,012630,12450,2,50,0.4,142.93,42479,60715,18236,412,405,-7,106805,12450,12500,12450,390,5,3,56681,43618,380,10
104600,012630,12450,2,50,0.4,143.29,42480,60868,18388,413,412,-1,106959,12450,12450,12400,154,1,7,53778,47315,1,153
104700,012630,12500,2,100,0.81,143.09,42552,60889,18337,416,414,-2,107052,12500,12500,12500,0,0,0,56780,45788,0,0
104700,012630,12450,2,50,0.4,143.09,42553,60889,18336,417,414,-3,107053,12450,12450,12450,1,1,0,56936,45986,1,0
104800,012630,12500,2,100,0.81,144.14,42590,61390,18800,418,416,-2,107591,12500,12500,12500,0,0,0,57067,46451,0,0
104800,012630,12500,2,100,0.81,144.14,42592,61391,18799,420,417,-3,107594,12450,12500,12450,3,2,1,56772,47676,2,1
104900,012630,12450,2,50,0.4,144.01,42629,61391,18762,421,417,-4,107631,12450,12450,12450,0,0,0,56860,47829,0,0
104900,012630,12500,2,100,0.81,144.04,42629,61401,18772,421,420,-1,107641,12500,12500,12500,10,0,3,56878,47852,0,10
105000,012630,12500,2,100,0.81,143.55,42781,61412,18631,425,422,-3,107804,12500,12500,12500,1,0,1,56942,47952,0,1
105000,012630,12500,2,100,0.81,143.61,42782,61439,18657,426,423,-3,107832,12500,12500,12450,29,1,2,56953,48011,1,28
105100,012630,12500,2,100,0.81,144.65,42821,61940,19119,428,425,-3,108372,12450,12500,12450,3,1,1,56603,48452,2,1
105100,012630,12500,2,100,0.81,145.27,42821,62206,19385,428,428,0,108638,12450,12500,12450,269,1,4,56443,48563,2,267
105200,012630,12450,2,50,0.4,145.15,42859,62209,19350,430,429,-1,108679,12450,12450,12450,0,0,0,56363,48674,0,0
105200,012630,12500,2,100,0.81,146.45,42861,62772,19911,432,430,-2,109244,12450,12500,12450,565,2,1,56442,48697,2,563
105300,012630,12450,2,50,0.4,146.32,42901,62773,19872,435,431,-4,109285,12450,12450,12450,0,0,0,56453,48716,0,0
105300,012630,12500,2,100,0.81,146.32,42901,62774,19873,435,432,-3,109286,12500,12500,12500,1,0,1,56453,48692,0,1
105400,012630,12450,2,50,0.4,147.45,42939,63313,20374,437,436,-1,109863,12450,12450,12450,38,2,0,56527,49327,38,0
105400,012630,12500,2,100,0.81,147.46,42940,63318,20378,438,438,0,109869,12450,12500,12450,44,3,2,56578,51603,39,5
105500,012630,12500,2,100,0.81,147.44,42977,63366,20389,439,441,2,109954,12500,12500,12450,84,1,2,56572,51166,37,47
105500,012630,12450,2,50,0.4,146.69,43203,63376,20173,443,442,-1,110190,12500,12500,12450,320,5,3,56463,51247,263,57
105600,012630,12450,2,50,0.4,146.57,43241,63377,20136,445,443,-2,110229,12500,12500,12450,38,1,1,56554,51603,37,1
105600,012630,12500,2,100,0.81,147.68,43253,63878,20625,447,445,-2,110742,12500,12500,12450,551,3,3,59562,51546,49,502
105700,012630,12450,2,50,0.4,147.23,43387,63878,20491,453,445,-8,110876,12450,12450,12450,8,2,0,58979,51483,8,0
105700,012630,12450,2,50,0.4,146.28,43669,63879,20210,460,446,-14,111159,12450,12500,12450,291,9,1,58866,51592,290,1
105800,012630,12450,2,50,0.4,146.16,43706,63880,20174,464,447,-17,111197,12450,12450,12450,31,3,0,58866,51983,31,0
105800,012630,12450,2,50,0.4,145.95,43769,63880,20111,471,447,-24,111260,12450,12450,12450,94,10,0,58885,52346,94,0
105900,012630,12450,2,50,0.4,145.91,43781,63880,20099,473,447,-26,111272,12450,12450,12450,6,1,0,58941,52133,6,0
105900,012630,12500,2,100,0.81,146.51,43944,64382,20438,478,450,-28,111937,12450,12500,12450,671,6,3,58856,52022,169,502
110000,012630,12450,2,50,0.4,146.46,43962,64386,20424,481,451,-30,111959,12450,12450,12450,12,2,0,58442,52145,12,0
110000,012630,12450,2,50,0.4,146.29,44012,64386,20374,485,451,-34,112009,12450,12450,12450,62,6,0,58453,52170,62,0
110100,012630,12450,2,50,0.4,145.88,44138,64388,20250,490,453,-37,112137,12450,12450,12450,125,4,0,58473,52118,125,0
110100,012630,12450,2,50,0.4,145.72,44187,64388,20201,493,453,-40,112186,12450,12450,12450,174,7,0,58384,52027,174,0
110200,012630,12450,2,50,0.4,145.59,44227,64388,20161,499,453,-46,112226,12450,12450,12450,33,4,0,58833,51924,33,0
110200,012630,12450,2,50,0.4,146.5,44297,64894,20597,504,457,-47,112802,12450,12500,12450,609,9,4,58333,51882,103,506
110300,012630,12450,2,50,0.4,145.63,44562,64894,20332,509,457,-52,113067,12450,12450,12450,259,4,0,58327,51723,259,0
110300,012630,12450,2,50,0.4,145.44,44620,64894,20274,516,457,-59,113125,12450,12450,12450,317,11,0,58333,51575,317,0
110400,012630,12450,2,50,0.4,144.21,45004,64900,19896,520,460,-60,113515,12500,12500,12450,80,3,3,58321,51461,74,6
110400,012630,12450,2,50,0.4,144.03,45060,64900,19840,525,460,-65,113571,12500,12500,12450,136,8,3,58327,51340,130,6
110500,012630,12500,2,100,0.81,143.64,45185,64902,19717,529,461,-68,113698,12450,12500,12450,127,4,1,58337,51228,125,2
110500,012630,12500,2,100,0.81,144.6,45235,65408,20173,533,465,-68,114254,12450,12500,12450,683,8,5,57819,51174,175,508
110600,012630,12450,2,50,0.4,143.95,45441,65412,19971,539,466,-73,114464,12450,12450,12450,206,6,0,57826,51401,206,0
110600,012630,12450,2,50,0.4,143.79,45490,65412,19922,542,466,-76,114513,12450,12450,12450,255,9,0,57961,51313,255,0
110700,012630,12450,2,50,0.4,142.03,46055,65413,19358,551,467,-84,115079,12450,12500,12450,560,8,1,58058,50837,559,1
110700,012630,12450,2,50,0.4,142.0,46067,65414,19347,553,468,-85,115092,12450,12500,12450,573,10,2,58046,50890,571,2
110800,012630,12450,2,50,0.4,139.54,46879,65414,18535,562,468,-94,115904,12450,12450,12450,775,8,0,58110,50243,775,0
110900,012630,12450,2,50,0.4,140.56,46893,65915,19022,565,470,-95,116419,12450,12450,12450,0,0,0,57779,50256,0,0
110900,012630,12450,2,50,0.4,139.15,47370,65916,18546,573,471,-102,116897,12450,12500,12450,478,8,1,57539,49859,477,1
111000,012630,12450,2,50,0.4,139.11,47385,65916,18531,578,471,-107,116912,12450,12450,12450,0,0,0,57528,49946,0,0
111000,012630,12500,2,100,0.81,138.74,47515,65923,18408,582,474,-108,117049,12450,12500,12450,137,4,3,57550,50107,130,7
111100,012630,12450,2,50,0.4,137.17,48061,65924,17863,587,475,-112,117596,12450,12450,12450,0,0,0,57407,49572,0,0
111100,012630,12500,2,100,0.81,138.1,48099,66424,18325,589,476,-113,118134,12450,12500,12450,538,2,1,57537,49683,38,500
111200,012630,12500,2,100,0.81,138.1,48100,66425,18325,590,477,-113,118136,12500,12500,12500,0,0,0,57120,49731,0,0
111200,012630,12500,2,100,0.81,137.99,48138,66426,18288,593,478,-115,118175,12450,12500,12450,39,3,1,57239,49948,38,1
111300,012630,12450,2,50,0.4,137.34,48365,66426,18061,596,478,-118,118402,12450,12450,12450,0,0,0,57577,49959,0,0
111300,012630,12500,2,100,0.81,137.01,48487,66431,17944,599,480,-119,118529,12450,12500,12450,127,3,2,57351,49639,122,5
111400,012630,12500,2,100,0.81,137.01,48488,66432,17944,600,481,-119,118531,12500,12500,12500,1,0,1,57437,49561,0,1
111400,012630,12500,2,100,0.81,137.73,48599,66936,18337,604,483,-121,119146,12500,12500,12450,616,4,3,57444,49471,111,505
111500,012630,12500,2,100,0.81,136.92,48886,66937,18051,606,484,-122,119434,12500,12500,12500,0,0,0,57103,51305,0,0
111500,012630,12450,2,50,0.4,136.59,49004,66937,17933,608,484,-124,119552,12450,12450,12450,118,2,0,57115,51403,118,0
111600,012630,12500,2,100,0.81,136.59,49006,66939,17933,610,486,-124,119556,12450,12500,12450,2,1,1,57052,50839,1,1
111600,012630,12450,2,50,0.4,136.5,49043,66944,17901,611,488,-123,119598,12450,12500,12450,44,2,3,57295,51027,38,6
111700,012630,12450,2,50,0.4,136.16,49167,66944,17777,614,488,-126,119722,12450,12450,12450,124,3,0,57332,50914,124,0
111700,012630,12450,2,50,0.4,137.98,49205,67894,18689,616,492,-124,120710,12450,12500,12450,1112,5,4,56414,55981,162,950
111800,012630,12450,2,50,0.4,137.18,49492,67895,18403,618,493,-125,120998,12500,12500,12450,288,2,1,56400,66048,287,1
111800,012630,12450,2,50,0.4,136.32,49805,67895,18090,624,493,-131,121311,12500,12500,12450,601,8,1,56389,65544,600,1
111900,012630,12500,2,100,0.81,137.14,49838,68348,18510,625,497,-128,121797,12500,12500,12500,453,0,4,55947,66050,0,453
111900,012630,12500,2,100,0.81,137.75,49838,68652,18814,625,501,-124,122101,12500,12500,12500,757,0,8,55611,66093,0,757
112000,012630,12450,2,50,0.4,137.64,49877,68652,18775,628,501,-127,122140,12450,12450,12450,1,1,0,55610,56093,1,0
112000,012630,12500,2,100,0.81,138.39,49973,69157,19184,631,504,-127,122741,12450,12500,12450,602,4,3,55259,56081,97,505
112100,012630,12500,2,100,0.81,138.37,50010,69198,19188,632,506,-126,122819,12500,12500,12500,1,0,1,55346,56417,0,1
112100,012630,12450,2,50,0.4,137.58,50295,69198,18903,633,506,-127,123104,12500,12500,12450,286,1,1,55447,56417,285,1
112200,012630,12450,2,50,0.4,136.56,50673,69199,18526,640,507,-133,123483,12450,12500,12450,342,6,1,55283,55615,341,1
112200,012630,12500,2,100,0.81,136.57,50673,69203,18530,640,509,-131,123487,12450,12500,12450,346,6,3,55366,55531,341,5
112300,012630,12500,2,100,0.81,137.46,50710,69707,18997,641,511,-130,124028,12450,12500,12450,537,1,1,55373,55603,37,500
112300,012630,12450,2,50,0.4,137.39,50736,69707,18971,642,511,-131,124054,12450,12500,12450,563,2,1,59057,55676,63,500
112400,012630,12500,2,100,0.81,136.97,50894,69709,18815,645,513,-132,124214,12450,12500,12450,159,3,1,59968,53648,158,1
112400,012630,12450,2,50,0.4,136.17,51196,69712,18516,651,514,-137,124519,12450,12500,12450,464,9,2,59964,53245,460,4
112500,012630,12450,2,50,0.4,136.03,51247,69712,18465,656,514,-142,124570,12450,12450,12450,45,4,0,59965,53251,45,0
112500,012630,12450,2,50,0.4,136.01,51260,69717,18457,659,517,-142,124588,12450,12500,12450,63,7,3,59962,53275,58,5
112600,012630,12450,2,50,0.4,135.99,51633,70217,18584,667,518,-149,125461,12450,12500,12450,873,8,1,59372,52998,373,500
112600,012630,12450,2,50,0.4,135.95,51648,70217,18569,672,518,-154,125476,12450,12500,12450,888,13,1,59478,52995,388,500
112700,012630,12500,2,100,0.81,135.58,51793,70223,18430,679,522,-157,125627,12450,12500,12450,150,7,3,59468,52868,145,5
112700,012630,12450,2,50,0.4,134.86,52092,70251,18159,683,525,-158,125954,12450,12500,12450,477,11,6,59441,52866,444,33
112800,012630,12450,2,50,0.4,134.44,52254,70251,17997,688,525,-163,126116,12450,12450,12450,162,5,0,59441,52554,162,0
112800,012630,12500,2,100,0.81,134.34,52296,70253,17957,693,527,-166,126160,12450,12500,12450,206,10,2,59478,52522,204,2
112900,012630,12450,2,50,0.4,135.17,52346,70757,18411,697,529,-168,126714,12500,12500,12450,554,4,2,58973,52417,50,504
113000,012630,12450,2,50,0.4,134.86,52467,70757,18290,701,529,-172,126835,12450,12450,12450,0,0,0,58967,52429,0,0
113000,012630,12500,2,100,0.81,134.32,52680,70760,18080,705,532,-173,127051,12450,12500,12450,216,4,3,63910,52092,213,3
113100,012630,12450,2,50,0.4,134.18,52736,70763,18027,713,533,-180,127110,12450,12450,12450,2,1,0,63906,52051,2,0
113100,012630,12450,2,50,0.4,133.05,53184,70763,17579,718,533,-185,127558,12450,12450,12450,450,6,0,64024,51639,450,0
113200,012630,12450,2,50,0.4,132.48,53413,70763,17350,723,533,-190,127787,12450,12450,12450,0,0,0,64034,51428,0,0
113200,012630,12500,2,100,0.81,133.56,53428,71357,17929,728,535,-193,128396,12450,12500,12450,609,5,2,63553,51485,15,594
113300,012630,12450,2,50,0.4,133.2,53570,71357,17787,734,535,-199,128538,12450,12450,12450,6,1,0,63594,51531,6,0
113300,012630,12450,2,50,0.4,133.17,53585,71361,17776,739,536,-203,128557,12450,12500,12450,25,6,1,63651,51529,21,4
113400,012630,12450,2,50,0.4,132.76,53750,71361,17611,745,536,-209,128722,12450,12450,12450,7,2,0,63781,51288,7,0
113400,012630,12450,2,50,0.4,132.05,54042,71361,17319,747,536,-211,129014,12450,12450,12450,299,4,0,63781,51304,299,0
113500,012630,12450,2,50,0.4,132.6,54207,71879,17672,754,538,-216,129697,12450,12450,12450,1,1,0,59138,51186,1,0
113500,012630,12450,2,50,0.4,133.22,54332,72383,18051,758,540,-218,130326,12450,12500,12450,630,5,2,58805,51221,126,504
113600,012630,12450,2,50,0.4,133.1,54383,72383,18000,763,540,-223,130377,12450,12450,12450,6,1,0,59767,51077,6,0
113600,012630,12450,2,50,0.4,133.07,54396,72386,17990,766,541,-225,130393,12450,12500,12450,22,4,1,61824,51077,19,3
113700,012630,12450,2,50,0.4,132.95,54447,72386,17939,771,541,-230,130444,12450,12450,12450,8,3,0,63029,51039,8,0
113700,012630,12450,2,50,0.4,132.65,54570,72386,17816,776,541,-235,130567,12450,12450,12450,131,8,0,63023,50924,131,0
113800,012630,12500,2,100,0.81,132.74,54907,72886,17979,782,542,-240,131404,12450,12500,12450,543,2,1,63050,50561,43,500
113800,012630,12450,2,50,0.4,132.74,54909,72886,17977,784,542,-242,131406,12450,12500,12450,545,4,1,62623,50560,45,500
113900,012630,12450,2,50,0.4,132.64,54949,72886,17937,788,542,-246,131446,12450,12450,12450,39,3,0,62702,50522,39,0
113900,012630,12450,2,50,0.4,132.65,54951,72891,17940,790,544,-246,131453,12450,12500,12450,46,5,2,62851,50567,41,5
114000,012630,12450,2,50,0.4,132.54,54997,72894,17897,793,545,-248,131502,12500,12500,12450,41,2,1,62912,51514,38,3
114000,012630,12450,2,50,0.4,132.49,55017,72894,17877,798,545,-253,131522,12500,12500,12450,61,7,1,62941,54478,58,3
114100,012630,12450,2,50,0.4,132.6,55348,73394,18046,803,546,-257,132353,12450,12500,12450,830,4,1,62525,54211,330,500
114100,012630,12450,2,50,0.4,132.28,55483,73394,17911,807,546,-261,132488,12450,12500,12450,965,8,1,62942,54055,465,500
114200,012630,12450,2,50,0.4,132.32,55523,73470,17947,811,549,-262,132604,12500,12500,12450,53,4,1,62900,54010,40,13
114200,012630,12450,2,50,0.4,132.33,55524,73473,17949,812,550,-262,132608,12500,12500,12450,57,5,2,62967,54060,41,16
114300,012630,12450,2,50,0.4,132.32,55529,73475,17946,815,552,-263,132615,12500,12500,12450,4,2,2,63164,54260,2,2
114300,012630,12500,2,100,0.81,132.22,55569,73476,17907,819,553,-266,132656,12500,12500,12450,45,6,3,63164,54393,42,3
114400,012630,12450,2,50,0.4,132.44,55857,73978,18121,822,556,-266,133446,12450,12500,12450,790,3,3,62936,53080,288,502
114400,012630,12500,2,100,0.81,132.35,55896,73980,18084,825,558,-267,133487,12450,12500,12450,831,6,5,63021,53025,327,504
114500,012630,12500,2,100,0.81,132.9,55898,74286,18388,827,562,-265,133795,12450,12500,12450,308,2,4,62858,53058,2,306
114500,012630,12500,2,100,0.81,132.83,55936,74299,18363,829,563,-266,133846,12450,12500,12450,359,4,5,63119,53025,40,319
114600,012630,12450,2,50,0.4,132.63,56019,74299,18280,831,563,-268,133929,12450,12450,12450,83,2,0,63181,52969,83,0
114700,012630,12500,2,100,0.81,133.46,56057,74813,18756,833,565,-268,134481,12500,12500,12500,500,0,1,63230,52966,0,500
114700,012630,12500,2,100,0.81,133.94,56061,75088,19027,836,567,-269,134760,12500,12500,12450,779,3,3,62971,52962,4,775
114800,012630,12450,2,50,0.4,133.17,56386,75088,18702,840,567,-273,135085,12450,12450,12450,0,0,0,62687,52678,0,0
114800,012630,12450,2,50,0.4,133.17,56388,75091,18703,842,568,-274,135090,12500,12500,12450,5,2,1,63201,52233,2,3
114900,012630,12450,2,50,0.4,132.29,56763,75092,18329,847,569,-278,135466,12450,12450,12450,1,1,0,62987,51825,1,0
114900,012630,12450,2,50,0.4,132.29,56765,75092,18327,849,569,-280,135468,12450,12450,12450,3,3,0,63094,51849,3,0
115000,012630,12500,2,100,0.81,133.08,56804,75592,18788,852,570,-282,136007,12500,12500,12500,0,0,0,58093,52005,0,0
115000,012630,12450,2,50,0.4,133.05,56813,75592,18779,854,570,-284,136016,12450,12450,12450,9,2,0,57707,52120,9,0
115100,012630,12450,2,50,0.4,131.74,57378,75592,18214,864,570,-294,136581,12450,12450,12450,0,0,0,58226,51574,0,0
115100,012630,12450,2,50,0.4,131.5,57492,75604,18112,869,572,-297,136707,12450,12500,12450,126,5,2,58587,51389,114,12
115200,012630,12450,2,50,0.4,131.39,57542,75604,18062,873,572,-301,136757,12450,12450,12450,44,3,0,58612,51365,44,0
115200,012630,12450,2,50,0.4,131.37,57550,75604,18054,876,572,-304,136765,12450,12450,12450,52,6,0,58707,51401,52,0
115300,012630,12450,2,50,0.4,131.62,57820,76104,18284,882,573,-309,137535,12450,12450,12450,38,2,0,58105,51271,38,0
115300,012630,12500,2,100,0.81,131.62,57822,76106,18284,884,575,-309,137539,12450,12500,12450,42,4,2,57957,51345,40,2
115400,012630,12450,2,50,0.4,130.88,58148,76106,17958,888,575,-313,137865,12450,12450,12450,326,4,0,58041,51578,326,0
115400,012630,12450,2,50,0.4,130.89,58149,76109,17960,889,576,-313,137869,12450,12500,12450,330,5,1,58117,51513,327,3
115500,012630,12450,2,50,0.4,130.63,58264,76109,17845,893,576,-317,137984,12450,12450,12450,2,2,0,58269,51398,2,0
115500,012630,12450,2,50,0.4,130.54,58302,76109,17807,895,576,-319,138022,12450,12450,12450,40,4,0,58269,51360,40,0
115600,012630,12500,2,100,0.81,131.57,58306,76712,18406,899,579,-320,138629,12450,12500,12450,104,1,2,57780,51399,1,103
115600,012630,12500,2,100,0.81,131.23,58459,76713,18254,904,580,-324,138783,12450,12500,12450,258,6,3,57768,51764,154,104
115700,012630,12500,2,100,0.81,131.24,58461,76725,18264,906,582,-324,138797,12500,12500,12450,14,2,2,57789,52062,2,12
115700,012630,12450,2,50,0.4,130.51,58788,76725,17937,911,582,-329,139124,12500,12500,12450,341,7,2,58066,51765,329,12
115800,012630,12500,2,100,0.81,130.51,58788,76727,17939,911,584,-327,139126,12500,12500,12500,1,0,1,58094,51798,0,1
115800,012630,12450,2,50,0.4,129.52,59239,76729,17490,916,586,-330,139579,12500,12500,12450,454,5,3,58011,51680,451,3
115900,012630,12450,2,50,0.4,130.07,59374,77229,17855,918,587,-331,140214,12450,12450,12450,135,2,0,57388,51460,135,0
115900,012630,12450,2,50,0.4,129.78,59506,77229,17723,922,587,-335,140346,12450,12450,12450,267,6,0,57341,51300,267,0
120000,012630,12500,2,100,0.81,129.79,59506,77232,17726,922,588,-334,140349,12500,12500,12500,3,0,1,57346,51258,0,3
120000,012630,12450,2,50,0.4,129.07,59839,77232,17393,932,588,-344,140682,12500,12500,12450,336,10,1,57753,51093,333,3
120100,012630,12450,2,50,0.4,129.06,59840,77232,17392,933,588,-345,140683,12450,12450,12450,1,1,0,57518,50964,1,0
120100,012630,12500,2,100,0.81,129.82,59877,77732,17855,934,589,-345,141220,12450,12500,12450,538,2,1,57757,51117,38,500
120200,012630,12450,2,50,0.4,129.54,60004,77732,17728,939,589,-350,141347,12450,12450,12450,120,4,0,57378,51187,120,0
120200,012630,12450,2,50,0.4,129.44,60053,77733,17680,942,590,-352,141397,12450,12500,12450,170,7,1,57329,51044,169,1
120300,012630,12500,2,100,0.81,129.44,60059,77738,17679,943,592,-351,141408,12450,12500,12450,11,1,2,57423,51169,6,5
120300,012630,12450,2,50,0.4,129.32,60111,77738,17627,949,592,-357,141460,12450,12500,12450,63,7,2,57754,50699,58,5
120400,012630,12450,2,50,0.4,128.45,60519,77738,17219,954,592,-362,141868,12450,12450,12450,408,5,0,58553,50534,408,0
120400,012630,12450,2,50,0.4,129.11,60599,78238,17639,959,593,-366,142448,12450,12500,12450,988,10,1,58343,50391,488,500
120500,012630,12450,2,50,0.4,129.11,60599,78238,17639,959,593,-366,142448,12450,12450,12450,0,0,0,58343,50391,0,0
120500,012630,12450,2,50,0.4,129.02,60638,78238,17600,962,593,-369,142487,12450,12450,12450,39,3,0,58406,50434,39,0
120600,012630,12450,2,50,0.4,129.03,60639,78241,17602,963,594,-369,142491,12500,12500,12450,4,1,1,58635,50567,1,3
120700,012630,12500,2,100,0.81,129.03,60639,78244,17605,963,595,-368,142494,12500,12500,12500,0,0,0,58635,50566,0,0
120700,012630,12450,2,50,0.4,128.32,60978,78245,17267,969,596,-373,142834,12450,12500,12450,340,6,1,58635,50401,339,1
120800,012630,12500,2,100,0.81,129.07,61010,78746,17736,970,598,-372,143367,12500,12500,12500,0,0,0,58218,47594,0,0
120800,012630,12450,2,50,0.4,128.98,61052,78746,17694,975,598,-377,143409,12450,12450,12450,42,5,0,58360,47666,42,0
120900,012630,12450,2,50,0.4,128.51,61278,78746,17468,978,598,-380,143635,12450,12450,12450,1,1,0,57963,47455,1,0
120900,012630,12450,2,50,0.4,128.44,61315,78750,17435,979,599,-380,143676,12450,12500,12450,42,2,1,57959,47578,38,4
121000,012630,12450,2,50,0.4,127.96,61542,78750,17208,983,599,-384,143903,12450,12450,12450,0,0,0,58252,47721,0,0
121000,012630,12450,2,50,0.4,127.3,61864,78750,16886,985,599,-386,144225,12450,12450,12450,322,2,0,58094,47660,322,0
121100,012630,12450,2,50,0.4,128.08,61875,79250,17375,990,600,-390,144736,12450,12450,12450,6,3,0,57789,47526,6,0
121100,012630,12450,2,50,0.4,128.0,61913,79250,17337,992,600,-392,144774,12450,12450,12450,44,5,0,57801,47521,44,0
121200,012630,12500,2,100,0.81,127.57,62125,79254,17129,994,602,-392,144990,12500,12500,12500,3,0,1,57886,48500,0,3
121200,012630,12450,2,50,0.4,127.5,62165,79259,17094,998,603,-395,145035,12500,12500,12450,48,4,2,57890,48580,40,8
121300,012630,12500,2,100,0.81,127.5,62165,79260,17095,998,604,-394,145036,12500,12500,12500,1,0,1,57902,48647,0,1
121300,012630,12500,2,100,0.81,128.22,62204,79760,17556,1001,605,-396,145575,12500,12500,12450,540,3,2,57932,48540,39,501
121400,012630,12450,2,50,0.4,127.63,62492,79760,17268,1003,605,-398,145863,12450,12450,12450,2,1,0,57565,48335,2,0
121400,012630,12450,2,50,0.4,127.59,62531,79781,17250,1006,606,-400,145923,12450,12500,12450,62,4,1,57650,48308,41,21
121500,012630,12450,2,50,0.4,127.58,62539,79786,17247,1009,608,-401,145936,12500,12500,12450,7,2,2,60779,48638,2,5
121500,012630,12450,2,50,0.4,127.25,62700,79786,17086,1013,608,-405,146097,12500,12500,12450,168,6,2,60771,48600,163,5
121600,012630,12450,2,50,0.4,127.22,62715,79786,17071,1018,608,-410,146112,12450,12450,12450,7,2,0,60837,48521,7,0
121600,012630,12450,2,50,0.4,127.92,62765,80287,17522,1022,610,-412,146663,12450,12500,12450,558,6,2,60059,48564,57,501
121700,012630,12450,2,50,0.4,127.32,63059,80287,17228,1026,610,-416,146957,12450,12450,12450,293,3,0,60170,48288,293,0
121700,012630,12450,2,50,0.4,126.86,63289,80287,16998,1034,610,-424,147187,12450,12450,12450,523,11,0,60188,48031,523,0
121800,012630,12450,2,50,0.4,126.85,63296,80290,16994,1036,611,-425,147197,12500,12500,12450,9,1,1,60185,48077,6,3
121800,012630,12450,2,50,0.4,126.69,63377,80290,16913,1041,611,-430,147278,12500,12500,12450,90,6,1,59985,47984,87,3
121900,012630,12450,2,50,0.4,126.66,63390,80290,16900,1044,611,-433,147291,12450,12450,12450,13,3,0,60085,48030,13,0
121900,012630,12450,2,50,0.4,126.93,63652,80792,17140,1047,614,-433,148055,12450,12500,12450,777,6,3,59506,47823,275,502
122000,012630,12450,2,50,0.4,126.36,63937,80792,16855,1048,614,-434,148340,12450,12450,12450,285,1,0,59518,47799,285,0
122100,012630,12500,2,100,0.81,126.36,63940,80796,16856,1050,615,-435,148347,12500,12500,12500,0,0,0,59596,47606,0,0
122100,012630,12450,2,50,0.4,126.07,64091,80797,16706,1053,616,-437,148499,12450,12500,12450,152,3,1,59505,47602,151,1
122200,012630,12450,2,50,0.4,126.06,64094,80797,16703,1056,616,-440,148502,12450,12450,12450,1,1,0,59689,47487,1,0
122200,012630,12500,2,100,0.81,126.73,64148,81297,17149,1060,617,-443,149056,12450,12500,12450,555,5,1,59679,47591,55,500
122300,012630,12500,2,100,0.81,126.73,64148,81297,17149,1060,617,-443,149056,12500,12500,12500,0,0,0,59679,47591,0,0
122300,012630,12450,2,50,0.4,126.44,64298,81297,16999,1063,617,-446,149206,12450,12450,12450,150,3,0,59279,47867,150,0
122400,012630,12500,2,100,0.81,125.88,64586,81300,16714,1066,618,-448,149497,12500,12500,12500,0,0,0,59446,47776,0,0
122400,012630,12450,2,50,0.4,125.8,64627,81300,16673,1069,618,-451,149538,12450,12450,12450,41,3,0,59480,47953,41,0
122500,012630,12500,2,100,0.81,125.8,64627,81301,16674,1069,619,-450,149539,12500,12500,12500,0,0,0,59478,47951,0,0
122500,012630,12500,2,100,0.81,126.5,64666,81801,17135,1071,620,-451,150078,12450,12500,12450,539,2,1,59760,48251,39,500
122600,012630,12450,2,50,0.4,126.49,64670,81802,17132,1074,621,-453,150083,12450,12450,12450,3,2,0,59283,48285,3,0
122600,012630,12450,2,50,0.4,126.42,64708,81802,17094,1076,621,-455,150121,12450,12450,12450,41,4,0,59357,48072,41,0
122700,012630,12450,2,50,0.4,125.65,65108,81806,16698,1079,622,-457,150525,12450,12450,12450,114,2,0,59365,47951,114,0
122700,012630,12450,2,50,0.4,125.57,65150,81806,16656,1083,622,-461,150567,12450,12450,12450,156,6,0,59377,47947,156,0
122800,012630,12450,2,50,0.4,125.57,65151,81807,16656,1084,623,-461,150569,12450,12450,12450,1,1,0,59388,49643,1,0
122800,012630,12450,2,50,0.4,126.26,65188,82307,17119,1085,624,-461,151106,12450,12500,12450,538,2,1,58998,49784,38,500
122900,012630,12450,2,50,0.4,126.04,65304,82307,17003,1088,624,-464,151222,12450,12450,12450,115,2,0,59010,50171,115,0
122900,012630,12450,2,50,0.4,125.96,65342,82307,16965,1090,624,-466,151260,12450,12450,12450,153,4,0,59122,50443,153,0
123000,012630,12450,2,50,0.4,125.38,65648,82310,16662,1094,625,-469,151569,12450,12450,12450,286,2,0,59278,50619,286,0
123000,012630,12450,2,50,0.4,125.11,65791,82311,16520,1097,626,-471,151713,12450,12500,12450,430,5,1,59289,51627,429,1
123100,012630,12450,2,50,0.4,124.67,66024,82311,16287,1102,626,-476,151946,12450,12450,12450,6,2,0,59196,51466,6,0
123100,012630,12450,2,50,0.4,125.33,66073,82811,16738,1105,627,-478,152495,12450,12500,12450,555,5,1,58711,51713,55,500
123200,012630,12450,2,50,0.4,125.31,66086,82811,16725,1108,627,-481,152508,12450,12450,12450,7,2,0,58711,51674,7,0
123200,012630,12450,2,50,0.4,125.19,66146,82811,16665,1111,627,-484,152568,12450,12450,12450,67,5,0,58712,51597,67,0
123300,012630,12450,2,50,0.4,124.97,66270,82815,16545,1114,628,-486,152696,12450,12450,12450,6,1,0,58714,51496,6,0
123300,012630,12450,2,50,0.4,124.34,66606,82815,16209,1120,628,-492,153032,12450,12450,12450,342,7,0,58736,51146,342,0
123400,012630,12450,2,50,0.4,124.25,66652,82815,16163,1124,628,-496,153078,12450,12450,12450,9,3,0,59045,51168,9,0
123400,012630,12450,2,50,0.4,123.99,67194,83315,16121,1131,629,-502,154120,12450,12500,12450,1051,10,1,58539,50696,551,500
123500,012630,12450,2,50,0.4,123.69,67358,83316,15958,1136,630,-506,154285,12450,12450,12450,127,4,0,58529,50470,127,0
123500,012630,12500,2,100,0.81,123.68,67364,83319,15955,1137,631,-506,154294,12450,12500,12450,136,5,1,58539,50471,133,3
123600,012630,12450,2,50,0.4,123.59,67414,83319,15905,1141,631,-510,154344,12450,12450,12450,43,2,0,58541,50416,43,0
123600,012630,12450,2,50,0.4,122.86,67819,83320,15501,1145,632,-513,154750,12450,12500,12450,449,6,1,58339,51154,448,1
123700,012630,12500,2,100,0.81,123.43,67907,83820,15913,1150,633,-517,155338,12450,12500,12450,582,4,1,58567,50842,82,500
123700,012630,12450,2,50,0.4,123.41,67921,83820,15899,1153,633,-520,155352,12450,12500,12450,596,7,1,57867,50940,96,500
123800,012630,12450,2,50,0.4,123.33,67964,83820,15856,1155,633,-522,155395,12450,12450,12450,43,2,0,58275,50913,43,0
123800,012630,12500,2,100,0.81,123.11,68091,83825,15734,1161,635,-526,155527,12450,12500,12450,175,8,2,58265,50728,170,5
123900,012630,12450,2,50,0.4,123.02,68140,83825,15685,1164,635,-529,155576,12450,12450,12450,49,3,0,58270,50642,49,0
124000,012630,12450,2,50,0.4,122.98,68161,83826,15665,1169,636,-533,155598,12450,12450,12450,0,0,0,58313,50639,0,0
124000,012630,12450,2,50,0.4,122.71,68717,84326,15609,1180,637,-543,156654,12450,12500,12450,1056,11,1,57868,50289,556,500
124100,012630,12450,2,50,0.4,122.45,68867,84326,15459,1187,637,-550,156804,12450,12450,12450,1,1,0,57868,50069,1,0
124100,012630,12450,2,50,0.4,122.36,68916,84327,15411,1190,638,-552,156854,12450,12500,12450,51,4,1,57890,50082,50,1
124200,012630,12450,2,50,0.4,122.22,68999,84331,15332,1195,639,-556,156941,12450,12450,12450,7,2,0,57921,50074,7,0
124200,012630,12450,2,50,0.4,121.94,69155,84331,15176,1199,639,-560,157097,12450,12450,12450,163,6,0,57921,50580,163,0
124300,012630,12450,2,50,0.4,121.75,69263,84331,15068,1203,639,-564,157205,12450,12450,12450,7,2,0,58025,50582,7,0
124300,012630,12450,2,50,0.4,121.9,69588,84831,15243,1208,640,-568,158030,12450,12500,12450,832,7,1,57732,50380,332,500
124400,012630,12500,2,100,0.81,122.63,69588,85333,15745,1208,643,-565,158532,12500,12500,12500,501,0,2,57294,50466,0,501
124400,012630,12450,2,50,0.4,122.36,69741,85333,15592,1211,643,-568,158685,12500,12500,12450,654,3,2,57650,50350,153,501
124500,012630,12500,2,100,0.81,122.36,69741,85337,15596,1211,644,-567,158689,12500,12500,12500,0,0,0,57650,50313,0,0
124500,012630,12500,2,100,0.81,122.36,69741,85337,15596,1211,644,-567,158689,12500,12500,12500,0,0,0,57650,50313,0,0
124600,012630,12500,2,100,0.81,123.1,69780,85900,16120,1214,647,-567,159291,12500,12500,12500,563,0,3,57713,53703,0,563
124600,012630,12450,2,50,0.4,122.49,70126,85900,15774,1218,647,-571,159637,12500,12500,12450,909,4,3,57244,53405,346,563
124700,012630,12450,2,50,0.4,122.43,70163,85900,15737,1219,647,-572,159674,12450,12450,12450,0,0,0,57340,53416,0,0
124700,012630,12500,2,100,0.81,122.42,70169,85903,15734,1223,648,-575,159683,12450,12500,12450,9,4,1,57552,53406,6,3
124800,012630,12450,2,50,0.4,122.16,70319,85903,15584,1225,648,-577,159833,12450,12450,12450,113,1,0,57673,53382,113,0
124800,012630,12500,2,100,0.81,122.16,70320,85904,15584,1226,649,-577,159835,12450,12500,12450,115,2,1,57685,54790,114,1
124900,012630,12500,2,100,0.81,123.79,70357,87097,16740,1227,652,-575,161065,12500,12500,12500,1193,0,3,56197,54766,0,1193
124900,012630,12500,2,100,0.81,123.79,70357,87097,16740,1227,652,-575,161065,12500,12500,12500,1193,0,3,56197,54766,0,1193
125000,012630,12500,2,100,0.81,124.31,70866,88097,17231,1236,654,-582,162574,12450,12500,12450,1186,7,2,64436,50587,186,1000
125000,012630,12550,2,150,1.21,124.17,70950,88102,17152,1238,656,-582,162663,12450,12550,12450,1275,9,4,64453,49096,270,1005
125100,012630,12500,2,100,0.81,124.13,70993,88123,17130,1243,657,-586,162727,12500,12500,12500,62,4,1,56097,52931,41,21
125100,012630,12500,2,100,0.81,124.13,70994,88128,17134,1244,659,-585,162733,12500,12500,12450,68,5,3,56086,54397,42,26
125200,012630,12450,2,50,0.4,124.57,71148,88628,17480,1250,660,-590,163387,12450,12500,12450,540,4,1,56056,54257,40,500
125200,012630,12450,2,50,0.4,124.2,71361,88628,17267,1252,660,-592,163600,12450,12500,12450,753,6,1,56189,54255,253,500
125300,012630,12500,2,100,0.81,123.64,71683,88629,16946,1254,661,-593,163923,12450,12500,12450,323,2,1,56859,53735,322,1
125300,012630,12500,2,100,0.81,123.64,71683,88632,16949,1254,662,-592,163926,12450,12500,12450,326,2,2,56859,53949,322,4
125400,012630,12450,2,50,0.4,123.57,71724,88632,16908,1257,662,-595,163967,12450,12450,12450,41,3,0,57437,53983,41,0
125500,012630,12450,2,50,0.4,123.57,71726,88632,16906,1259,662,-597,163969,12450,12450,12450,0,0,0,57549,53994,0,0
125500,012630,12450,2,50,0.4,124.2,71763,89132,17369,1260,663,-597,164506,12500,12500,12450,537,1,1,57285,54104,37,500
125600,012630,12450,2,50,0.4,124.01,71877,89133,17256,1263,664,-599,164621,12450,12450,12450,0,0,0,57233,53747,0,0
125600,012630,12450,2,50,0.4,123.45,72201,89134,16933,1266,665,-601,164946,12500,12500,12450,325,3,1,57127,53722,324,1
125700,012630,12500,2,100,0.81,123.46,72201,89138,16937,1266,666,-600,164950,12500,12500,12500,0,0,0,57227,53636,0,0
125700,012630,12450,2,50,0.4,123.39,72242,89138,16896,1269,666,-603,164991,12450,12450,12450,41,3,0,57829,54003,41,0
125800,012630,12450,2,50,0.4,123.89,72356,89640,17284,1271,669,-602,165607,12500,12500,12450,501,1,1,57446,53903,1,500
125800,012630,12450,2,50,0.4,123.82,72395,89640,17245,1274,669,-605,165646,12500,12500,12450,540,4,1,57632,53913,40,500
125900,012630,12450,2,50,0.4,123.82,72396,89640,17244,1275,669,-606,165647,12450,12450,12450,1,1,0,57748,53587,1,0
125900,012630,12500,2,100,0.81,123.82,72396,89643,17247,1275,670,-605,165650,12450,12500,12450,4,1,1,57689,53651,1,3
130000,012630,12450,2,50,0.4,122.72,73046,89643,16597,1280,670,-610,166300,12450,12450,12450,1,1,0,57864,53016,1,0
130000,012630,12450,2,50,0.4,122.72,73047,89644,16597,1281,671,-610,166302,12450,12500,12450,3,2,1,58174,52833,2,1
130100,012630,12500,2,100,0.81,123.34,73087,90144,17057,1284,672,-612,166842,12450,12500,12450,501,1,1,58250,60887,1,500
130100,012630,12500,2,100,0.81,123.34,73087,90144,17057,1284,672,-612,166842,12450,12500,12450,501,1,1,58250,60887,1,500
130200,012630,12450,2,50,0.4,123.27,73126,90144,17018,1286,672,-614,166881,12450,12450,12450,2,1,0,58506,64452,2,0
130200,012630,12500,2,100,0.81,122.54,73577,90162,16585,1288,677,-611,167350,12450,12500,12450,471,3,5,59203,53347,453,18
130300,012630,12500,2,100,0.81,122.02,73900,90171,16271,1290,679,-611,167682,12450,12500,12450,294,1,1,59232,52523,286,8
130300,012630,12500,2,100,0.81,122.02,73900,90171,16271,1290,679,-611,167682,12450,12500,12450,294,1,1,59232,52523,286,8
130400,012630,12450,2,50,0.4,121.95,73941,90172,16231,1294,680,-614,167724,12500,12500,12450,4,2,1,59384,52791,3,1
130400,012630,12500,2,100,0.81,121.76,74062,90175,16113,1297,681,-616,167848,12500,12500,12450,128,5,2,59484,52680,124,4
130500,012630,12500,2,100,0.81,121.28,74358,90183,15825,1304,685,-619,168152,12450,12500,12450,304,7,4,59358,52420,296,8
130500,012630,12500,2,100,0.81,121.29,74358,90186,15828,1304,686,-618,168155,12450,12500,12450,307,7,5,59389,52420,296,11
130600,012630,12450,2,50,0.4,120.77,74681,90194,15513,1307,688,-619,168486,12450,12500,12450,331,3,2,59318,52411,323,8
130600,012630,12450,2,50,0.4,120.75,74696,90194,15498,1309,688,-621,168501,12450,12500,12450,346,5,2,59322,52382,338,8
130700,012630,12450,2,50,0.4,120.68,74740,90196,15456,1313,690,-623,168547,12450,12500,12450,46,4,2,59426,52367,44,2
130800,012630,12500,2,100,0.81,120.5,74855,90200,15345,1317,693,-624,168666,12500,12500,12500,0,0,0,59565,52251,0,0
130800,012630,12450,2,50,0.4,120.43,74905,90205,15300,1321,695,-626,168721,12450,12500,12450,55,4,2,59559,52228,50,5
130900,012630,12500,2,100,0.81,120.27,75007,90208,15201,1326,696,-630,168826,12500,12500,12500,0,0,0,59559,52056,0,0
130900,012630,12450,2,50,0.4,120.19,75057,90208,15151,1330,696,-634,168876,12450,12450,12450,50,4,0,59679,50737,50,0
131000,012630,12450,2,50,0.4,119.21,75688,90225,14537,1336,699,-637,169524,12450,12450,12450,0,0,0,59333,51204,0,0
131000,012630,12450,2,50,0.4,118.96,75846,90229,14383,1340,700,-640,169686,12450,12500,12450,162,4,1,59462,51079,158,4
131100,012630,12500,2,100,0.81,118.55,76117,90235,14118,1347,701,-646,169963,12450,12500,12450,232,2,1,59351,50928,226,6
131100,012630,12450,2,50,0.4,118.49,76155,90238,14083,1349,702,-647,170004,12450,12500,12450,273,4,2,59392,50994,264,9
131200,012630,12500,2,100,0.81,118.36,76242,90242,14000,1351,705,-646,170095,12500,12500,12500,2,0,1,59282,50953,0,2
131200,012630,12450,2,50,0.4,118.29,76292,90244,13952,1355,707,-648,170147,12500,12500,12450,54,4,3,59700,51046,50,4
131300,012630,12450,2,50,0.4,117.65,76704,90244,13540,1361,707,-654,170559,12450,12450,12450,6,1,0,59690,50821,6,0
131300,012630,12450,2,50,0.4,117.58,76754,90244,13490,1365,707,-658,170609,12450,12450,12450,56,5,0,59736,50842,56,0
131400,012630,12450,2,50,0.4,117.56,76761,90244,13483,1367,707,-660,170616,12450,12450,12450,0,0,0,59882,51013,0,0
131400,012630,12450,2,50,0.4,117.49,76812,90249,13437,1371,709,-662,170672,12450,12500,12450,56,4,2,59871,51806,51,5
131500,012630,12450,2,50,0.4,117.29,76948,90249,13301,1376,709,-667,170808,12450,12450,12450,6,1,0,59871,51731,6,0
131500,012630,12500,2,100,0.81,117.26,76968,90254,13286,1386,710,-676,170833,12450,12500,12450,31,11,1,76019,51464,26,5
131600,012630,12450,2,50,0.4,116.8,77304,90289,12985,1391,712,-679,171204,12450,12450,12450,293,3,0,76018,50784,293,0
131600,012630,12450,2,50,0.4,116.48,77518,90290,12772,1395,713,-682,171419,12450,12500,12450,508,7,1,76017,50567,507,1
131700,012630,12450,2,50,0.4,116.45,77570,90329,12759,1401,717,-684,171510,12450,12500,12450,44,4,3,76009,50417,9,35
131700,012630,12450,2,50,0.4,116.43,77587,90332,12745,1407,718,-689,171530,12450,12500,12450,64,10,4,76206,50413,26,38
131800,012630,12500,2,100,0.81,116.42,77711,90471,12760,1414,722,-692,171793,12450,12500,12450,147,3,4,76159,50170,8,139
131800,012630,12450,2,50,0.4,116.33,77772,90471,12699,1416,722,-694,171854,12450,12500,12450,208,5,4,76196,50285,69,139
131900,012630,12450,2,50,0.4,115.17,78554,90471,11917,1421,722,-699,172636,12450,12450,12450,745,4,0,76185,49819,745,0
131900,012630,12450,2,50,0.4,115.05,78668,90509,11841,1423,725,-698,172788,12450,12500,12450,897,6,3,75629,49585,859,38
132000,012630,12450,2,50,0.4,114.97,78725,90513,11788,1432,726,-706,172849,12450,12500,12450,61,9,1,75623,49386,57,4
132000,012630,12450,2,50,0.4,113.57,79732,90552,10820,1450,729,-721,173895,12450,12500,12450,1107,27,4,75576,48495,1064,43
132100,012630,12450,2,50,0.4,113.51,79775,90553,10778,1456,730,-726,173939,12450,12500,12450,42,5,1,75698,48399,41,1
132100,012630,12500,2,100,0.81,113.41,79881,90592,10711,1458,734,-724,174084,12450,12500,12450,187,7,5,75690,48453,147,40
132200,012630,12450,2,50,0.4,113.17,80050,90592,10542,1465,734,-731,174253,12450,12450,12450,169,7,0,75651,48552,169,0
132300,012630,12450,2,50,0.4,112.11,81317,91168,9851,1481,735,-746,176096,12450,12450,12450,0,0,0,75277,49247,0,0
132300,012630,12450,2,50,0.4,112.11,81358,91210,9852,1485,739,-746,176179,12500,12500,12450,83,4,4,75247,49360,41,42
132400,012630,12450,2,50,0.4,112.01,81443,91225,9782,1488,740,-748,176279,12450,12450,12450,2,1,0,75246,47400,2,0
132400,012630,12500,2,100,0.81,112.01,81482,91264,9782,1490,743,-747,176357,12450,12500,12450,80,3,3,75382,47360,41,39
132500,012630,12450,2,50,0.4,111.96,81513,91264,9751,1493,743,-750,176388,12450,12450,12450,30,2,0,75501,49379,30,0
132500,012630,12450,2,50,0.4,109.4,83429,91268,7839,1506,744,-762,178308,12450,12500,12450,1950,15,1,75400,47495,1946,4
132600,012630,12450,2,50,0.4,109.04,83802,91379,7577,1516,751,-765,178792,12450,12450,12450,95,3,2,75227,47283,55,40
132600,012630,12400,3,0,0.0,108.99,83844,91379,7535,1518,751,-767,178834,12450,12450,12400,137,5,2,55417,48949,97,40
132700,012630,12450,2,50,0.4,109.03,83846,91417,7571,1520,754,-766,178874,12450,12450,12450,0,0,0,55398,49025,0,0
132700,012630,12400,3,0,0.0,108.98,83888,91417,7529,1525,754,-771,178916,12400,12400,12400,42,5,0,55545,49009,42,0
132800,012630,12450,2,50,0.4,109.02,83890,91457,7567,1527,758,-769,178958,12450,12450,12450,39,0,3,57377,48963,0,39
132800,012630,12400,3,0,0.0,108.77,84154,91537,7383,1531,759,-772,179302,12450,12450,12400,383,4,4,60288,48840,264,119
132900,012630,12400,3,0,0.0,108.77,84157,91537,7380,1532,759,-773,179305,12400,12400,12400,0,0,0,60300,48816,0,0
132900,012630,12400,3,0,0.0,108.77,84196,91578,7382,1535,763,-772,179385,12450,12450,12400,80,3,4,60306,48834,39,41
133000,012630,12400,3,0,0.0,108.47,84427,91578,7151,1543,763,-780,179616,12400,12400,12400,226,3,0,60195,48659,226,0
133000,012630,12450,2,50,0.4,108.64,84430,91726,7296,1546,769,-777,179767,12400,12450,12400,377,6,6,60091,48716,229,148
133100,012630,12400,3,0,0.0,108.71,84472,91826,7354,1550,770,-780,179909,12400,12400,12400,4,2,0,60085,48758,4,0
133100,012630,12450,2,50,0.4,108.72,84472,91835,7363,1550,772,-778,179918,12400,12450,12400,13,2,2,60305,49005,4,9
133200,012630,12400,3,0,0.0,108.51,84663,91869,7206,1555,774,-781,180143,12400,12450,12400,119,3,1,60265,48863,115,4
133200,012630,12400,3,0,0.0,108.51,84666,91869,7203,1558,774,-784,180146,12400,12450,12400,122,6,1,60305,47873,118,4
133300,012630,12450,2,50,0.4,108.58,84703,91972,7269,1559,778,-781,180286,12450,12450,12450,99,0,3,60180,47979,0,99
133300,012630,12450,2,50,0.4,108.51,84761,91974,7213,1562,780,-782,180346,12450,12450,12400,159,3,5,60127,48065,58,101
133400,012630,12450,2,50,0.4,108.3,85016,92076,7060,1567,785,-782,180703,12400,12450,12400,80,3,4,60038,47908,40,40
133400,012630,12450,2,50,0.4,110.74,85030,94162,9132,1572,788,-784,182803,12400,12450,12400,2180,8,7,78168,47901,54,2126
133500,012630,12500,2,100,0.81,110.7,85071,94170,9099,1577,791,-786,182852,12450,12500,12450,48,5,2,78175,48132,41,7
133500,012630,12450,2,50,0.4,110.19,85495,94205,8710,1583,793,-790,183311,12450,12500,12450,507,11,4,78148,48356,465,42
133600,012630,12450,2,50,0.4,110.14,85536,94206,8670,1587,794,-793,183353,12450,12500,12450,40,3,1,78069,48264,39,1
133600,012630,12450,2,50,0.4,110.18,85537,94244,8707,1588,797,-791,183392,12450,12500,12450,79,4,4,78150,48293,40,39
133700,012630,12450,2,50,0.4,110.11,85594,94244,8650,1594,797,-797,183449,12450,12450,12450,57,6,0,78162,48324,57,0
133800,012630,12500,2,100,0.81,109.96,85712,94252,8540,1599,799,-800,183575,12500,12500,12500,0,0,0,78286,48193,0,0
133800,012630,12450,2,50,0.4,109.96,85753,94290,8537,1603,803,-800,183654,12500,12500,12450,79,4,4,78257,48173,41,38
133900,012630,12500,2,100,0.81,109.96,85753,94293,8540,1603,806,-797,183657,12500,12500,12500,0,0,0,78254,48170,0,0
133900,012630,12450,2,50,0.4,109.44,86199,94332,8133,1609,810,-799,184142,12500,12500,12450,485,6,4,79112,47906,446,39
134000,012630,12450,2,50,0.4,109.43,86204,94333,8129,1614,811,-803,184148,12450,12450,12450,0,0,0,79257,47901,0,0
134000,012630,12500,2,100,0.81,109.28,86358,94373,8015,1620,814,-806,184342,12450,12500,12450,194,6,3,79261,47746,154,40
134100,012630,12500,2,100,0.81,109.2,86427,94377,7950,1623,816,-807,184415,12500,12500,12450,6,1,2,79347,47764,2,4
134100,012630,12450,2,50,0.4,108.64,86873,94381,7508,1629,817,-812,184865,12500,12500,12450,456,7,3,79512,47621,448,8
134200,012630,12450,2,50,0.4,108.58,86955,94415,7460,1634,819,-815,184981,12450,12450,12450,2,2,0,79368,47383,2,0
134200,012630,12450,2,50,0.4,108.33,87359,94639,7280,1641,820,-821,185609,12450,12500,12450,630,9,1,79107,47008,406,224
134300,012630,12500,2,100,0.81,108.28,87437,94678,7241,1643,823,-820,185726,12500,12500,12500,0,0,0,79411,46906,0,0
134300,012630,12450,2,50,0.4,108.24,87475,94679,7204,1645,824,-821,185765,12500,12500,12450,39,2,1,79604,47192,38,1
134400,012630,12500,2,100,0.81,108.28,87477,94722,7245,1647,829,-818,185810,12450,12500,12450,40,1,4,80629,47443,1,39
134400,012630,12450,2,50,0.4,108.23,87522,94722,7200,1654,829,-825,185855,12450,12500,12450,85,8,4,80411,47461,46,39
134500,012630,12450,2,50,0.4,108.22,87527,94726,7199,1659,830,-829,185864,12450,12500,12450,6,2,1,80357,47493,2,4
134500,012630,12450,2,50,0.4,107.89,87835,94761,6926,1661,832,-829,186207,12450,12500,12450,349,4,3,80570,47504,310,39
134600,012630,12450,2,50,0.4,107.84,87874,94761,6887,1664,832,-832,186246,12450,12450,12450,1,1,0,80582,47198,1,0
134600,012630,12450,2,50,0.4,107.74,87990,94799,6809,1669,835,-834,186400,12450,12500,12450,155,6,3,80656,47161,117,38
134700,012630,12500,2,100,0.81,107.7,88028,94802,6774,1671,836,-835,186441,12500,12500,12500,3,0,1,80668,47143,0,3
134700,012630,12500,2,100,0.81,107.35,88317,94811,6494,1676,838,-838,186739,12500,12500,12450,301,5,3,80690,46863,289,12
134800,012630,12450,2,50,0.4,106.76,88838,94842,6004,1684,839,-845,187291,12450,12450,12450,478,6,0,79418,46443,478,0
134800,012630,12450,2,50,0.4,106.26,89263,94847,5584,1690,841,-849,187721,12450,12500,12450,908,12,2,79250,46020,903,5
134900,012630,12450,2,50,0.4,105.74,89728,94881,5153,1698,843,-855,188220,12450,12500,12450,298,6,2,79327,45891,264,34
134900,012630,12400,3,0,0.0,105.5,89935,94885,4950,1706,846,-860,188431,12450,12500,12400,509,14,5,58926,50511,471,38
135000,012630,12450,2,50,0.4,105.67,89973,95076,5103,1708,852,-856,188660,12450,12450,12400,228,1,6,58807,50685,37,191
135000,012630,12450,2,50,0.4,106.76,90057,96146,6089,1709,857,-852,189814,12450,12450,12400,1382,2,11,57828,50476,121,1261
135100,012630,12400,3,0,0.0,106.65,90212,96212,6000,1716,860,-856,190035,12400,12450,12400,221,7,3,57774,50399,155,66
135200,012630,12400,3,0,0.0,106.59,90295,96247,5952,1718,863,-855,190153,12400,12400,12400,0,0,0,57745,50444,0,0
135200,012630,12400,3,0,0.0,106.41,90451,96247,5796,1723,863,-860,190309,12400,12400,12400,156,5,0,57510,50539,156,0
135300,012630,12450,2,50,0.4,106.46,90451,96290,5839,1723,868,-855,190352,12450,12450,12450,1,0,1,57528,50078,0,1
135300,012630,12450,2,50,0.4,106.41,90489,96291,5802,1725,869,-856,190391,12450,12450,12400,40,2,2,57639,50098,38,2
135400,012630,12450,2,50,0.4,106.43,90510,96329,5819,1732,872,-860,190450,12450,12450,12400,40,1,2,57812,50113,6,34
135400,012630,12400,3,0,0.0,106.36,90565,96329,5764,1740,872,-868,190505,12450,12450,12400,95,9,2,57906,52152,61,34
135500,012630,12450,2,50,0.4,106.22,90694,96333,5639,1747,873,-874,190638,12450,12450,12450,0,0,0,58071,52035,0,0
135500,012630,12400,3,0,0.0,106.19,90748,96368,5620,1755,875,-880,190727,12400,12450,12400,89,8,2,58330,53930,54,35
135600,012630,12450,2,50,0.4,107.46,90830,97609,6779,1762,880,-882,192050,12450,12450,12450,1306,4,4,77264,60895,69,1237
135600,012630,12450,2,50,0.4,107.46,90871,97648,6777,1767,883,-884,192130,12450,12500,12450,1386,9,7,77177,58318,110,1276
135700,012630,12450,2,50,0.4,107.32,90984,97648,6664,1769,883,-886,192243,12450,12450,12450,0,0,0,77189,58558,0,0
135700,012630,12450,2,50,0.4,107.28,91022,97652,6630,1771,884,-887,192285,12450,12500,12450,42,2,1,77250,58992,38,4
135800,012630,12500,2,100,0.81,107.32,91024,97689,6665,1772,888,-884,192324,12500,12500,12500,0,0,0,77299,51313,0,0
135800,012630,12450,2,50,0.4,106.88,91401,97693,6292,1776,889,-887,192705,12450,12500,12450,381,4,1,77427,51619,377,4
135900,012630,12450,2,50,0.4,106.79,91518,97731,6213,1782,892,-890,192860,12500,12500,12450,32,2,1,77341,52218,2,30
135900,012630,12450,2,50,0.4,106.78,91522,97731,6209,1786,892,-894,192864,12500,12500,12450,36,6,1,77364,53533,6,30
140000,012630,12500,2,100,0.81,106.78,91560,97771,6211,1788,896,-892,192942,12500,12500,12500,36,0,3,77393,53557,0,36
140000,012630,12450,2,50,0.4,106.65,91675,97771,6096,1791,896,-895,193057,12500,12500,12450,151,3,3,77590,49737,115,36
140100,012630,12450,2,50,0.4,106.6,91722,97775,6053,1799,897,-902,193108,12500,12500,12450,12,5,1,77589,49826,8,4
140100,012630,12450,2,50,0.4,106.74,91724,97909,6185,1801,900,-901,193244,12500,12500,12450,148,7,4,77479,50136,10,138
140200,012630,12500,2,100,0.81,106.4,92099,97997,5898,1803,903,-900,193707,12450,12500,12450,342,1,1,77407,49959,338,4
140200,012630,12500,2,100,0.81,106.32,92205,98034,5829,1805,907,-898,193850,12450,12500,12450,485,3,5,77410,49866,444,41
140300,012630,12450,2,50,0.4,106.28,92243,98034,5791,1807,907,-900,193888,12450,12450,12450,38,2,0,77403,49991,38,0
140300,012630,12500,2,100,0.81,106.28,92247,98043,5796,1811,909,-902,193901,12450,12500,12450,51,6,2,77467,50051,42,9
140400,012630,12500,2,100,0.81,106.35,92285,98146,5861,1814,912,-902,194042,12450,12500,12450,111,3,2,77451,50031,38,73
140400,012630,12500,2,100,0.81,106.22,92403,98153,5750,1818,914,-904,194167,12450,12500,12450,236,7,4,77388,49881,156,80
140500,012630,12450,2,50,0.4,105.79,92876,98249,5373,1824,919,-905,194736,12500,12500,12450,569,6,5,77450,51379,473,96
140600,012630,12450,2,50,0.4,105.79,92878,98253,5375,1826,920,-906,194742,12450,12450,12450,1,1,0,77462,51563,1,0
140600,012630,12450,2,50,0.4,105.79,93029,98414,5385,1833,925,-908,195054,12450,12500,12450,313,8,5,77300,51560,152,161
140700,012630,12500,2,100,0.81,105.83,93047,98473,5426,1840,927,-913,195131,12450,12500,12450,60,1,2,77306,52481,1,59
140700,012630,12500,2,100,0.81,105.81,93103,98513,5410,1845,931,-914,195227,12450,12500,12450,156,6,6,77116,52513,57,99
140800,012630,12500,2,100,0.81,105.89,93119,98605,5486,1850,935,-915,195335,12450,12500,12450,88,1,2,77080,52468,1,87
140800,012630,12450,2,50,0.4,105.45,93514,98611,5097,1857,937,-920,195736,12450,12500,12450,489,8,4,60852,52096,396,93
140900,012630,12450,2,50,0.4,105.54,93528,98707,5179,1861,941,-920,195846,12450,12450,12450,8,3,0,61809,50136,8,0
140900,012630,12450,2,50,0.4,105.49,93585,98721,5136,1867,943,-924,195917,12450,12500,12450,79,9,2,61887,50146,65,14
141000,012630,12450,2,50,0.4,105.52,93677,98847,5170,1872,949,-923,196135,12500,12500,12450,48,3,3,61827,50076,8,40
141000,012630,12450,2,50,0.4,105.52,93735,98912,5177,1879,952,-927,196258,12500,12500,12450,171,10,6,61762,49556,66,105
141100,012630,12500,2,100,0.81,105.39,93860,98920,5060,1885,954,-931,196391,12450,12500,12450,23,4,1,61765,49482,19,4
141100,012630,12450,2,50,0.4,105.07,94253,99036,4783,1891,958,-933,196900,12450,12500,12450,532,10,5,61651,49097,412,120
141200,012630,12450,2,50,0.4,104.97,94353,99041,4688,1895,960,-935,197005,12450,12500,12450,18,3,2,61682,49043,13,5
141200,012630,12450,2,50,0.4,105.02,94405,99142,4737,1901,964,-937,197158,12450,12500,12450,171,9,6,61593,49017,65,106
141300,012630,12450,2,50,0.4,104.91,94523,99168,4645,1909,967,-942,197302,12500,12500,12450,42,6,3,61485,49208,16,26
141300,012630,12450,2,50,0.4,104.98,94574,99288,4714,1914,972,-942,197473,12500,12500,12450,213,11,8,61441,49253,67,146
141400,012630,12500,2,100,0.81,105.03,94595,99355,4760,1920,975,-945,197561,12450,12500,12450,87,5,3,61444,49448,20,67
141400,012630,12450,2,50,0.4,104.98,94648,99361,4713,1926,978,-948,197620,12450,12500,12450,146,11,6,61369,49520,73,73
141500,012630,12500,2,100,0.81,104.71,95002,99479,4477,1933,982,-951,198092,12500,12500,12450,472,7,4,61501,49165,354,118
141600,012630,12450,2,50,0.4,104.65,95059,99483,4424,1939,983,-956,198153,12450,12450,12450,0,0,0,61469,49055,0,0
141600,012630,12450,2,50,0.4,104.62,95184,99579,4395,1944,988,-956,198374,12450,12500,12450,221,5,5,61329,49097,125,96
141700,012630,12500,2,100,0.81,104.57,95239,99588,4349,1948,992,-956,198438,12500,12500,12500,6,0,3,61329,49144,0,6
141700,012630,12500,2,100,0.81,104.68,95252,99709,4457,1951,996,-955,198572,12500,12500,12450,140,3,7,61231,49143,13,127
141800,012630,12450,2,50,0.4,104.51,95402,99709,4307,1959,996,-963,198722,12450,12450,12450,37,1,0,61958,49243,37,0
141800,012630,12450,2,50,0.4,104.2,95759,99783,4024,1965,1000,-965,199153,12450,12500,12450,468,7,4,61879,48950,394,74
141900,012630,12450,2,50,0.4,104.15,95920,99896,3976,1971,1005,-966,199427,12450,12500,12450,118,2,3,61764,49223,39,79
141900,012630,12450,2,50,0.4,104.12,95943,99900,3957,1979,1006,-973,199454,12450,12500,12450,145,10,4,62469,49265,62,83
142000,012630,12500,2,100,0.81,104.23,95956,100012,4056,1982,1011,-971,199579,12500,12500,12500,0,0,0,63368,48280,0,0
142000,012630,12450,2,50,0.4,104.16,96014,100012,3998,1989,1011,-978,199637,12450,12450,12450,58,7,0,63395,48540,58,0
142100,012630,12450,2,50,0.4,104.23,96029,100092,4063,1993,1015,-978,199732,12450,12500,12450,9,2,1,63249,48634,8,1
142100,012630,12450,2,50,0.4,103.84,96424,100126,3702,2000,1017,-983,200161,12450,12500,12450,438,9,3,63377,48666,403,35
142200,012630,12450,2,50,0.4,103.89,96446,100196,3750,2011,1021,-990,200253,12450,12450,12450,16,10,0,63490,48339,16,0
142200,012630,12450,2,50,0.4,103.95,96502,100317,3815,2016,1026,-990,200430,12450,12500,12450,193,15,5,62363,48467,72,121
142300,012630,12450,2,50,0.4,103.94,96522,100321,3799,2021,1027,-994,200454,12450,12500,12450,16,2,1,62360,48500,12,4
142300,012630,12500,2,100,0.81,103.98,96575,100417,3842,2027,1031,-996,200603,12450,12500,12450,165,8,5,62301,48544,65,100
142400,012630,12500,2,100,0.81,103.98,96596,100442,3846,2033,1033,-1000,200649,12450,12500,12450,23,4,1,62304,48789,9,14
142400,012630,12450,2,50,0.4,104.02,96655,100544,3889,2040,1037,-1003,200810,12450,12500,12450,184,11,5,62222,48598,68,116
142500,012630,12450,2,50,0.4,103.69,97015,100593,3578,2046,1040,-1006,201219,12450,12500,12450,28,4,1,62185,48579,14,14
142500,012630,12450,2,50,0.4,103.72,97075,100684,3609,2054,1046,-1008,201370,12450,12500,12450,179,12,7,62112,49708,74,105
142600,012630,12500,2,100,0.81,103.67,97177,100746,3569,2060,1050,-1010,201534,12450,12500,12450,63,5,3,63563,49564,15,48
142600,012630,12500,2,100,0.81,103.71,97233,100844,3611,2065,1055,-1010,201688,12450,12500,12450,217,10,8,63461,49564,71,146
142700,012630,12500,2,100,0.81,103.81,97252,100955,3703,2069,1060,-1009,201818,12500,12500,12450,123,2,5,63371,49584,12,111
142700,012630,12450,2,50,0.4,102.89,98137,100969,2832,2078,1061,-1017,202717,12500,12500,12450,1022,11,6,62576,48712,897,125
142800,012630,12500,2,100,0.81,102.63,98494,101080,2586,2083,1066,-1017,203185,12500,12500,12450,461,3,5,62632,48633,350,111
142800,012630,12450,2,50,0.4,102.62,98553,101132,2579,2091,1070,-1021,203296,12500,12500,12450,572,11,9,62559,48825,409,163
142900,012630,12450,2,50,0.4,102.68,98576,101214,2638,2099,1074,-1025,203401,12450,12500,12450,105,8,4,62479,49889,23,82
142900,012630,12450,2,50,0.4,102.67,98628,101263,2635,2105,1077,-1028,203502,12450,12500,12450,206,14,7,62602,49842,75,131
143000,012630,12500,2,100,0.81,102.76,98658,101378,2720,2111,1083,-1028,203647,12450,12500,12450,131,6,5,62487,49906,30,101
143100,012630,12500,2,100,0.81,102.79,98715,101467,2752,2117,1086,-1031,203793,12500,12500,12500,0,0,0,62656,49931,0,0
143100,012630,12500,2,100,0.81,102.39,99160,101534,2374,2123,1092,-1031,204305,12500,12500,12450,512,6,6,62847,49479,445,67
143200,012630,12450,2,50,0.4,102.34,99218,101538,2320,2130,1093,-1037,204367,12450,12450,12450,0,0,0,62789,49565,0,0
143200,012630,12450,2,50,0.4,102.35,99240,101573,2333,2137,1095,-1042,204424,12450,12500,12450,57,7,2,62785,49161,22,35
143300,012630,12450,2,50,0.4,101.8,99780,101581,1801,2143,1097,-1046,204972,12450,12450,12450,527,3,0,63028,49079,527,0
143300,012630,12500,2,100,0.81,101.82,99795,101615,1820,2148,1099,-1049,205021,12450,12500,12450,576,8,2,63125,48811,542,34
143400,012630,12450,2,50,0.4,101.61,100006,101621,1615,2153,1102,-1051,205238,12450,12500,12450,42,2,1,63074,48625,38,4
143400,012630,12450,2,50,0.4,101.6,100020,101624,1604,2158,1103,-1055,205255,12450,12500,12450,59,7,2,62976,48602,52,7
143500,012630,12450,2,50,0.4,101.16,100496,101660,1164,2167,1106,-1061,205767,12450,12450,12450,9,4,0,62943,48315,9,0
143500,012630,12450,2,50,0.4,101.1,100558,101664,1106,2174,1107,-1067,205833,12450,12500,12450,75,11,1,62965,48269,71,4
143600,012630,12500,2,100,0.81,100.94,100754,101700,946,2181,1110,-1071,206065,12500,12500,12450,42,1,3,62950,48243,6,36
143600,012630,12450,2,50,0.4,100.88,100813,101704,891,2188,1111,-1077,206128,12500,12500,12450,105,8,4,63102,48246,65,40
143700,012630,12500,2,100,0.81,100.72,101013,101739,726,2195,1113,-1082,206363,12450,12500,12450,48,3,2,63287,48160,13,35
143700,012630,12450,2,50,0.4,100.98,101052,102043,991,2198,1115,-1083,206706,12450,12500,12450,391,6,4,63255,48213,52,339
143800,012630,12450,2,50,0.4,100.6,101435,102047,612,2206,1116,-1090,207093,12450,12450,12450,380,6,0,63305,48060,380,0
143800,012630,12500,2,100,0.81,100.6,101473,102083,610,2208,1120,-1088,207167,12450,12500,12450,454,8,4,63499,48102,418,36
143900,012630,12450,2,50,0.4,100.6,101477,102087,610,2212,1121,-1091,207175,12500,12500,12450,6,2,1,63505,48550,2,4
144000,012630,12450,2,50,0.4,100.55,101560,102123,563,2223,1124,-1099,207294,12450,12450,12450,21,2,0,63365,48548,21,0
144000,012630,12450,2,50,0.4,100.51,101616,102130,514,2228,1126,-1102,207357,12450,12500,12450,84,7,2,63482,48512,77,7
144100,012630,12450,2,50,0.4,100.52,101635,102165,530,2232,1129,-1103,207411,12500,12500,12450,8,2,1,63459,48512,7,1
144100,012630,12450,2,50,0.4,100.13,102032,102169,137,2240,1130,-1110,207812,12500,12500,12450,409,10,2,63443,48184,404,5
144200,012630,12450,2,50,0.4,100.04,102166,102209,43,2248,1133,-1115,207986,12450,12500,12450,161,5,2,63424,48220,126,35
144200,012630,12450,2,50,0.4,99.99,102222,102213,-9,2253,1134,-1119,208046,12450,12500,12450,221,10,3,63472,48182,182,39
144300,012630,12450,2,50,0.4,99.87,102347,102213,-134,2259,1134,-1125,208171,12450,12450,12450,119,5,0,63466,48082,119,0
144300,012630,12450,2,50,0.4,99.89,102367,102253,-114,2264,1139,-1125,208231,12450,12500,12450,179,10,5,63448,48118,139,40
144400,012630,12500,2,100,0.81,99.4,102880,102258,-622,2301,1141,-1160,208749,12450,12500,12450,465,34,1,63105,47836,464,1
144400,012630,12450,2,50,0.4,98.87,103458,102294,-1164,2314,1143,-1171,209363,12450,12500,12450,1079,47,3,62939,47353,1042,37
144500,012630,12450,2,50,0.4,98.28,104151,102364,-1787,2326,1145,-1181,210126,12450,12500,12450,470,5,2,62607,46698,400,70
144500,012630,12450,2,50,0.4,98.23,104208,102364,-1844,2333,1145,-1188,210183,12450,12500,12450,527,12,2,62637,47186,457,70
144600,012630,12500,2,100,0.81,98.21,104271,102405,-1866,2340,1149,-1191,210287,12450,12500,12450,27,5,2,62500,47220,20,7
144600,012630,12450,2,50,0.4,98.19,104292,102405,-1887,2346,1149,-1197,210308,12450,12500,12450,48,11,2,62712,47785,41,7
144700,012630,12450,2,50,0.4,98.07,104459,102440,-2019,2354,1151,-1203,210510,12450,12500,12450,182,7,2,62758,47623,147,35
144700,012630,12450,2,50,0.4,97.62,104941,102444,-2497,2363,1152,-1211,210996,12450,12500,12450,668,16,3,62801,47169,629,39
144800,012630,12450,2,50,0.4,97.6,104998,102478,-2520,2369,1154,-1215,211087,12450,12500,12450,91,6,2,62767,47153,57,34
144900,012630,12450,2,50,0.4,97.5,105137,102506,-2631,2377,1157,-1220,211254,12450,12450,12450,6,1,0,62592,46544,6,0
144900,012630,12450,2,50,0.4,97.4,105288,102550,-2738,2386,1159,-1227,211449,12450,12500,12450,201,10,2,62899,46508,157,44
145000,012630,12450,2,50,0.4,97.31,105416,102585,-2831,2392,1161,-1231,211612,12450,12450,12450,108,1,0,62862,47046,108,0
145000,012630,12450,2,50,0.4,97.26,105477,102589,-2888,2401,1162,-1239,211677,12450,12500,12450,173,10,1,62910,46972,169,4
145100,012630,12450,2,50,0.4,97.26,105516,102623,-2893,2408,1164,-1244,211750,12450,12450,12450,0,0,0,62876,46961,0,0
145100,012630,12450,2,50,0.4,96.81,106005,102627,-3378,2419,1165,-1254,212243,12450,12500,12450,493,11,1,62806,46558,489,4
145200,012630,12500,2,100,0.81,96.83,106025,102663,-3362,2424,1167,-1257,212299,12450,12500,12450,42,1,2,62956,46572,6,36
145200,012630,12450,2,50,0.4,96.52,106369,102670,-3699,2432,1169,-1263,212650,12450,12500,12450,393,9,4,62901,47577,350,43
145300,012630,12450,2,50,0.4,96.44,106459,102671,-3788,2440,1170,-1270,212741,12500,12500,12450,76,3,1,62801,47479,75,1
145300,012630,12450,2,50,0.4,96.42,106517,102706,-3811,2447,1173,-1274,212834,12500,12500,12450,169,10,4,62670,47601,133,36
145400,012630,12450,2,50,0.4,95.63,107401,102710,-4691,2459,1174,-1285,213722,12450,12450,12450,63,6,0,63303,47025,63,0
145400,012630,12450,2,50,0.4,95.31,107798,102745,-5053,2467,1176,-1291,214154,12450,12500,12450,495,14,2,63368,46642,460,35
145500,012630,12450,2,50,0.4,95.3,107820,102749,-5071,2474,1177,-1297,214180,12450,12450,12450,8,3,0,63365,46702,8,0
145500,012630,12450,2,50,0.4,95.23,107905,102753,-5152,2484,1178,-1306,214269,12450,12500,12450,97,13,1,63549,45762,93,4
145600,012630,12450,2,50,0.4,95.14,108044,102791,-5253,2490,1181,-1309,214446,12450,12500,12450,52,3,1,63511,45605,48,4
145600,012630,12450,2,50,0.4,95.0,108205,102791,-5414,2500,1181,-1319,214607,12450,12500,12450,213,13,1,63509,45494,209,4
145700,012630,12450,2,50,0.4,95.01,108231,102826,-5405,2506,1183,-1323,214668,12450,12500,12450,49,4,2,63474,45495,14,35
145700,012630,12450,2,50,0.4,94.49,108824,102830,-5994,2516,1184,-1332,215265,12450,12500,12450,646,14,3,63469,45008,607,39
145800,012630,12450,2,50,0.4,94.47,108885,102868,-6017,2523,1188,-1335,215364,12500,12500,12450,90,4,4,63428,45023,52,38
145800,012630,12450,2,50,0.4,94.39,109094,102972,-6122,2538,1190,-1348,215677,12500,12500,12450,403,19,6,63324,44836,261,142
145900,012630,12450,2,50,0.4,94.37,109114,102972,-6142,2543,1190,-1353,215697,12450,12450,12450,14,4,0,63324,44757,14,0
145900,012630,12450,2,50,0.4,94.25,109297,103011,-6286,2551,1193,-1358,215919,12450,12500,12450,236,12,3,63311,44838,197,39
150000,012630,12450,2,50,0.4,93.13,110615,103011,-7604,2568,1193,-1375,217237,12450,12450,12450,1318,17,0,62055,45012,1318,0
150000,012630,12450,2,50,0.4,93.02,110779,103046,-7733,2572,1195,-1377,217436,12450,12500,12450,1517,21,2,62144,44917,1482,35
150100,012630,12450,2,50,0.4,92.45,111468,103054,-8414,2582,1197,-1385,218133,12450,12500,12450,660,9,2,62129,44422,652,8
150200,012630,12500,2,100,0.81,92.48,111469,103089,-8380,2583,1199,-1384,218169,12500,12500,12500,0,0,0,62276,44287,0,0
150200,012630,12450,2,50,0.4,92.36,111617,103094,-8523,2588,1201,-1387,218322,12450,12500,12450,153,5,2,62291,44237,148,5
150300,012630,12500,2,100,0.81,92.37,111720,103199,-8521,2592,1206,-1386,218530,12450,12500,12450,101,1,1,62210,44057,100,1
150300,012630,12500,2,100,0.81,92.34,111807,103239,-8568,2599,1211,-1388,218657,12450,12500,12450,228,8,6,62182,44082,187,41
150400,012630,12500,2,100,0.81,92.21,111965,103242,-8723,2606,1213,-1393,218818,12450,12500,12450,106,2,1,62093,43924,104,2
150400,012630,12450,2,50,0.4,92.17,112050,103281,-8769,2611,1217,-1394,218942,12450,12500,12450,230,7,5,62176,44191,189,41
150500,012630,12450,2,50,0.4,92.04,112215,103287,-8928,2621,1220,-1401,219113,12450,12450,12450,86,4,0,62181,44150,86,0
150500,012630,12500,2,100,0.81,91.97,112342,103321,-9021,2626,1222,-1404,219274,12450,12500,12450,247,9,2,63464,44463,213,34
150600,012630,12450,2,50,0.4,91.93,112391,103325,-9066,2635,1223,-1412,219327,12450,12450,12450,20,3,0,63461,44804,20,0
150600,012630,12450,2,50,0.4,91.87,112501,103355,-9146,2641,1224,-1417,219467,12450,12500,12450,160,9,1,64428,44814,130,30
150700,012630,12450,2,50,0.4,91.81,112620,103398,-9222,2650,1228,-1422,219629,12450,12500,12450,113,6,2,64566,43719,105,8
150700,012630,12450,2,50,0.4,91.91,113506,104324,-9182,2661,1232,-1429,221441,12450,12500,12400,1925,17,6,62468,46253,991,934
150800,012630,12450,2,50,0.4,91.84,113630,104359,-9271,2668,1234,-1434,221600,12400,12500,12400,146,3,2,65600,48418,111,35
150800,012630,12400,3,0,0.0,91.76,113752,104375,-9377,2675,1236,-1439,221738,12400,12500,12400,284,10,4,65584,49392,233,51
150900,012630,12450,2,50,0.4,92.66,113830,105478,-8352,2677,1241,-1436,222919,12450,12450,12450,781,0,3,62632,49300,0,781
150900,012630,12450,2,50,0.4,92.6,113955,105517,-8438,2683,1244,-1439,223083,12450,12500,12450,945,6,6,65536,46175,125,820
151000,012630,12500,2,100,0.81,93.0,114050,106064,-7986,2686,1254,-1432,223725,12450,12500,12450,640,1,10,65065,46485,93,547
151000,012630,12500,2,100,0.81,93.6,114142,106836,-7306,2690,1269,-1421,224589,12450,12500,12450,1504,5,25,64664,46820,185,1319
151100,012630,12450,2,50,0.4,93.99,114250,107380,-6870,2695,1278,-1417,225241,12450,12500,12450,515,4,7,64349,46998,107,408
151100,012630,12450,2,50,0.4,94.16,114370,107688,-6682,2699,1286,-1413,225669,12450,12500,12450,943,8,15,64237,48296,227,716
151200,012630,12450,2,50,0.4,94.33,114454,107965,-6489,2706,1293,-1413,226030,12450,12500,12450,361,7,7,63973,48605,84,277
151200,012630,12450,2,50,0.4,94.59,114569,108372,-6197,2709,1300,-1409,226552,12450,12500,12450,883,10,14,63643,50739,199,684
151300,012630,12450,2,50,0.4,95.12,114685,109094,-5591,2713,1316,-1397,227390,12450,12500,12450,838,4,16,62947,51319,116,722
151400,012630,12450,2,50,0.4,95.27,114696,109270,-5426,2716,1319,-1397,227577,12450,12450,12450,0,0,0,61333,51583,0,0
151400,012630,12500,2,100,0.81,96.1,114814,110338,-4476,2717,1338,-1379,228763,12450,12500,12450,1186,1,19,60582,52369,118,1068
151500,012630,12500,2,100,0.81,96.24,114839,110519,-4320,2725,1344,-1381,228969,12500,12500,12450,147,2,3,61352,53138,11,136
151500,012630,12500,2,100,0.81,96.5,114989,110966,-4023,2731,1357,-1374,229566,12500,12500,12450,744,8,16,61145,53243,161,583
151600,012630,12450,2,50,0.4,96.87,115133,111535,-3598,2749,1372,-1377,230279,12450,12500,12450,263,13,5,60503,54070,121,142
151600,012630,12450,2,50,0.4,97.14,115279,111984,-3295,2756,1382,-1374,230874,12450,12500,12450,858,20,15,59960,54633,267,591
151700,012630,12450,2,50,0.4,99.0,115309,114157,-1152,2762,1393,-1369,233077,12500,12500,12450,1643,3,4,57776,54707,8,1635
151700,012630,12450,2,50,0.4,99.22,115355,114460,-895,2768,1398,-1370,233426,12500,12500,12450,1992,9,9,57477,55439,54,1938
151800,012630,12450,2,50,0.4,99.33,115406,114630,-776,2776,1402,-1374,233647,12500,12500,12450,193,5,3,57354,56192,24,169
151800,012630,12500,2,100,0.81,100.05,115441,115503,62,2783,1413,-1370,234555,12500,12500,12450,1101,12,14,58067,60766,59,1042
151900,012630,12500,2,100,0.81,100.66,115505,116267,762,2791,1424,-1367,235383,12450,12500,12450,481,3,7,58875,62873,20,461
151900,012630,12500,2,100,0.81,101.83,115517,117633,2116,2802,1436,-1366,236761,12450,12500,12450,1859,14,19,57678,62838,32,1827
152000,012630,12450,2,50,0.4,102.35,115541,118251,2710,2803,1447,-1356,237403,12500,12500,12450,252,1,4,57862,62286,24,228
152000,012630,12500,2,100,0.81,102.99,115739,119199,3460,2811,1467,-1344,238549,12500,12500,12450,1398,9,24,56752,61546,222,1176
152000,012630,12500,2,100,0.81,103.01,115739,119227,3488,2811,1470,-1341,238577,12500,12500,12450,1426,9,27,56719,61536,222,1204
152000,012630,12500,2,100,0.81,103.01,115739,119227,3488,2811,1470,-1341,238577,12500,12500,12450,1426,9,27,56719,61536,222,1204
152000,012630,12500,2,100,0.81,103.01,115739,119227,3488,2811,1470,-1341,238577,12500,12500,12450,1426,9,27,56719,61536,222,1204
152000,012630,12500,2,100,0.81,103.01,115739,119227,3488,2811,1470,-1341,238577,12500,12500,12450,1426,9,27,56719,61536,222,1204
152000,012630,12500,2,100,0.81,103.01,115739,119227,3488,2811,1470,-1341,238577,12500,12500,12450,1426,9,27,56719,61536,222,1204
152000,012630,12500,2,100,0.81,103.01,115739,119227,3488,2811,1470,-1341,238577,12500,12500,12450,1426,9,27,56719,61536,222,1204
152000,012630,12500,2,100,0.81,103.01,115739,119227,3488,2811,1470,-1341,238577,12500,12500,12450,1426,9,27,56719,61536,222,1204
152000,012630,12500,2,100,0.81,103.01,115739,119227,3488,2811,1470,-1341,238577,12500,12500,12450,1426,9,27,56719,61536,222,1204
152000,012630,12500,2,100,0.81,103.01,115739,119227,3488,2811,1470,-1341,238577,12500,12500,12450,1426,9,27,56719,61536,222,1204
152000,012630,12500,2,100,0.81,103.01,115739,119227,3488,2811,1470,-1341,238577,12500,12500,12450,1426,9,27,56719,61536,222,1204
152000,012630,12500,2,100,0.81,103.01,115739,119227,3488,2811,1470,-1341,238577,12500,12500,12450,1426,9,27,56719,61536,222,1204
152000,012630,12500,2,100,0.81,103.01,115739,119227,3488,2811,1470,-1341,238577,12500,12500,12450,1426,9,27,56719,61536,222,1204
152000,012630,12500,2,100,0.81,103.01,115739,119227,3488,2811,1470,-1341,238577,12500,12500,12450,1426,9,27,56719,61536,222,1204
152000,012630,12500,2,100,0.81,103.01,115739,119227,3488,2811,1470,-1341,238577,12500,12500,12450,1426,9,27,56719,61536,222,1204
152000,012630,12500,2,100,0.81,103.01,115739,119227,3488,2811,1470,-1341,238577,12500,12500,12450,1426,9,27,56719,61536,222,1204
152000,012630,12500,2,100,0.81,103.01,115739,119227,3488,2811,1470,-1341,238577,12500,12500,12450,1426,9,27,56719,61536,222,1204
152000,012630,12500,2,100,0.81,103.01,115739,119227,3488,2811,1470,-1341,238577,12500,12500,12450,1426,9,27,56719,61536,222,1204
152000,012630,12500,2,100,0.81,103.01,115739,119227,3488,2811,1470,-1341,238577,12500,12500,12450,1426,9,27,56719,61536,222,1204
152000,012630,12500,2,100,0.81,103.01,115739,119227,3488,2811,1470,-1341,238577,12500,12500,12450,1426,9,27,56719,61536,222,1204
